Player_ID,Year,TeamA,TeamB,Serve_Points,Serve_Errors,Serve_Attempts,Total_Serves,Match_Date,Set_Successes,Set_Errors,Set_Attempts,Total_Sets,Attack_Success,Attack_Errors,Attack_Attempts,Total_Attacks,Block_Successful,Block_Errors,Block_Rebounds,Total_Blocks,Reception_Successful,Reception_Errors,Reception_Attemps,Total_Receptions,Dig_Success,Dig_Errors,Dig_Attempts,Total_Digs
142412,2021,Iran,Argentina,0,0,0,0,23/06/2021,2,0,2,4,0,0,0,0,0,0,0,0,0,0,0,0,1,0,0,1
142412,2021,France,Argentina,0,0,1,1,22/06/2021,2,0,5,7,0,0,0,0,0,0,0,0,0,0,0,0,0,0,0,0
142412,2021,Argentina,Serbia,1,1,11,13,17/06/2021,25,0,22,47,0,0,0,0,0,0,0,0,0,0,0,0,5,0,1,6
142412,2021,Argentina,Bulgaria,0,0,0,0,15/06/2021,2,0,6,8,0,0,0,0,0,0,0,0,0,0,0,0,1,0,0,1
142412,2021,Japan,Argentina,0,0,1,1,11/6/2021,7,0,6,13,0,0,0,0,0,0,0,0,0,0,0,0,0,0,0,0
142412,2021,Argentina,Australia,1,1,12,14,10/6/2021,34,0,39,73,2,0,0,2,0,1,0,1,0,0,0,0,3,4,0,7
142412,2021,Netherlands,Argentina,0,0,0,0,5/6/2021,0,0,0,0,0,0,0,0,0,0,0,0,0,0,0,0,0,0,0,0
117445,2021,Iran,Argentina,0,0,0,0,23/06/2021,0,0,0,0,2,0,0,2,1,0,0,1,0,0,0,0,0,0,0,0
117445,2021,France,Argentina,0,0,2,2,22/06/2021,0,0,0,0,2,0,1,3,0,0,0,0,0,0,0,0,0,1,0,1
117445,2021,Poland,Argentina,0,2,6,8,21/06/2021,0,0,1,1,10,3,3,16,0,1,0,1,0,0,0,0,2,1,2,5
117445,2021,Argentina,Serbia,0,1,1,2,17/06/2021,0,0,0,0,6,1,2,9,0,0,1,1,0,0,0,0,0,0,0,0
117445,2021,Argentina,Russia,1,2,3,6,16/06/2021,0,0,1,1,15,6,5,26,0,3,1,4,0,0,1,1,0,2,0,2
117445,2021,Argentina,Bulgaria,0,0,1,1,15/06/2021,0,0,0,0,2,0,0,2,0,0,0,0,0,0,0,0,2,1,0,3
117445,2021,Japan,Argentina,2,4,10,16,11/6/2021,0,0,2,2,18,6,12,36,2,3,6,11,0,0,0,0,5,0,0,5
117445,2021,Argentina,Australia,3,4,7,14,10/6/2021,0,0,1,1,12,4,5,21,0,3,0,3,0,0,0,0,2,1,0,3
117445,2021,Argentina,Italy,0,0,0,0,9/6/2021,0,0,0,0,1,0,2,3,0,1,0,1,0,0,0,0,0,0,0,0
117445,2021,Netherlands,Argentina,1,3,7,11,5/6/2021,0,0,2,2,8,6,9,23,6,2,2,10,0,0,0,0,2,5,0,7
117445,2021,Argentina,Slovenia,0,3,3,6,4/6/2021,0,0,2,2,4,7,9,20,0,1,1,2,0,0,0,0,1,0,2,3
117445,2021,Germany,Argentina,1,5,12,18,3/6/2021,0,0,0,0,20,4,9,33,1,2,1,4,0,0,0,0,6,1,0,7
117445,2021,USA,Argentina,0,3,8,11,30/05/2021,0,0,4,4,7,8,7,22,1,0,0,1,0,0,0,0,1,0,0,1
117445,2021,Argentina,Canada,1,1,5,7,29/05/2021,0,0,0,0,4,7,2,13,0,3,0,3,0,0,0,0,1,1,0,2
117445,2021,Brazil,Argentina,1,4,5,10,28/05/2021,0,1,0,1,14,4,7,25,1,2,1,4,0,0,0,0,3,1,0,4
142410,2021,Iran,Argentina,0,0,0,0,23/06/2021,0,0,0,0,0,0,0,0,0,0,0,0,0,0,0,0,0,0,0,0
142410,2021,France,Argentina,0,0,0,0,22/06/2021,0,0,0,0,0,0,0,0,0,0,0,0,0,0,0,0,0,0,0,0
142410,2021,Poland,Argentina,0,0,0,0,21/06/2021,0,0,0,0,0,0,0,0,0,0,0,0,0,0,0,0,0,0,0,0
142410,2021,Japan,Argentina,0,0,0,0,11/6/2021,0,0,0,0,0,0,0,0,0,0,0,0,0,0,0,0,0,0,0,0
142410,2021,Argentina,Australia,0,2,13,15,10/6/2021,0,0,1,1,8,2,7,17,1,3,2,6,9,0,9,18,5,0,0,5
142410,2021,Argentina,Italy,0,0,5,5,9/6/2021,0,0,0,0,5,3,8,16,0,0,0,0,5,2,6,13,2,0,0,2
142410,2021,Netherlands,Argentina,0,0,0,0,5/6/2021,0,0,0,0,0,0,0,0,0,0,0,0,0,0,0,0,0,0,0,0
142410,2021,Argentina,Slovenia,0,3,7,10,4/6/2021,0,0,4,4,7,1,9,17,0,1,0,1,5,0,14,19,9,1,0,10
142410,2021,Germany,Argentina,0,3,14,17,3/6/2021,0,0,0,0,18,2,12,32,1,4,0,5,6,1,16,23,10,0,0,10
142410,2021,USA,Argentina,0,1,12,13,30/05/2021,0,0,5,5,9,4,13,26,0,3,0,3,4,0,14,18,4,1,0,5
142410,2021,Argentina,Canada,0,0,0,0,29/05/2021,0,0,1,1,0,0,0,0,0,0,0,0,6,1,8,15,4,3,0,7
142410,2021,Brazil,Argentina,0,2,8,10,28/05/2021,0,0,0,0,4,1,8,13,0,0,0,0,4,0,8,12,4,1,0,5
119846,2021,Poland,Argentina,0,1,4,5,21/06/2021,16,0,26,42,0,0,0,0,1,0,1,2,0,0,0,0,1,1,0,2
119846,2021,Argentina,Russia,0,0,7,7,16/06/2021,14,0,35,49,2,0,1,3,0,0,1,1,0,0,0,0,6,1,1,8
119846,2021,Japan,Argentina,0,1,0,1,11/6/2021,0,0,0,0,0,0,0,0,0,0,0,0,0,0,0,0,0,0,0,0
119846,2021,Argentina,Australia,0,0,0,0,10/6/2021,0,0,0,0,0,0,0,0,0,0,0,0,0,0,0,0,0,0,0,0
119846,2021,Argentina,Italy,0,2,3,5,9/6/2021,16,0,38,54,0,0,3,3,0,0,1,1,0,0,1,1,0,1,0,1
119846,2021,Argentina,Slovenia,0,0,4,4,4/6/2021,15,0,24,39,0,0,1,1,2,0,3,5,0,0,0,0,2,0,1,3
119846,2021,Germany,Argentina,0,0,3,3,3/6/2021,2,1,4,7,0,0,0,0,0,0,0,0,0,0,0,0,1,1,0,2
119846,2021,USA,Argentina,0,0,2,2,30/05/2021,6,0,8,14,0,0,0,0,1,0,1,2,0,0,0,0,1,1,0,2
119846,2021,Argentina,Canada,0,1,4,5,29/05/2021,9,0,22,31,1,0,1,2,1,3,1,5,0,0,0,0,0,0,0,0
119846,2021,Brazil,Argentina,0,0,1,1,28/05/2021,0,0,0,0,0,0,0,0,0,0,0,0,0,0,0,0,0,0,0,0
119853,2021,Iran,Argentina,0,4,17,21,23/06/2021,0,0,1,1,10,5,14,29,2,3,3,8,3,1,16,20,8,0,1,9
119853,2021,France,Argentina,0,2,3,5,22/06/2021,0,0,2,2,1,1,4,6,0,0,0,0,2,2,12,16,4,1,0,5
119853,2021,Poland,Argentina,0,3,7,10,21/06/2021,0,0,1,1,7,0,8,15,0,0,3,3,3,3,7,13,3,3,1,7
119853,2021,Argentina,Serbia,0,0,0,0,17/06/2021,0,0,0,0,0,0,0,0,0,0,0,0,0,0,0,0,0,0,0,0
119853,2021,Argentina,Russia,0,3,8,11,16/06/2021,0,0,3,3,5,4,6,15,0,3,2,5,3,3,16,22,6,0,0,6
119853,2021,Argentina,Bulgaria,0,0,0,0,15/06/2021,0,0,0,0,0,0,0,0,0,0,0,0,0,0,0,0,0,0,0,0
119853,2021,Japan,Argentina,1,0,12,13,11/6/2021,0,0,8,8,12,2,11,25,1,2,5,8,11,1,11,23,10,1,1,12
119853,2021,Argentina,Australia,0,0,0,0,10/6/2021,0,0,0,0,0,0,0,0,0,0,0,0,0,0,0,0,0,0,0,0
119853,2021,Netherlands,Argentina,0,2,12,14,5/6/2021,0,0,1,1,6,1,2,9,0,3,0,3,5,2,7,14,3,1,0,4
119853,2021,Argentina,Slovenia,0,0,5,5,4/6/2021,0,0,0,0,4,2,6,12,0,2,3,5,1,1,9,11,5,2,0,7
119853,2021,Germany,Argentina,0,0,0,0,3/6/2021,0,0,0,0,0,0,0,0,0,0,0,0,0,0,0,0,0,0,0,0
118886,2021,Iran,Argentina,0,4,10,14,23/06/2021,0,0,2,2,9,5,4,18,2,2,2,6,8,2,24,34,8,2,0,10
118886,2021,France,Argentina,0,2,6,8,22/06/2021,0,0,1,1,4,2,4,10,3,2,0,5,4,0,12,16,2,1,2,5
118886,2021,Poland,Argentina,0,3,8,11,21/06/2021,0,0,0,0,4,2,10,16,0,3,1,4,7,2,16,25,8,2,0,10
118886,2021,Argentina,Serbia,0,2,8,10,17/06/2021,0,0,3,3,12,2,6,20,2,3,2,7,5,1,13,19,3,2,1,6
118886,2021,Argentina,Russia,0,4,10,14,16/06/2021,0,0,10,10,7,6,10,23,0,2,1,3,4,0,22,26,7,1,2,10
118886,2021,Argentina,Bulgaria,0,5,10,15,15/06/2021,0,0,3,3,12,1,8,21,0,3,3,6,3,2,10,15,9,3,0,12
118886,2021,Japan,Argentina,0,2,15,17,11/6/2021,0,0,4,4,9,6,17,32,3,4,0,7,7,0,17,24,8,7,1,16
118886,2021,Argentina,Australia,0,0,0,0,10/6/2021,0,0,0,0,0,0,0,0,0,0,0,0,0,0,0,0,0,0,0,0
118886,2021,Argentina,Italy,0,0,4,4,9/6/2021,0,0,1,1,0,4,6,10,1,0,0,1,3,2,7,12,2,1,0,3
118886,2021,Netherlands,Argentina,0,2,8,10,5/6/2021,0,0,1,1,12,1,12,25,2,2,1,5,9,1,13,23,5,1,0,6
118886,2021,Argentina,Slovenia,0,0,0,0,4/6/2021,0,0,0,0,0,0,0,0,0,0,0,0,0,0,0,0,0,0,0,0
118886,2021,Germany,Argentina,0,0,0,0,3/6/2021,0,0,0,0,0,0,0,0,0,0,0,0,0,0,0,0,0,0,0,0
118886,2021,USA,Argentina,1,4,9,14,30/05/2021,0,0,6,6,7,4,11,22,1,2,1,4,7,2,13,22,6,3,0,9
118886,2021,Argentina,Canada,0,4,7,11,29/05/2021,0,1,0,1,7,3,8,18,1,2,0,3,3,2,12,17,6,1,0,7
118886,2021,Brazil,Argentina,1,3,9,13,28/05/2021,0,0,0,0,9,7,4,20,3,2,0,5,7,6,15,28,4,1,0,5
152692,2021,Iran,Argentina,0,4,15,19,23/06/2021,0,0,0,0,10,1,2,13,2,3,3,8,0,1,2,3,1,2,1,4
152692,2021,France,Argentina,0,2,6,8,22/06/2021,0,0,1,1,8,1,3,12,0,6,3,9,0,0,0,0,3,0,0,3
152692,2021,Poland,Argentina,1,5,5,11,21/06/2021,0,0,2,2,4,0,4,8,0,7,7,14,0,0,0,0,0,0,1,1
152692,2021,Argentina,Serbia,1,2,14,17,17/06/2021,0,0,0,0,8,1,5,14,3,3,2,8,0,0,1,1,3,2,0,5
152692,2021,Argentina,Russia,1,2,12,15,16/06/2021,0,0,0,0,7,1,5,13,2,3,3,8,0,0,0,0,4,1,1,6
152692,2021,Argentina,Bulgaria,2,5,10,17,15/06/2021,0,0,0,0,7,0,0,7,1,5,5,11,0,0,2,2,2,1,0,3
152692,2021,Japan,Argentina,2,2,14,18,11/6/2021,0,0,2,2,9,0,3,12,1,5,2,8,0,0,3,3,2,0,1,3
152692,2021,Argentina,Australia,0,3,8,11,10/6/2021,0,0,2,2,13,1,5,19,1,3,1,5,0,0,0,0,5,0,0,5
152692,2021,Argentina,Italy,1,3,5,9,9/6/2021,0,0,0,0,3,0,1,4,4,0,2,6,0,1,2,3,0,1,0,1
152692,2021,Netherlands,Argentina,1,2,9,12,5/6/2021,0,0,0,0,8,1,1,10,1,3,2,6,1,0,0,1,0,1,0,1
152692,2021,Argentina,Slovenia,0,0,0,0,4/6/2021,0,0,0,0,0,0,0,0,0,0,0,0,0,0,0,0,0,0,0,0
152692,2021,Germany,Argentina,0,5,11,16,3/6/2021,0,0,1,1,9,2,3,14,1,8,3,12,1,0,0,1,4,0,0,4
153053,2021,Iran,Argentina,0,0,0,0,23/06/2021,0,0,6,6,0,0,0,0,0,0,0,0,10,1,15,26,6,5,2,13
153053,2021,France,Argentina,0,0,0,0,22/06/2021,0,0,6,6,0,0,0,0,0,0,0,0,1,1,6,8,7,4,2,13
153053,2021,Poland,Argentina,0,0,0,0,21/06/2021,0,0,1,1,0,0,0,0,0,0,0,0,2,2,13,17,4,4,1,9
153053,2021,Argentina,Serbia,0,0,0,0,17/06/2021,0,0,4,4,0,0,0,0,0,0,0,0,6,1,8,15,7,1,1,9
153053,2021,Argentina,Russia,0,0,0,0,16/06/2021,0,0,3,3,0,0,0,0,0,0,0,0,5,0,12,17,13,2,1,16
153053,2021,Argentina,Bulgaria,0,0,0,0,15/06/2021,0,0,5,5,0,0,0,0,0,0,0,0,8,0,14,22,9,1,1,11
153053,2021,Argentina,Italy,0,0,0,0,9/6/2021,0,0,4,4,0,0,0,0,0,0,0,0,4,0,7,11,7,6,1,14
136737,2021,Poland,Argentina,0,0,0,0,21/06/2021,0,0,0,0,0,0,0,0,0,0,0,0,0,0,0,0,0,0,0,0
136737,2021,Argentina,Serbia,0,0,0,0,17/06/2021,0,0,0,0,0,0,0,0,0,0,0,0,0,0,0,0,0,0,0,0
136737,2021,Argentina,Russia,0,0,0,0,16/06/2021,0,0,0,0,0,0,0,0,0,0,0,0,0,0,0,0,0,0,0,0
136737,2021,Argentina,Bulgaria,0,1,4,5,15/06/2021,0,0,0,0,5,4,2,11,1,2,0,3,1,1,6,8,3,1,0,4
136737,2021,Argentina,Italy,0,0,6,6,9/6/2021,0,0,0,0,4,4,9,17,2,0,0,2,2,0,5,7,1,1,0,2
133730,2021,Argentina,Russia,1,1,17,19,16/06/2021,0,0,2,2,5,0,7,12,3,2,8,13,0,0,0,0,5,0,0,5
133730,2021,Argentina,Bulgaria,0,2,12,14,15/06/2021,0,0,1,1,6,1,5,12,1,5,7,13,1,0,0,1,1,0,0,1
133730,2021,Japan,Argentina,0,2,17,19,11/6/2021,0,0,0,0,11,1,5,17,1,4,13,18,2,0,1,3,6,2,0,8
133730,2021,Argentina,Australia,0,0,0,0,10/6/2021,0,0,0,0,0,0,0,0,0,0,0,0,0,0,0,0,0,0,0,0
133730,2021,Argentina,Italy,0,2,15,17,9/6/2021,0,0,1,1,6,1,7,14,2,3,3,8,0,0,1,1,2,0,0,2
133730,2021,Netherlands,Argentina,0,0,10,10,5/6/2021,1,0,0,1,8,0,2,10,1,2,1,4,0,0,0,0,1,1,0,2
133730,2021,Argentina,Slovenia,0,0,0,0,4/6/2021,0,0,0,0,0,0,0,0,0,0,0,0,0,0,0,0,0,0,0,0
133730,2021,Germany,Argentina,0,5,12,17,3/6/2021,0,0,0,0,11,1,2,14,2,7,4,13,2,0,0,2,5,1,0,6
133730,2021,USA,Argentina,0,1,9,10,30/05/2021,0,0,0,0,3,0,2,5,2,2,2,6,1,0,1,2,0,0,0,0
133730,2021,Argentina,Canada,0,1,8,9,29/05/2021,0,0,0,0,4,2,4,10,1,1,2,4,1,0,1,2,2,0,0,2
133730,2021,Brazil,Argentina,0,2,8,10,28/05/2021,0,0,0,0,5,0,5,10,2,9,2,13,0,0,2,2,2,0,0,2
142415,2021,Iran,Argentina,1,6,9,16,23/06/2021,0,0,1,1,23,3,9,35,0,8,2,10,0,0,1,1,6,1,1,8
142415,2021,France,Argentina,0,3,8,11,22/06/2021,0,0,1,1,10,4,5,19,1,2,1,4,0,0,0,0,3,0,0,3
142415,2021,Poland,Argentina,0,1,4,5,21/06/2021,0,0,0,0,4,1,3,8,0,1,0,1,0,0,0,0,1,1,0,2
142415,2021,Argentina,Serbia,0,1,3,4,17/06/2021,0,0,0,0,9,4,4,17,1,3,4,8,0,0,0,0,0,1,0,1
142415,2021,Argentina,Russia,0,3,3,6,16/06/2021,0,0,1,1,6,5,4,15,0,0,1,1,0,0,0,0,2,1,1,4
142415,2021,Argentina,Bulgaria,2,3,10,15,15/06/2021,0,0,1,1,14,6,4,24,0,5,3,8,0,0,0,0,2,2,1,5
142415,2021,Argentina,Italy,0,5,6,11,9/6/2021,0,0,0,0,10,8,4,22,0,0,3,3,1,0,0,1,4,2,0,6
125048,2021,Iran,Argentina,0,0,0,0,23/06/2021,0,0,0,0,0,0,0,0,0,0,0,0,0,0,0,0,0,0,0,0
125048,2021,France,Argentina,0,3,2,5,22/06/2021,0,0,1,1,4,1,4,9,2,0,1,3,3,1,4,8,0,1,0,1
125048,2021,Poland,Argentina,0,0,0,0,21/06/2021,0,0,0,0,0,0,0,0,0,0,0,0,0,0,0,0,0,0,0,0
125048,2021,Argentina,Serbia,1,5,6,12,17/06/2021,0,1,2,3,4,2,3,9,0,2,0,2,9,0,12,21,5,0,1,6
125048,2021,Argentina,Russia,0,1,1,2,16/06/2021,0,0,0,0,1,2,3,6,0,0,0,0,2,0,5,7,2,0,0,2
125048,2021,Argentina,Bulgaria,2,1,8,11,15/06/2021,0,0,0,0,7,1,5,13,0,0,3,3,7,1,9,17,3,2,0,5
125048,2021,Japan,Argentina,0,0,0,0,11/6/2021,0,0,0,0,0,0,0,0,0,0,0,0,0,0,0,0,0,0,0,0
125048,2021,Argentina,Australia,0,0,0,0,10/6/2021,0,0,0,0,0,0,0,0,0,0,0,0,0,0,0,0,0,0,0,0
125048,2021,Netherlands,Argentina,0,0,0,0,5/6/2021,0,0,0,0,0,0,0,0,0,0,0,0,0,0,1,1,0,1,0,1
125048,2021,Argentina,Slovenia,0,0,0,0,4/6/2021,0,0,0,0,0,0,0,0,0,0,0,0,0,0,0,0,0,0,0,0
125048,2021,Germany,Argentina,0,0,0,0,3/6/2021,0,0,0,0,0,2,1,3,0,0,0,0,0,0,0,0,1,0,0,1
119851,2021,Netherlands,Argentina,0,0,0,0,5/6/2021,0,0,0,0,0,0,0,0,0,0,0,0,0,0,0,0,0,0,0,0
119851,2021,Argentina,Slovenia,0,1,11,12,4/6/2021,0,0,1,1,6,1,2,9,2,2,2,6,0,0,1,1,3,1,1,5
119851,2021,Germany,Argentina,0,0,0,0,3/6/2021,0,0,0,0,0,0,0,0,0,0,0,0,0,0,0,0,0,0,0,0
117457,2021,Iran,Argentina,1,2,14,17,23/06/2021,40,1,57,98,1,0,0,1,2,2,0,4,0,0,1,1,2,1,0,3
117457,2021,France,Argentina,0,0,10,10,22/06/2021,23,1,32,56,0,0,0,0,0,2,1,3,0,0,1,1,4,0,0,4
117457,2021,Poland,Argentina,0,0,2,2,21/06/2021,10,0,16,26,0,0,0,0,0,0,0,0,0,0,0,0,0,0,0,0
117457,2021,Argentina,Serbia,0,1,5,6,17/06/2021,11,0,13,24,0,0,0,0,0,0,0,0,0,0,0,0,1,0,1,2
117457,2021,Argentina,Russia,1,0,6,7,16/06/2021,11,1,30,42,0,0,1,1,0,2,1,3,0,1,0,1,5,0,0,5
117457,2021,Argentina,Bulgaria,0,2,10,12,15/06/2021,20,0,56,76,1,0,1,2,0,1,3,4,0,0,0,0,4,3,1,8
117457,2021,Japan,Argentina,1,3,13,17,11/6/2021,41,0,52,93,1,0,1,2,1,2,1,4,0,0,0,0,10,4,2,16
117457,2021,Argentina,Australia,0,0,0,0,10/6/2021,0,0,0,0,0,0,0,0,0,0,0,0,0,0,0,0,0,0,0,0
117457,2021,Argentina,Italy,0,0,5,5,9/6/2021,7,0,32,39,0,0,0,0,0,1,0,1,0,0,0,0,1,0,0,1
117457,2021,Netherlands,Argentina,0,0,17,17,5/6/2021,24,0,49,73,1,0,3,4,0,0,1,1,0,1,0,1,1,2,0,3
117457,2021,Argentina,Slovenia,0,1,6,7,4/6/2021,11,0,23,34,0,0,0,0,0,0,2,2,0,0,1,1,1,1,2,4
117457,2021,Germany,Argentina,1,4,11,16,3/6/2021,35,1,82,118,3,1,2,6,0,2,4,6,0,0,0,0,6,3,0,9
117457,2021,USA,Argentina,0,3,8,11,30/05/2021,22,0,43,65,1,0,3,4,0,1,1,2,0,0,2,2,2,0,1,3
117457,2021,Argentina,Canada,0,2,2,4,29/05/2021,9,0,28,37,0,0,2,2,0,0,0,0,0,0,0,0,0,1,0,1
117457,2021,Brazil,Argentina,0,2,13,15,28/05/2021,22,1,51,74,0,0,1,1,3,1,0,4,0,0,0,0,0,2,0,2
162546,2021,Iran,Argentina,0,0,0,0,23/06/2021,0,0,0,0,0,0,0,0,0,0,0,0,0,0,0,0,0,0,0,0
162546,2021,France,Argentina,0,0,0,0,22/06/2021,0,0,0,0,0,0,0,0,0,0,0,0,0,0,0,0,0,0,0,0
162546,2021,Argentina,Serbia,0,0,0,0,17/06/2021,0,0,0,0,0,0,0,0,0,0,0,0,0,0,0,0,0,0,0,0
162546,2021,Japan,Argentina,0,0,2,2,11/6/2021,0,0,0,0,1,1,1,3,0,1,0,1,0,0,0,0,0,0,0,0
162546,2021,Argentina,Australia,0,0,0,0,10/6/2021,0,0,0,0,0,0,0,0,0,0,0,0,0,0,0,0,0,0,0,0
162546,2021,Argentina,Italy,0,0,0,0,9/6/2021,0,0,0,0,0,0,0,0,0,0,0,0,0,0,0,0,0,0,0,0
162546,2021,Netherlands,Argentina,0,0,0,0,5/6/2021,0,0,0,0,0,0,0,0,0,0,0,0,0,0,0,0,0,0,0,0
162546,2021,Argentina,Slovenia,0,1,4,5,4/6/2021,0,0,1,1,4,2,4,10,0,1,0,1,0,0,0,0,4,2,0,6
162546,2021,Germany,Argentina,0,1,1,2,3/6/2021,0,0,0,0,1,0,2,3,0,0,0,0,0,0,0,0,0,0,0,0
162546,2021,USA,Argentina,0,1,6,7,30/05/2021,0,0,0,0,5,4,4,13,1,0,0,1,0,0,0,0,1,1,0,2
162546,2021,Argentina,Canada,0,2,1,3,29/05/2021,0,0,0,0,2,1,4,7,0,0,0,0,0,0,0,0,1,2,0,3
162546,2021,Brazil,Argentina,0,0,1,1,28/05/2021,0,0,0,0,1,0,1,2,0,0,0,0,0,1,2,3,1,2,0,3
125049,2021,Iran,Argentina,0,0,0,0,23/06/2021,0,0,0,0,0,0,0,0,0,0,0,0,0,0,0,0,0,0,0,0
125049,2021,France,Argentina,0,2,6,8,22/06/2021,0,0,2,2,5,1,3,9,1,2,0,3,2,2,7,11,2,0,1,3
125049,2021,Poland,Argentina,0,0,0,0,21/06/2021,0,0,0,0,0,0,0,0,0,0,0,0,0,0,0,0,0,0,0,0
125049,2021,Argentina,Serbia,0,0,0,0,17/06/2021,0,0,0,0,0,0,0,0,0,0,0,0,0,0,0,0,0,0,0,0
125049,2021,Argentina,Russia,0,0,0,0,16/06/2021,0,0,0,0,0,1,2,3,0,0,0,0,0,1,0,1,0,0,0,0
125049,2021,Argentina,Bulgaria,0,0,0,0,15/06/2021,0,0,0,0,0,0,0,0,0,0,0,0,0,0,1,1,0,0,0,0
125049,2021,Japan,Argentina,0,0,0,0,11/6/2021,0,0,0,0,0,0,0,0,0,0,0,0,0,0,0,0,0,0,0,0
125049,2021,Argentina,Australia,0,0,10,10,10/6/2021,0,0,2,2,9,2,2,13,0,2,0,2,9,1,10,20,3,1,0,4
125049,2021,Argentina,Italy,0,2,5,7,9/6/2021,0,0,2,2,8,1,4,13,0,1,1,2,3,1,10,14,1,3,0,4
125049,2021,Netherlands,Argentina,0,0,0,0,5/6/2021,0,0,0,0,0,0,0,0,0,0,0,0,0,0,0,0,0,0,0,0
125049,2021,Argentina,Slovenia,0,1,2,3,4/6/2021,0,0,1,1,2,1,6,9,2,2,1,5,3,1,11,15,2,0,0,2
125049,2021,Germany,Argentina,0,3,13,16,3/6/2021,0,0,4,4,8,5,17,30,3,1,2,6,11,2,20,33,6,4,3,13
125049,2021,USA,Argentina,0,0,0,0,30/05/2021,0,0,3,3,0,0,0,0,0,0,0,0,4,3,20,27,12,5,1,18
125049,2021,Argentina,Canada,0,3,5,8,29/05/2021,0,0,0,0,6,6,3,15,1,0,0,1,4,1,18,23,3,3,1,7
125049,2021,Brazil,Argentina,0,0,0,0,28/05/2021,0,0,1,1,0,0,0,0,0,0,0,0,8,0,19,27,6,2,0,8
125047,2021,Iran,Argentina,1,3,21,25,23/06/2021,0,0,1,1,10,1,3,14,3,6,1,10,0,0,1,1,3,0,1,4
125047,2021,France,Argentina,0,2,9,11,22/06/2021,0,0,0,0,3,2,2,7,0,2,3,5,0,0,1,1,1,0,0,1
125047,2021,Poland,Argentina,0,2,9,11,21/06/2021,0,0,0,0,8,0,2,10,0,5,5,10,1,0,2,3,3,3,2,8
125047,2021,Argentina,Serbia,0,1,12,13,17/06/2021,0,0,1,1,6,3,2,11,2,7,2,11,1,0,0,1,0,0,1,1
125047,2021,Argentina,Russia,0,0,0,0,16/06/2021,0,0,0,0,0,0,0,0,0,0,0,0,0,0,0,0,0,0,0,0
125047,2021,Argentina,Bulgaria,0,0,0,0,15/06/2021,0,0,0,0,0,0,0,0,0,0,0,0,0,0,0,0,0,0,0,0
125047,2021,Japan,Argentina,0,0,0,0,11/6/2021,0,0,0,0,0,0,0,0,0,0,0,0,0,0,0,0,0,0,0,0
125047,2021,Argentina,Australia,1,2,6,9,10/6/2021,0,0,0,0,5,0,6,11,4,4,0,8,1,0,0,1,2,0,0,2
125047,2021,Argentina,Italy,0,0,1,1,9/6/2021,0,0,0,0,1,1,1,3,0,2,0,2,0,0,1,1,1,0,0,1
125047,2021,Netherlands,Argentina,0,0,0,0,5/6/2021,0,0,0,0,0,0,0,0,0,0,0,0,0,0,0,0,0,0,0,0
125047,2021,Argentina,Slovenia,0,1,7,8,4/6/2021,0,1,1,2,5,1,3,9,1,4,5,10,1,0,0,1,3,1,3,7
125047,2021,Germany,Argentina,0,0,0,0,3/6/2021,0,0,0,0,0,0,0,0,0,0,0,0,0,0,0,0,0,0,0,0
125047,2021,USA,Argentina,0,2,11,13,30/05/2021,0,0,0,0,4,1,2,7,3,5,1,9,0,1,0,1,1,1,0,2
125047,2021,Argentina,Canada,1,2,6,9,29/05/2021,0,0,0,0,3,0,1,4,1,5,0,6,3,0,0,3,2,1,0,3
125047,2021,Brazil,Argentina,1,2,7,10,28/05/2021,0,0,0,0,5,1,1,7,4,2,0,6,0,0,0,0,2,0,0,2
135349,2021,Iran,Argentina,0,0,0,0,23/06/2021,0,0,0,0,0,0,0,0,0,0,0,0,0,0,0,0,0,0,0,0
135349,2021,France,Argentina,0,0,0,0,22/06/2021,0,0,0,0,0,0,0,0,0,0,0,0,0,0,0,0,0,0,0,0
135349,2021,Poland,Argentina,0,0,0,0,21/06/2021,0,0,0,0,0,0,0,0,0,0,0,0,0,0,0,0,0,0,0,0
135349,2021,Argentina,Serbia,0,0,0,0,17/06/2021,0,0,0,0,0,0,0,0,0,0,0,0,0,0,0,0,0,0,0,0
135349,2021,Argentina,Russia,0,0,0,0,16/06/2021,0,0,0,0,0,0,0,0,0,0,0,0,0,0,0,0,0,0,0,0
135349,2021,Argentina,Bulgaria,0,0,0,0,15/06/2021,0,0,0,0,0,0,0,0,0,0,0,0,0,0,0,0,0,0,0,0
135349,2021,Japan,Argentina,0,0,0,0,11/6/2021,0,0,1,1,0,0,0,0,0,0,0,0,9,0,11,20,13,5,2,20
135349,2021,Argentina,Australia,0,0,0,0,10/6/2021,0,0,3,3,0,0,0,0,0,0,0,0,5,0,5,10,5,3,1,9
135349,2021,Argentina,Italy,0,0,0,0,9/6/2021,0,0,0,0,0,0,0,0,0,0,0,0,0,0,0,0,0,0,0,0
135349,2021,Netherlands,Argentina,0,0,0,0,5/6/2021,0,0,3,3,0,0,0,0,0,0,0,0,2,2,8,12,9,3,1,13
135349,2021,Argentina,Slovenia,0,0,0,0,4/6/2021,0,0,3,3,0,0,0,0,0,0,0,0,2,2,6,10,4,4,2,10
135349,2021,Germany,Argentina,0,0,0,0,3/6/2021,0,0,2,2,0,0,0,0,0,0,0,0,13,1,14,28,12,2,2,16
144457,2021,Australia,Netherlands,0,1,3,4,23/06/2021,0,0,0,0,0,3,1,4,0,1,0,1,0,0,0,0,1,0,0,1
144457,2021,Canada,Australia,0,1,2,3,22/06/2021,0,1,2,3,3,2,7,12,0,2,1,3,0,0,0,0,2,1,2,5
144457,2021,Australia,Serbia,0,2,11,13,21/06/2021,0,0,2,2,7,9,7,23,0,4,2,6,0,0,0,0,1,2,0,3
144457,2021,Australia,Brazil,0,1,7,8,17/06/2021,0,0,0,0,10,4,11,25,0,4,1,5,0,0,0,0,2,1,0,3
144457,2021,Slovenia,Australia,0,2,9,11,16/06/2021,0,0,1,1,7,2,10,19,1,3,1,5,0,0,0,0,1,2,0,3
144457,2021,Iran,Australia,3,2,22,27,15/06/2021,0,0,2,2,12,4,9,25,0,2,1,3,1,0,1,2,2,5,0,7
144457,2021,Australia,Italy,0,0,6,6,11/6/2021,0,0,0,0,5,5,3,13,0,1,2,3,0,0,0,0,2,2,0,4
144457,2021,Argentina,Australia,0,0,6,6,10/6/2021,0,0,0,0,6,0,4,10,0,1,0,1,0,0,1,1,1,1,0,2
144457,2021,Japan,Australia,0,0,9,9,9/6/2021,0,0,2,2,5,2,3,10,0,2,3,5,0,0,0,0,1,5,0,6
144457,2021,USA,Australia,0,4,3,7,5/6/2021,0,0,2,2,7,6,9,22,0,2,1,3,0,0,0,0,4,0,0,4
144457,2021,Russia,Australia,0,2,9,11,4/6/2021,0,0,0,0,6,8,11,25,0,1,0,1,0,0,0,0,1,1,0,2
144457,2021,Australia,Poland,0,1,3,4,3/6/2021,0,0,1,1,2,3,3,8,0,0,0,0,0,1,0,1,1,4,0,5
144457,2021,Australia,France,0,5,12,17,30/05/2021,0,1,0,1,13,5,8,26,1,2,2,5,0,0,0,0,4,2,1,7
144457,2021,Australia,Bulgaria,0,2,4,6,29/05/2021,0,0,0,0,6,6,4,16,0,1,0,1,0,2,1,3,1,2,1,4
144457,2021,Germany,Australia,0,2,8,10,28/05/2021,0,0,0,0,7,1,4,12,0,2,2,4,0,0,0,0,0,1,0,1
144456,2021,Australia,Netherlands,0,0,9,9,23/06/2021,13,0,41,54,2,1,1,4,2,0,1,3,0,0,0,0,3,3,0,6
144456,2021,Canada,Australia,0,1,5,6,22/06/2021,9,1,39,49,1,1,1,3,0,2,0,2,0,0,0,0,3,1,2,6
144456,2021,Australia,Serbia,1,0,12,13,21/06/2021,18,0,59,77,2,0,1,3,1,4,1,6,0,0,0,0,10,3,0,13
144456,2021,Australia,Brazil,0,1,7,8,17/06/2021,7,0,50,57,2,0,3,5,0,2,1,3,0,0,0,0,5,3,1,9
144456,2021,Slovenia,Australia,3,4,12,19,16/06/2021,23,0,48,71,1,0,2,3,1,3,1,5,0,0,0,0,6,3,1,10
144456,2021,Iran,Australia,1,3,14,18,15/06/2021,17,1,82,100,1,1,3,5,1,3,1,5,0,0,0,0,4,5,0,9
144456,2021,Australia,Italy,0,4,6,10,11/6/2021,13,1,47,61,3,0,1,4,1,1,5,7,0,0,0,0,2,1,1,4
144456,2021,Argentina,Australia,1,1,7,9,10/6/2021,11,1,46,58,0,0,3,3,2,0,0,2,0,0,1,1,4,8,1,13
144456,2021,Japan,Australia,0,2,11,13,9/6/2021,26,1,75,102,2,1,4,7,2,4,2,8,0,0,1,1,9,5,1,15
144456,2021,USA,Australia,0,2,6,8,5/6/2021,14,1,51,66,2,0,3,5,0,2,0,2,0,0,0,0,4,4,3,11
144456,2021,Russia,Australia,1,3,8,12,4/6/2021,13,0,52,65,2,1,2,5,1,3,1,5,0,0,1,1,2,2,1,5
144456,2021,Australia,Poland,0,2,3,5,3/6/2021,8,1,40,49,0,0,2,2,0,0,1,1,0,0,1,1,0,0,0,0
144456,2021,Australia,France,1,2,9,12,30/05/2021,31,1,67,99,2,0,5,7,1,2,0,3,0,0,1,1,5,2,2,9
144456,2021,Australia,Bulgaria,0,0,9,9,29/05/2021,10,1,53,64,3,2,1,6,0,1,0,1,0,0,0,0,3,2,2,7
144456,2021,Germany,Australia,0,5,2,7,28/05/2021,12,3,36,51,2,0,1,3,1,2,0,3,0,0,0,0,3,1,0,4
162262,2021,Australia,Netherlands,0,0,0,0,23/06/2021,0,0,0,0,0,0,0,0,0,0,0,0,0,0,0,0,0,0,0,0
162262,2021,Canada,Australia,0,0,0,0,22/06/2021,0,0,0,0,0,0,0,0,0,0,0,0,0,0,0,0,0,0,0,0
162262,2021,Australia,Serbia,0,0,0,0,21/06/2021,0,0,0,0,0,0,0,0,0,0,0,0,0,0,0,0,0,0,0,0
162262,2021,Australia,Italy,0,0,0,0,11/6/2021,0,0,0,0,0,0,0,0,0,0,0,0,0,0,0,0,0,0,0,0
162262,2021,Argentina,Australia,0,0,3,3,10/6/2021,0,0,0,0,0,0,0,0,0,1,0,1,0,0,0,0,0,0,0,0
162262,2021,Australia,France,0,0,0,0,30/05/2021,0,0,0,0,0,0,0,0,0,0,0,0,0,0,0,0,0,0,0,0
162262,2021,Australia,Bulgaria,0,0,0,0,29/05/2021,0,0,0,0,0,0,0,0,0,0,0,0,0,0,0,0,0,0,0,0
162077,2021,Australia,Netherlands,0,0,0,0,23/06/2021,0,0,0,0,0,0,0,0,0,0,0,0,0,0,0,0,0,0,0,0
162077,2021,Canada,Australia,0,2,6,8,22/06/2021,0,0,2,2,1,1,5,7,0,2,1,3,0,0,0,0,1,0,1,2
162077,2021,Australia,Serbia,1,1,9,11,21/06/2021,0,0,1,1,6,4,3,13,3,1,0,4,0,0,0,0,1,1,0,2
162077,2021,Australia,Brazil,0,2,1,3,17/06/2021,0,0,0,0,1,0,0,1,0,0,0,0,0,0,0,0,0,0,0,0
162077,2021,Slovenia,Australia,0,0,1,1,16/06/2021,0,0,0,0,0,0,0,0,0,0,0,0,0,0,0,0,0,0,0,0
162077,2021,Iran,Australia,0,0,1,1,15/06/2021,0,0,0,0,0,0,0,0,0,0,0,0,0,0,0,0,0,0,0,0
162077,2021,Australia,Italy,0,0,0,0,11/6/2021,0,0,0,0,0,0,0,0,0,0,0,0,0,0,0,0,0,0,0,0
162077,2021,Argentina,Australia,0,2,4,6,10/6/2021,0,0,2,2,3,3,2,8,0,1,1,2,0,0,0,0,1,3,0,4
162077,2021,Japan,Australia,0,0,1,1,9/6/2021,0,0,0,0,0,0,0,0,0,0,0,0,0,0,0,0,0,0,0,0
162077,2021,USA,Australia,0,0,2,2,5/6/2021,0,0,0,0,0,0,0,0,0,0,0,0,0,0,0,0,0,0,0,0
162077,2021,Russia,Australia,0,0,0,0,4/6/2021,0,0,0,0,0,0,0,0,0,0,0,0,0,0,0,0,0,0,0,0
162077,2021,Australia,Poland,1,1,3,5,3/6/2021,0,0,0,0,1,2,2,5,0,3,0,3,0,0,0,0,0,1,0,1
162077,2021,Australia,France,2,1,3,6,30/05/2021,0,0,0,0,2,1,2,5,0,4,1,5,1,0,0,1,1,0,0,1
162077,2021,Australia,Bulgaria,0,3,5,8,29/05/2021,0,0,0,0,2,0,0,2,0,0,1,1,0,1,1,2,0,0,0,0
162077,2021,Germany,Australia,0,1,10,11,28/05/2021,0,0,0,0,2,0,1,3,1,3,1,5,0,0,0,0,1,2,0,3
144464,2021,Australia,Netherlands,0,0,8,8,23/06/2021,0,0,3,3,4,0,6,10,0,4,3,7,0,0,1,1,0,2,0,2
144464,2021,Canada,Australia,0,2,2,4,22/06/2021,0,0,0,0,2,0,2,4,0,2,2,4,0,0,2,2,1,0,0,1
144464,2021,Australia,Serbia,1,1,8,10,21/06/2021,0,0,1,1,3,1,3,7,0,2,0,2,0,0,1,1,1,1,0,2
144464,2021,Australia,Brazil,1,1,4,6,17/06/2021,0,0,0,0,0,3,5,8,0,0,2,2,0,0,0,0,2,1,0,3
144464,2021,Slovenia,Australia,0,3,10,13,16/06/2021,0,0,2,2,2,4,1,7,3,4,3,10,1,0,2,3,2,0,0,2
144464,2021,Iran,Australia,0,2,11,13,15/06/2021,0,0,0,0,13,2,4,19,4,2,0,6,1,0,0,1,1,0,0,1
144464,2021,Australia,Italy,0,0,7,7,11/6/2021,0,0,5,5,4,2,2,8,2,2,1,5,0,0,0,0,0,2,1,3
144464,2021,Argentina,Australia,0,0,9,9,10/6/2021,0,0,1,1,4,1,7,12,3,4,0,7,1,0,0,1,0,1,0,1
144464,2021,Japan,Australia,0,3,10,13,9/6/2021,0,0,0,0,8,1,5,14,0,5,6,11,1,0,0,1,1,1,0,2
144464,2021,USA,Australia,0,0,12,12,5/6/2021,0,0,1,1,7,1,0,8,0,2,2,4,0,0,0,0,2,0,2,4
144464,2021,Russia,Australia,0,0,12,12,4/6/2021,0,0,1,1,3,2,4,9,2,3,1,6,0,0,1,1,3,1,0,4
144464,2021,Australia,Poland,0,0,3,3,3/6/2021,0,0,0,0,1,0,2,3,0,1,0,1,0,2,0,2,0,0,0,0
144464,2021,Australia,France,0,2,16,18,30/05/2021,0,0,0,0,7,1,3,11,0,6,10,16,0,0,1,1,2,0,2,4
144464,2021,Australia,Bulgaria,0,0,2,2,29/05/2021,0,0,0,0,1,0,3,4,0,1,2,3,0,0,0,0,0,0,0,0
144464,2021,Germany,Australia,0,0,0,0,28/05/2021,0,0,0,0,0,0,0,0,0,0,0,0,0,0,0,0,0,0,0,0
144578,2021,Australia,Netherlands,0,0,0,0,23/06/2021,0,0,5,5,0,0,0,0,0,0,0,0,3,0,2,5,8,3,0,11
144578,2021,Canada,Australia,0,0,0,0,22/06/2021,0,0,9,9,0,0,0,0,0,0,0,0,3,0,7,10,7,2,4,13
144578,2021,Australia,Serbia,0,0,0,0,21/06/2021,0,0,10,10,0,0,0,0,0,0,0,0,8,0,8,16,4,3,0,7
144578,2021,Australia,Brazil,0,0,0,0,17/06/2021,0,0,11,11,0,0,0,0,0,0,0,0,5,0,5,10,8,2,0,10
144578,2021,Slovenia,Australia,0,0,0,0,16/06/2021,0,0,13,13,0,0,0,0,0,0,0,0,9,2,6,17,11,4,3,18
144578,2021,Iran,Australia,0,0,0,0,15/06/2021,0,0,14,14,0,0,0,0,0,0,0,0,13,0,5,18,14,8,2,24
144578,2021,Australia,Italy,0,0,0,0,11/6/2021,0,0,9,9,0,0,0,0,0,0,0,0,2,0,11,13,10,1,2,13
144578,2021,Argentina,Australia,0,0,0,0,10/6/2021,0,0,10,10,0,0,0,0,0,0,0,0,7,1,7,15,4,1,0,5
144578,2021,Japan,Australia,0,0,0,0,9/6/2021,0,0,15,15,0,0,0,0,0,0,0,0,7,1,11,19,14,5,0,19
144578,2021,USA,Australia,0,0,0,0,5/6/2021,0,0,8,8,0,0,0,0,0,0,0,0,7,1,6,14,7,2,1,10
144578,2021,Russia,Australia,0,0,0,0,4/6/2021,0,0,10,10,0,0,0,0,0,0,0,0,8,0,6,14,5,0,0,5
144578,2021,Australia,Poland,0,0,0,0,3/6/2021,0,0,7,7,0,0,0,0,0,0,0,0,10,2,8,20,2,1,0,3
144578,2021,Australia,France,0,0,0,0,30/05/2021,0,0,7,7,0,0,0,0,0,0,0,0,6,1,11,18,17,0,0,17
144578,2021,Australia,Bulgaria,0,0,0,0,29/05/2021,0,0,3,3,0,0,0,0,0,0,0,0,6,3,9,18,12,3,1,16
144578,2021,Germany,Australia,0,0,0,0,28/05/2021,0,0,3,3,0,0,0,0,0,0,0,0,5,0,12,17,6,4,1,11
144461,2021,Australia,Netherlands,0,1,10,11,23/06/2021,0,0,0,0,8,2,0,10,2,4,0,6,0,0,2,2,2,1,0,3
144461,2021,Canada,Australia,1,1,5,7,22/06/2021,0,0,0,0,2,0,6,8,0,3,2,5,0,0,1,1,3,0,0,3
144461,2021,Australia,Serbia,0,0,0,0,21/06/2021,0,0,0,0,0,0,0,0,0,0,0,0,0,0,0,0,0,0,0,0
144461,2021,Australia,Brazil,0,0,8,8,17/06/2021,0,0,4,4,3,1,5,9,1,4,2,7,0,0,0,0,5,1,0,6
144461,2021,Slovenia,Australia,0,0,11,11,16/06/2021,0,0,1,1,9,3,7,19,2,3,4,9,1,0,0,1,4,0,0,4
144461,2021,Iran,Australia,0,1,11,12,15/06/2021,0,0,1,1,8,3,7,18,4,1,0,5,3,0,1,4,1,2,0,3
144461,2021,Australia,Italy,0,2,10,12,11/6/2021,1,1,0,2,7,1,5,13,1,5,4,10,0,0,2,2,3,2,0,5
144461,2021,Japan,Australia,0,3,14,17,9/6/2021,0,0,1,1,11,2,2,15,3,2,6,11,2,0,1,3,6,4,2,12
144461,2021,USA,Australia,0,0,10,10,5/6/2021,0,0,3,3,3,1,4,8,0,3,4,7,0,0,0,0,3,3,1,7
144461,2021,Russia,Australia,0,0,13,13,4/6/2021,0,1,2,3,5,0,1,6,0,4,2,6,2,0,0,2,4,1,0,5
144461,2021,Australia,Poland,0,0,9,9,3/6/2021,0,0,1,1,5,0,3,8,0,3,0,3,1,0,0,1,2,0,0,2
144461,2021,Australia,France,0,0,10,10,30/05/2021,0,0,0,0,7,0,4,11,2,3,7,12,1,0,2,3,2,0,1,3
144461,2021,Australia,Bulgaria,1,1,10,12,29/05/2021,0,0,0,0,1,1,5,7,2,4,5,11,0,0,0,0,2,0,0,2
144461,2021,Germany,Australia,0,1,8,9,28/05/2021,0,0,0,0,5,1,4,10,1,3,2,6,1,0,1,2,2,0,0,2
120515,2021,Australia,Brazil,1,0,10,11,17/06/2021,0,0,0,0,8,1,10,19,2,3,2,7,6,1,17,24,5,2,0,7
120515,2021,Slovenia,Australia,0,1,11,12,16/06/2021,0,0,1,1,12,2,8,22,2,1,0,3,10,1,25,36,4,4,0,8
120515,2021,Iran,Australia,0,1,16,17,15/06/2021,0,0,0,0,11,8,13,32,2,5,0,7,15,1,20,36,3,3,0,6
120515,2021,Australia,Italy,1,2,7,10,11/6/2021,1,0,5,6,8,2,8,18,0,2,1,3,9,0,15,24,5,3,0,8
120515,2021,Argentina,Australia,0,2,9,11,10/6/2021,0,0,1,1,9,1,8,18,2,0,0,2,10,4,17,31,2,4,0,6
120515,2021,Japan,Australia,1,2,14,17,9/6/2021,0,0,3,3,18,3,16,37,0,2,3,5,6,3,28,37,8,2,0,10
120515,2021,USA,Australia,0,0,12,12,5/6/2021,0,0,1,1,6,2,9,17,0,3,2,5,3,1,15,19,1,1,1,3
120515,2021,Russia,Australia,1,1,7,9,4/6/2021,0,0,1,1,11,2,12,25,1,2,2,5,9,2,10,21,4,3,0,7
120515,2021,Australia,Poland,0,1,4,5,3/6/2021,0,0,1,1,5,6,4,15,0,0,0,0,7,3,13,23,0,0,0,0
120515,2021,Australia,France,0,5,8,13,30/05/2021,0,0,0,0,8,3,11,22,4,3,0,7,7,3,17,27,6,0,0,6
120515,2021,Australia,Bulgaria,0,2,10,12,29/05/2021,0,0,0,0,9,4,6,19,0,1,0,1,2,2,13,17,4,2,2,8
120515,2021,Germany,Australia,0,4,5,9,28/05/2021,0,0,0,0,10,3,8,21,0,6,1,7,2,3,8,13,0,0,0,0
132961,2021,Iran,Australia,0,1,0,1,15/06/2021,0,0,0,0,1,0,0,1,0,0,0,0,3,1,2,6,0,1,0,1
158841,2021,Australia,Netherlands,0,0,0,0,23/06/2021,0,0,0,0,0,0,0,0,0,0,0,0,0,0,0,0,0,0,0,0
158841,2021,Canada,Australia,0,0,1,1,22/06/2021,2,0,9,11,1,0,0,1,1,1,0,2,0,0,0,0,0,0,0,0
158841,2021,Australia,Serbia,0,0,0,0,21/06/2021,1,0,3,4,0,0,0,0,0,0,0,0,0,0,0,0,0,1,0,1
158841,2021,Australia,Brazil,0,1,0,1,17/06/2021,2,0,15,17,0,0,0,0,0,0,0,0,0,0,0,0,2,0,0,2
158841,2021,Slovenia,Australia,0,0,0,0,16/06/2021,2,0,2,4,0,0,0,0,0,0,0,0,0,0,0,0,1,0,0,1
158841,2021,Iran,Australia,0,0,0,0,15/06/2021,2,0,4,6,0,0,0,0,0,0,0,0,0,0,0,0,2,0,0,2
158841,2021,Australia,Italy,0,0,0,0,11/6/2021,0,0,0,0,0,0,0,0,0,0,0,0,0,0,0,0,0,0,0,0
158841,2021,Argentina,Australia,0,0,1,1,10/6/2021,0,0,0,0,0,0,0,0,0,0,0,0,0,0,0,0,0,0,0,0
158841,2021,Japan,Australia,0,0,0,0,9/6/2021,0,0,0,0,0,0,0,0,0,0,0,0,0,0,0,0,0,0,0,0
158841,2021,USA,Australia,0,0,0,0,5/6/2021,0,0,0,0,0,0,0,0,0,0,0,0,0,0,0,0,0,0,0,0
158841,2021,Russia,Australia,0,0,0,0,4/6/2021,0,0,0,0,0,0,0,0,0,0,0,0,0,0,0,0,0,0,0,0
158841,2021,Australia,Poland,0,0,0,0,3/6/2021,0,0,8,8,0,0,0,0,0,0,0,0,0,0,0,0,0,0,0,0
158841,2021,Australia,France,0,0,0,0,30/05/2021,0,0,0,0,0,0,0,0,0,0,0,0,0,0,0,0,2,0,0,2
158841,2021,Australia,Bulgaria,0,0,0,0,29/05/2021,0,0,0,0,0,0,0,0,0,0,0,0,0,0,0,0,0,0,0,0
158841,2021,Germany,Australia,0,0,0,0,28/05/2021,3,0,3,6,0,0,0,0,0,0,0,0,0,0,0,0,0,1,0,1
162870,2021,Australia,Netherlands,1,2,12,15,23/06/2021,0,0,1,1,4,2,5,11,1,4,0,5,12,2,12,26,3,3,0,6
162870,2021,Canada,Australia,1,2,5,8,22/06/2021,0,0,1,1,2,2,6,10,0,0,1,1,9,1,13,23,8,1,2,11
162870,2021,Australia,Serbia,1,2,4,7,21/06/2021,0,0,3,3,4,3,9,16,0,0,0,0,5,1,4,10,1,0,0,1
162870,2021,Australia,Brazil,0,0,2,2,17/06/2021,0,0,0,0,0,0,0,0,0,0,0,0,0,1,2,3,1,0,1,2
162870,2021,Slovenia,Australia,0,2,4,6,16/06/2021,0,0,0,0,3,0,2,5,1,1,2,4,6,0,4,10,0,0,1,1
162870,2021,Iran,Australia,0,0,1,1,15/06/2021,0,0,0,0,0,0,0,0,0,0,0,0,2,0,1,3,0,0,0,0
162870,2021,Australia,Italy,0,0,3,3,11/6/2021,1,0,0,1,1,3,2,6,0,0,0,0,3,0,5,8,0,2,0,2
162870,2021,Argentina,Australia,0,3,8,11,10/6/2021,0,0,0,0,6,1,9,16,0,0,0,0,6,0,6,12,0,1,0,1
162870,2021,Japan,Australia,0,1,12,13,9/6/2021,0,0,1,1,7,3,9,19,3,1,3,7,2,0,15,17,4,0,1,5
162870,2021,USA,Australia,1,1,1,3,5/6/2021,0,0,0,0,3,2,0,5,0,1,0,1,1,0,6,7,0,0,0,0
162870,2021,Russia,Australia,0,0,0,0,4/6/2021,0,0,0,0,0,0,0,0,0,0,0,0,0,0,0,0,0,0,0,0
162870,2021,Australia,Poland,0,0,0,0,3/6/2021,0,0,0,0,0,0,0,0,0,0,0,0,0,0,0,0,0,0,0,0
162870,2021,Australia,France,0,0,0,0,30/05/2021,0,0,0,0,0,0,0,0,0,0,0,0,0,0,0,0,0,0,0,0
162870,2021,Australia,Bulgaria,0,0,0,0,29/05/2021,0,0,0,0,0,0,0,0,0,0,0,0,0,0,0,0,0,0,0,0
162870,2021,Germany,Australia,0,0,0,0,28/05/2021,0,0,0,0,0,0,0,0,0,0,0,0,0,0,0,0,0,0,0,0
162267,2021,Australia,Netherlands,0,0,0,0,23/06/2021,0,0,0,0,0,0,0,0,0,0,0,0,0,0,0,0,0,0,0,0
162267,2021,Canada,Australia,0,0,0,0,22/06/2021,0,0,0,0,0,0,0,0,0,0,0,0,0,0,0,0,0,0,0,0
162267,2021,Australia,Serbia,0,1,0,1,21/06/2021,0,0,0,0,2,1,1,4,0,0,0,0,1,2,6,9,0,0,0,0
162267,2021,Australia,Brazil,0,0,0,0,17/06/2021,0,0,0,0,0,0,0,0,0,0,0,0,0,0,0,0,0,0,0,0
162267,2021,Slovenia,Australia,0,1,0,1,16/06/2021,0,0,0,0,3,0,0,3,0,0,0,0,0,0,0,0,0,0,0,0
162267,2021,Iran,Australia,0,0,0,0,15/06/2021,0,0,0,0,0,0,0,0,0,0,0,0,0,0,0,0,0,0,0,0
162267,2021,Australia,Italy,0,1,5,6,11/6/2021,0,0,1,1,4,1,5,10,0,2,0,2,1,3,8,12,4,0,0,4
162267,2021,Argentina,Australia,0,0,0,0,10/6/2021,0,0,0,0,0,0,0,0,0,0,0,0,0,0,0,0,0,0,0,0
162267,2021,Japan,Australia,0,2,2,4,9/6/2021,0,0,0,0,2,2,2,6,0,0,1,1,4,1,3,8,1,2,1,4
162267,2021,USA,Australia,0,2,4,6,5/6/2021,0,0,1,1,7,4,3,14,2,0,1,3,2,3,13,18,5,1,0,6
162267,2021,Russia,Australia,0,1,1,2,4/6/2021,0,0,0,0,0,1,4,5,0,0,0,0,2,1,3,6,1,0,0,1
162267,2021,Australia,Poland,0,1,0,1,3/6/2021,0,0,1,1,1,2,1,4,0,0,0,0,2,1,3,6,0,0,0,0
162267,2021,Australia,France,0,0,0,0,30/05/2021,0,0,0,0,1,3,3,7,0,0,0,0,0,2,0,2,1,0,0,1
162267,2021,Australia,Bulgaria,0,1,4,5,29/05/2021,0,0,0,0,2,1,4,7,1,1,1,3,1,3,3,7,1,2,0,3
162267,2021,Germany,Australia,0,0,0,0,28/05/2021,0,0,0,0,0,0,0,0,0,0,0,0,0,0,0,0,0,0,0,0
169335,2021,Australia,Netherlands,0,0,0,0,23/06/2021,0,0,0,0,0,0,0,0,0,0,0,0,1,1,1,3,1,1,0,2
169335,2021,Canada,Australia,0,1,3,4,22/06/2021,0,0,2,2,0,3,3,6,0,3,1,4,1,0,5,6,0,0,1,1
169335,2021,Australia,Serbia,0,2,1,3,21/06/2021,0,0,0,0,2,2,7,11,0,1,0,1,3,1,12,16,0,1,0,1
169335,2021,Australia,Brazil,0,2,3,5,17/06/2021,0,0,3,3,7,3,9,19,0,1,0,1,7,1,21,29,2,5,1,8
169335,2021,Slovenia,Australia,0,0,4,4,16/06/2021,0,1,2,3,2,4,5,11,0,4,1,5,3,1,5,9,0,1,0,1
169335,2021,Iran,Australia,1,6,8,15,15/06/2021,0,0,1,1,8,11,9,28,1,3,2,6,11,3,6,20,0,1,0,1
169335,2021,Japan,Australia,0,0,0,0,9/6/2021,0,0,0,0,0,0,0,0,0,0,0,0,0,0,0,0,0,0,0,0
169335,2021,Russia,Australia,0,1,5,6,4/6/2021,0,0,1,1,2,1,6,9,0,1,0,1,5,1,6,12,0,1,0,1
169335,2021,Australia,Poland,0,1,2,3,3/6/2021,0,0,0,0,2,5,4,11,1,3,1,5,1,1,5,7,2,2,0,4
169335,2021,Australia,France,0,6,7,13,30/05/2021,0,0,0,0,7,4,9,20,0,5,2,7,9,0,16,25,4,2,1,7
169335,2021,Australia,Bulgaria,0,1,5,6,29/05/2021,0,0,0,0,1,1,4,6,0,1,0,1,1,2,5,8,0,1,0,1
169335,2021,Germany,Australia,0,2,7,9,28/05/2021,0,0,0,0,2,3,5,10,0,3,0,3,5,2,14,21,2,2,0,4
162265,2021,Australia,Netherlands,0,2,2,4,23/06/2021,0,0,0,0,5,1,3,9,0,0,0,0,0,0,0,0,1,0,0,1
162265,2021,Canada,Australia,0,0,0,0,22/06/2021,0,0,0,0,0,0,0,0,0,0,0,0,0,0,0,0,0,0,0,0
162265,2021,Australia,Serbia,0,1,0,1,21/06/2021,0,0,0,0,0,1,0,1,0,0,0,0,0,0,0,0,0,0,0,0
162265,2021,Australia,Brazil,0,0,0,0,17/06/2021,0,0,0,0,0,0,0,0,0,0,0,0,0,0,0,0,0,0,0,0
162265,2021,Slovenia,Australia,0,0,0,0,16/06/2021,0,0,0,0,0,0,0,0,0,0,0,0,0,0,0,0,0,0,0,0
162265,2021,Iran,Australia,0,0,0,0,15/06/2021,0,0,0,0,0,0,0,0,0,0,0,0,0,0,0,0,0,0,0,0
162265,2021,Australia,Italy,0,1,0,1,11/6/2021,0,0,0,0,0,0,0,0,0,0,0,0,0,0,0,0,0,0,0,0
162265,2021,Argentina,Australia,0,0,0,0,10/6/2021,0,0,0,0,0,0,0,0,0,0,0,0,0,0,0,0,0,0,0,0
162265,2021,Japan,Australia,0,0,0,0,9/6/2021,0,0,0,0,0,0,0,0,0,0,0,0,0,0,0,0,0,0,0,0
162265,2021,USA,Australia,0,0,0,0,5/6/2021,0,0,0,0,0,0,0,0,0,0,0,0,0,0,0,0,0,0,0,0
162265,2021,Russia,Australia,0,0,0,0,4/6/2021,0,0,0,0,0,0,0,0,0,0,0,0,0,0,0,0,0,0,0,0
162265,2021,Australia,Poland,0,0,0,0,3/6/2021,0,0,0,0,0,0,0,0,0,0,0,0,0,0,0,0,0,0,0,0
162265,2021,Australia,France,0,0,0,0,30/05/2021,0,0,0,0,0,1,1,2,0,0,0,0,0,1,0,1,0,0,0,0
162265,2021,Australia,Bulgaria,0,1,1,2,29/05/2021,0,0,0,0,1,0,1,2,0,2,0,2,0,0,0,0,2,0,3,5
162265,2021,Germany,Australia,0,0,0,0,28/05/2021,0,0,0,0,0,1,1,2,0,1,0,1,0,0,0,0,0,0,0,0
181257,2021,Australia,Netherlands,0,4,8,12,23/06/2021,0,0,0,0,10,5,4,19,1,1,0,2,8,5,7,20,0,0,0,0
181257,2021,Canada,Australia,0,3,3,6,22/06/2021,0,0,0,0,10,5,12,27,0,1,4,5,2,4,10,16,1,2,1,4
181257,2021,Australia,Serbia,2,1,8,11,21/06/2021,0,0,0,0,8,3,10,21,2,3,0,5,10,2,14,26,10,5,0,15
181257,2021,Australia,Brazil,0,1,0,1,17/06/2021,0,0,0,0,4,1,4,9,0,0,0,0,0,0,0,0,0,0,0,0
181257,2021,Slovenia,Australia,0,0,1,1,16/06/2021,0,0,0,0,3,1,1,5,0,0,0,0,0,0,0,0,1,1,0,2
181257,2021,Iran,Australia,0,0,0,0,15/06/2021,0,0,0,0,1,0,0,1,0,0,0,0,0,0,0,0,0,0,0,0
181257,2021,Australia,Italy,0,0,2,2,11/6/2021,0,0,0,0,1,1,5,7,0,0,1,1,0,0,0,0,1,0,1,2
181257,2021,Argentina,Australia,0,2,1,3,10/6/2021,0,0,0,0,4,5,2,11,0,0,0,0,0,0,0,0,0,0,0,0
181257,2021,Japan,Australia,0,2,5,7,9/6/2021,0,0,0,0,6,1,11,18,0,2,0,2,0,0,0,0,1,0,1,2
181257,2021,USA,Australia,0,0,2,2,5/6/2021,0,0,2,2,1,2,3,6,0,1,0,1,0,1,0,1,2,0,0,2
181257,2021,Russia,Australia,0,0,0,0,4/6/2021,0,0,0,0,0,0,0,0,0,0,0,0,0,0,0,0,0,0,0,0
181257,2021,Australia,Poland,0,2,1,3,3/6/2021,0,0,0,0,3,0,7,10,0,1,0,1,0,0,0,0,1,1,0,2
178207,2021,Australia,Brazil,0,0,0,0,17/06/2021,0,0,0,0,0,0,0,0,0,0,0,0,0,0,0,0,0,0,0,0
178207,2021,Argentina,Australia,0,0,0,0,10/6/2021,0,0,0,0,0,0,0,0,0,0,0,0,0,0,0,0,0,0,0,0
178207,2021,USA,Australia,0,0,0,0,5/6/2021,0,0,0,0,0,0,0,0,0,0,0,0,0,0,0,0,0,0,0,0
178207,2021,Australia,Poland,0,1,0,1,3/6/2021,0,0,0,0,0,2,0,2,0,0,0,0,0,1,0,1,0,0,0,0
178207,2021,Australia,France,0,0,0,0,30/05/2021,0,0,0,0,0,0,0,0,0,0,0,0,0,0,0,0,0,0,0,0
178207,2021,Australia,Bulgaria,0,0,0,0,29/05/2021,0,0,0,0,0,0,0,0,0,0,0,0,0,0,0,0,0,0,0,0
178207,2021,Germany,Australia,0,0,0,0,28/05/2021,0,0,0,0,0,0,0,0,0,0,0,0,0,0,0,0,0,0,0,0
181247,2021,Australia,Netherlands,0,0,0,0,23/06/2021,0,0,0,0,0,0,0,0,0,0,0,0,0,0,0,0,0,0,0,0
181247,2021,Canada,Australia,0,0,0,0,22/06/2021,0,0,0,0,0,0,0,0,0,0,0,0,0,0,0,0,0,0,0,0
181247,2021,Australia,Serbia,0,0,0,0,21/06/2021,0,0,0,0,0,0,0,0,0,0,0,0,0,0,0,0,0,0,0,0
181247,2021,Slovenia,Australia,0,0,0,0,16/06/2021,0,0,0,0,0,0,0,0,0,0,0,0,0,0,0,0,0,0,0,0
181247,2021,Australia,Italy,0,0,0,0,11/6/2021,0,0,0,0,0,0,0,0,0,0,0,0,0,0,0,0,0,0,0,0
181247,2021,Argentina,Australia,0,0,0,0,10/6/2021,0,0,0,0,0,0,0,0,0,0,0,0,0,0,0,0,0,0,0,0
181247,2021,Japan,Australia,0,0,0,0,9/6/2021,0,0,0,0,0,0,0,0,0,0,0,0,0,0,0,0,0,0,0,0
181247,2021,USA,Australia,0,0,0,0,5/6/2021,0,0,0,0,0,0,0,0,0,0,0,0,0,0,0,0,0,0,0,0
181247,2021,Russia,Australia,0,0,0,0,4/6/2021,0,0,0,0,0,0,0,0,0,0,0,0,0,0,0,0,0,0,0,0
181247,2021,Germany,Australia,0,0,0,0,28/05/2021,0,0,0,0,0,0,0,0,0,0,0,0,0,0,0,0,0,0,0,0
116099,2021,Brazil,Poland,1,0,14,15,27/06/2021,22,0,63,85,0,0,0,0,0,4,1,5,0,0,0,0,11,4,0,15
116099,2021,Brazil,France,0,0,9,9,26/06/2021,18,1,48,67,0,0,0,0,1,2,3,6,0,0,0,0,4,1,0,5
116099,2021,Brazil,Russia,0,1,6,7,23/06/2021,15,0,27,42,0,0,0,0,0,1,1,2,0,0,0,0,2,5,3,10
116099,2021,Brazil,Germany,0,0,0,0,22/06/2021,1,0,1,2,0,0,0,0,0,0,0,0,0,0,0,0,0,0,0,0
116099,2021,Brazil,Italy,0,0,18,18,21/06/2021,36,0,68,104,0,0,0,0,0,5,5,10,0,0,0,0,14,2,5,21
116099,2021,Australia,Brazil,0,1,11,12,17/06/2021,25,0,36,61,2,0,1,3,1,2,0,3,0,0,0,0,9,1,4,14
116099,2021,Iran,Brazil,0,0,0,0,16/06/2021,0,0,5,5,0,0,0,0,0,0,0,0,0,0,0,0,0,0,0,0
116099,2021,Brazil,Slovenia,0,0,9,9,15/06/2021,31,0,59,90,0,0,0,0,1,2,4,7,0,0,0,0,9,2,2,13
116099,2021,Poland,Brazil,0,0,11,11,11/6/2021,11,0,60,71,2,0,0,2,0,3,3,6,0,0,0,0,5,0,0,5
116099,2021,Bulgaria,Brazil,0,0,0,0,10/6/2021,1,0,3,4,0,0,0,0,0,0,0,0,0,0,0,0,0,0,0,0
116099,2021,Netherlands,Brazil,0,0,11,11,9/6/2021,18,1,49,68,2,0,1,3,1,0,3,4,0,0,0,0,8,0,0,8
116099,2021,Brazil,Serbia,0,0,16,16,5/6/2021,39,1,41,81,1,0,0,1,2,2,2,6,0,0,0,0,6,1,2,9
116099,2021,Brazil,Japan,0,0,0,0,4/6/2021,0,0,2,2,0,0,0,0,0,0,0,0,0,0,0,0,0,0,0,0
116099,2021,Brazil,France,0,1,9,10,3/6/2021,37,0,48,85,0,0,0,0,1,3,5,9,0,0,0,0,5,3,1,9
116099,2021,Canada,Brazil,0,0,0,0,30/05/2021,2,0,3,5,0,0,0,0,0,0,0,0,0,0,0,0,2,0,0,2
116099,2021,USA,Brazil,2,2,10,14,29/05/2021,7,0,59,66,0,0,2,2,0,0,0,0,0,0,0,0,1,0,0,1
116099,2021,Brazil,Argentina,2,3,11,16,28/05/2021,19,0,52,71,2,0,1,3,0,2,0,2,0,0,1,1,6,3,0,9
136955,2021,Brazil,Germany,0,0,1,1,22/06/2021,0,0,0,0,0,0,0,0,0,0,0,0,0,0,0,0,0,0,0,0
136955,2021,Brazil,Italy,0,1,2,3,21/06/2021,0,0,0,0,0,0,0,0,0,0,0,0,0,0,0,0,0,0,0,0
136955,2021,Australia,Brazil,1,1,2,4,17/06/2021,0,0,2,2,3,0,1,4,0,0,0,0,0,0,1,1,1,0,0,1
136955,2021,Iran,Brazil,0,0,1,1,16/06/2021,0,0,0,0,0,0,2,2,0,0,0,0,0,0,0,0,0,0,0,0
132030,2021,Brazil,Poland,0,0,0,0,27/06/2021,0,0,0,0,0,0,0,0,0,0,0,0,0,0,0,0,0,0,0,0
132030,2021,Brazil,France,0,0,0,0,26/06/2021,0,0,0,0,0,0,0,0,0,0,0,0,0,0,0,0,0,0,0,0
132030,2021,Brazil,Russia,0,1,2,3,23/06/2021,0,0,0,0,3,3,0,6,0,0,0,0,0,1,2,3,2,0,0,2
132030,2021,Brazil,Germany,1,3,9,13,22/06/2021,0,0,2,2,8,5,6,19,2,0,0,2,8,2,8,18,7,0,0,7
132030,2021,Brazil,Italy,0,0,0,0,21/06/2021,1,0,0,1,1,0,0,1,0,0,0,0,1,0,4,5,1,0,0,1
132030,2021,Australia,Brazil,0,1,7,8,17/06/2021,0,0,7,7,10,1,7,18,1,1,4,6,4,0,9,13,4,0,0,4
132030,2021,Iran,Brazil,0,0,0,0,16/06/2021,0,0,0,0,0,0,0,0,0,0,0,0,1,1,5,7,0,1,0,1
132030,2021,Brazil,Slovenia,0,0,0,0,15/06/2021,0,0,0,0,0,0,0,0,0,0,0,0,0,0,1,1,1,1,0,2
132030,2021,Poland,Brazil,0,0,0,0,11/6/2021,0,0,0,0,0,0,0,0,0,0,0,0,0,1,1,2,0,0,0,0
132030,2021,Bulgaria,Brazil,0,0,0,0,10/6/2021,0,0,0,0,0,0,0,0,0,0,0,0,0,0,0,0,0,0,0,0
132030,2021,Netherlands,Brazil,0,1,13,14,9/6/2021,0,0,5,5,3,6,7,16,0,2,3,5,11,4,7,22,2,0,0,2
132030,2021,Brazil,Serbia,0,0,0,0,5/6/2021,0,0,0,0,0,0,0,0,0,0,0,0,0,0,0,0,0,0,0,0
132030,2021,Brazil,Japan,0,0,2,2,4/6/2021,0,0,0,0,1,0,1,2,0,0,0,0,0,0,4,4,1,3,0,4
132030,2021,Brazil,France,0,0,0,0,3/6/2021,0,0,0,0,0,0,0,0,0,0,0,0,0,0,1,1,0,0,0,0
132030,2021,Canada,Brazil,2,3,10,15,30/05/2021,0,0,0,0,7,3,8,18,0,1,3,4,8,2,15,25,5,2,1,8
132030,2021,USA,Brazil,0,0,0,0,29/05/2021,0,0,0,0,0,0,0,0,0,0,0,0,0,0,0,0,0,0,0,0
132030,2021,Brazil,Argentina,0,0,0,0,28/05/2021,0,0,0,0,0,0,0,0,0,0,0,0,0,0,0,0,0,0,0,0
142744,2021,Brazil,Poland,0,0,0,0,27/06/2021,0,0,0,0,0,0,0,0,0,0,0,0,0,0,0,0,0,0,0,0
142744,2021,Brazil,France,0,0,0,0,26/06/2021,0,0,0,0,0,0,0,0,0,0,0,0,0,0,0,0,0,0,0,0
142744,2021,Brazil,Russia,0,1,3,4,23/06/2021,3,0,15,18,0,0,0,0,0,0,1,1,0,0,0,0,1,0,0,1
142744,2021,Brazil,Germany,0,1,7,8,22/06/2021,23,0,50,73,1,0,0,1,0,4,1,5,0,0,0,0,4,2,0,6
142744,2021,Brazil,Italy,0,0,0,0,21/06/2021,1,0,0,1,0,0,0,0,0,0,0,0,0,0,0,0,0,0,0,0
142744,2021,Australia,Brazil,0,0,0,0,17/06/2021,0,0,0,0,0,0,0,0,0,0,0,0,0,0,0,0,0,0,0,0
142744,2021,Iran,Brazil,0,2,15,17,16/06/2021,7,0,77,84,2,0,0,2,1,2,0,3,0,0,1,1,9,2,0,11
142744,2021,Brazil,Slovenia,0,0,0,0,15/06/2021,1,0,6,7,0,0,0,0,0,1,0,1,0,0,0,0,0,0,0,0
142744,2021,Poland,Brazil,0,0,0,0,11/6/2021,0,0,0,0,0,0,0,0,0,0,0,0,0,0,0,0,0,0,0,0
142744,2021,Bulgaria,Brazil,2,0,8,10,10/6/2021,19,0,26,45,0,1,0,1,0,1,0,1,0,0,0,0,1,2,0,3
142744,2021,Netherlands,Brazil,0,0,0,0,9/6/2021,1,0,1,2,0,0,0,0,0,0,0,0,0,0,0,0,0,0,0,0
142744,2021,Brazil,Serbia,0,0,0,0,5/6/2021,0,0,1,1,0,0,0,0,0,0,0,0,0,0,0,0,0,0,0,0
142744,2021,Brazil,Japan,0,1,6,7,4/6/2021,31,0,34,65,0,0,1,1,0,1,2,3,0,0,0,0,10,1,1,12
142744,2021,Brazil,France,0,0,1,1,3/6/2021,2,0,5,7,0,0,0,0,0,0,0,0,0,0,0,0,1,0,0,1
142744,2021,Canada,Brazil,1,0,12,13,30/05/2021,24,2,76,102,0,0,1,1,1,2,0,3,0,0,1,1,8,2,0,10
142744,2021,USA,Brazil,0,0,0,0,29/05/2021,0,0,0,0,0,0,0,0,0,0,0,0,0,0,0,0,0,0,0,0
142744,2021,Brazil,Argentina,0,0,0,0,28/05/2021,0,0,1,1,0,0,0,0,0,0,0,0,0,0,0,0,0,1,0,1
112869,2021,Brazil,Poland,1,4,14,19,27/06/2021,0,0,1,1,18,7,6,31,3,3,6,12,1,0,0,1,4,2,0,6
112869,2021,Brazil,France,1,0,11,12,26/06/2021,0,0,1,1,11,2,6,19,1,0,4,5,0,0,0,0,2,0,0,2
112869,2021,Brazil,Russia,2,3,4,9,23/06/2021,0,0,0,0,6,3,2,11,2,2,2,6,0,0,0,0,4,0,1,5
112869,2021,Brazil,Germany,0,0,0,0,22/06/2021,0,0,0,0,0,0,0,0,0,0,0,0,0,0,0,0,0,0,0,0
112869,2021,Brazil,Italy,0,4,11,15,21/06/2021,0,0,1,1,19,3,7,29,1,5,4,10,0,0,3,3,4,1,0,5
112869,2021,Australia,Brazil,0,0,0,0,17/06/2021,0,0,0,0,0,0,0,0,0,0,0,0,0,0,0,0,0,0,0,0
112869,2021,Iran,Brazil,0,0,0,0,16/06/2021,0,0,0,0,0,0,0,0,0,0,0,0,0,0,0,0,0,0,0,0
112869,2021,Brazil,Slovenia,1,4,15,20,15/06/2021,0,0,3,3,17,2,7,26,0,4,3,7,0,0,0,0,5,3,2,10
112869,2021,Poland,Brazil,0,2,12,14,11/6/2021,0,0,2,2,17,4,6,27,1,2,0,3,0,0,1,1,3,2,0,5
112869,2021,Bulgaria,Brazil,0,0,0,0,10/6/2021,0,0,0,0,0,0,0,0,0,0,0,0,0,0,0,0,0,0,0,0
112869,2021,Netherlands,Brazil,1,2,12,15,9/6/2021,0,0,1,1,12,0,7,19,2,2,4,8,0,0,0,0,7,0,0,7
112869,2021,Brazil,Serbia,0,0,0,0,5/6/2021,0,0,0,0,0,0,0,0,0,0,0,0,0,0,0,0,0,0,0,0
112869,2021,Brazil,Japan,1,2,10,13,4/6/2021,0,0,0,0,15,1,10,26,0,0,2,2,0,0,1,1,6,1,1,8
112869,2021,Brazil,France,1,1,8,10,3/6/2021,0,0,2,2,5,5,3,13,0,1,0,1,0,0,1,1,1,2,0,3
112869,2021,Canada,Brazil,0,2,12,14,30/05/2021,3,0,0,3,19,2,12,33,0,1,0,1,0,0,0,0,7,1,1,9
112869,2021,USA,Brazil,0,1,4,5,29/05/2021,0,0,0,0,4,1,0,5,0,0,0,0,0,0,0,0,0,0,0,0
112869,2021,Brazil,Argentina,1,2,14,17,28/05/2021,0,0,0,0,7,9,3,19,0,4,0,4,0,0,1,1,6,0,0,6
118928,2021,Brazil,Poland,0,3,10,13,27/06/2021,0,0,3,3,16,4,15,35,1,1,0,2,5,2,23,30,6,3,0,9
118928,2021,Brazil,France,2,4,9,15,26/06/2021,0,0,1,1,18,1,8,27,0,2,4,6,5,1,11,17,8,1,0,9
118928,2021,Brazil,Russia,0,0,7,7,23/06/2021,0,0,1,1,6,6,5,17,0,3,0,3,1,3,7,11,3,0,0,3
118928,2021,Brazil,Italy,1,3,13,17,21/06/2021,0,0,3,3,19,2,14,35,0,3,4,7,6,2,22,30,5,2,0,7
118928,2021,Australia,Brazil,0,0,0,0,17/06/2021,0,0,0,0,0,0,0,0,0,0,0,0,0,0,0,0,0,0,0,0
118928,2021,Iran,Brazil,1,2,3,6,16/06/2021,0,0,0,0,2,1,4,7,1,1,0,2,2,0,3,5,2,2,0,4
118928,2021,Brazil,Slovenia,0,2,14,16,15/06/2021,0,0,2,2,16,5,10,31,1,2,1,4,6,1,27,34,3,1,0,4
118928,2021,Poland,Brazil,1,2,15,18,11/6/2021,0,0,1,1,10,5,14,29,0,2,2,4,3,1,16,20,3,3,0,6
118928,2021,Bulgaria,Brazil,0,0,0,0,10/6/2021,0,0,0,0,0,0,0,0,0,0,0,0,0,0,0,0,0,0,0,0
118928,2021,Netherlands,Brazil,2,1,10,13,9/6/2021,0,0,2,2,18,5,4,27,0,4,1,5,3,0,11,14,4,1,1,6
118928,2021,Brazil,Serbia,0,0,0,0,5/6/2021,0,0,0,0,0,0,0,0,0,0,0,0,0,0,0,0,0,0,0,0
118928,2021,Brazil,Japan,3,1,10,14,4/6/2021,0,0,1,1,7,5,4,16,2,1,4,7,3,0,12,15,6,0,0,6
118928,2021,Brazil,France,0,1,8,9,3/6/2021,0,0,0,0,11,2,8,21,1,1,1,3,4,1,16,21,1,0,0,1
118928,2021,USA,Brazil,2,2,9,13,29/05/2021,0,0,0,0,9,1,3,13,2,0,0,2,2,2,16,20,0,0,0,0
118928,2021,Brazil,Argentina,0,0,7,7,28/05/2021,0,0,0,0,7,2,5,14,3,2,0,5,5,2,10,17,3,0,0,3
151789,2021,Brazil,Germany,0,0,0,0,22/06/2021,0,0,0,0,0,0,0,0,0,1,0,1,0,0,0,0,0,0,0,0
151789,2021,Australia,Brazil,0,1,2,3,17/06/2021,0,0,1,1,3,1,2,6,1,1,1,3,2,0,1,3,1,0,0,1
151789,2021,Brazil,Slovenia,0,1,0,1,15/06/2021,0,0,0,0,0,0,0,0,0,0,0,0,0,0,0,0,0,0,0,0
151789,2021,Poland,Brazil,0,0,1,1,11/6/2021,0,0,0,0,0,0,0,0,0,0,0,0,0,0,0,0,0,0,0,0
151789,2021,Bulgaria,Brazil,0,0,1,1,10/6/2021,0,0,0,0,2,1,0,3,0,0,0,0,0,0,1,1,0,0,0,0
151789,2021,Netherlands,Brazil,0,0,1,1,9/6/2021,0,0,0,0,0,0,0,0,0,0,0,0,0,0,0,0,0,0,0,0
151789,2021,Brazil,Serbia,0,0,0,0,5/6/2021,0,0,0,0,0,0,0,0,0,0,0,0,0,0,0,0,0,0,0,0
151789,2021,Brazil,France,0,0,0,0,3/6/2021,0,0,0,0,0,0,0,0,0,0,0,0,0,0,0,0,0,0,0,0
151789,2021,Canada,Brazil,0,0,0,0,30/05/2021,0,0,0,0,1,0,0,1,0,0,0,0,0,0,0,0,0,0,0,0
151789,2021,Brazil,Argentina,0,0,0,0,28/05/2021,0,0,0,0,0,0,0,0,0,0,0,0,0,0,0,0,0,0,0,0
119872,2021,Brazil,Poland,0,1,0,1,27/06/2021,0,0,0,0,0,0,0,0,0,0,0,0,0,0,0,0,0,0,0,0
119872,2021,Brazil,France,0,2,2,4,26/06/2021,0,0,0,0,1,0,0,1,0,1,1,2,0,0,0,0,0,0,0,0
119872,2021,Brazil,Russia,0,1,1,2,23/06/2021,0,0,1,1,1,1,2,4,0,2,1,3,0,0,0,0,0,0,0,0
119872,2021,Brazil,Germany,0,4,6,10,22/06/2021,0,0,0,0,7,0,4,11,1,3,0,4,0,0,0,0,1,1,0,2
119872,2021,Australia,Brazil,2,1,10,13,17/06/2021,0,0,0,0,7,1,5,13,2,2,6,10,0,0,0,0,1,0,0,1
119872,2021,Iran,Brazil,0,2,13,15,16/06/2021,0,0,2,2,5,0,9,14,1,3,1,5,1,0,0,1,2,1,0,3
119872,2021,Brazil,Slovenia,1,2,5,8,15/06/2021,0,0,0,0,4,0,0,4,3,1,0,4,0,0,1,1,1,0,0,1
119872,2021,Poland,Brazil,0,4,6,10,11/6/2021,0,0,0,0,5,0,2,7,1,1,3,5,1,0,0,1,0,0,0,0
119872,2021,Bulgaria,Brazil,0,3,7,10,10/6/2021,0,0,0,0,5,0,2,7,0,3,3,6,1,0,0,1,1,1,0,2
119872,2021,Netherlands,Brazil,0,0,0,0,9/6/2021,0,0,0,0,0,0,0,0,0,0,0,0,0,0,0,0,0,0,0,0
119872,2021,Brazil,Serbia,1,4,7,12,5/6/2021,0,0,0,0,3,2,1,6,2,3,2,7,0,0,0,0,0,0,0,0
119872,2021,Brazil,Japan,1,1,5,7,4/6/2021,0,0,1,1,7,0,2,9,0,4,5,9,0,0,0,0,3,2,0,5
119872,2021,Brazil,France,2,4,9,15,3/6/2021,0,0,0,0,5,1,4,10,3,7,4,14,0,0,0,0,3,1,2,6
119872,2021,Canada,Brazil,1,4,12,17,30/05/2021,0,0,0,0,4,1,6,11,3,3,2,8,0,0,0,0,5,0,1,6
119872,2021,USA,Brazil,1,2,9,12,29/05/2021,0,0,1,1,5,0,1,6,3,0,0,3,1,0,1,2,1,0,0,1
119872,2021,Brazil,Argentina,1,1,12,14,28/05/2021,0,0,0,0,7,3,2,12,2,1,0,3,1,0,0,1,1,0,0,1
136734,2021,Brazil,Poland,1,2,8,11,27/06/2021,0,0,1,1,3,0,2,5,4,2,6,12,0,0,0,0,2,1,0,3
136734,2021,Brazil,France,0,1,9,10,26/06/2021,0,0,0,0,3,0,1,4,5,7,4,16,0,0,0,0,1,0,0,1
136734,2021,Brazil,Russia,0,0,7,7,23/06/2021,0,0,2,2,3,0,3,6,1,2,2,5,0,0,0,0,0,0,0,0
136734,2021,Brazil,Germany,0,0,0,0,22/06/2021,0,0,0,0,0,0,0,0,0,0,0,0,0,0,0,0,0,0,0,0
136734,2021,Brazil,Italy,0,0,16,16,21/06/2021,0,0,1,1,8,2,7,17,0,4,10,14,0,0,0,0,0,0,1,1
136734,2021,Australia,Brazil,0,0,0,0,17/06/2021,0,0,0,0,0,0,0,0,0,0,0,0,0,0,0,0,0,0,0,0
136734,2021,Iran,Brazil,1,3,12,16,16/06/2021,0,0,4,4,5,1,2,8,3,6,1,10,0,0,1,1,1,0,1,2
136734,2021,Brazil,Slovenia,0,1,9,10,15/06/2021,0,0,0,0,3,1,2,6,0,5,0,5,0,0,0,0,1,1,0,2
136734,2021,Poland,Brazil,0,1,12,13,11/6/2021,0,0,1,1,4,1,1,6,2,1,3,6,0,0,1,1,0,1,0,1
136734,2021,Bulgaria,Brazil,0,0,0,0,10/6/2021,0,0,0,0,0,0,0,0,0,0,0,0,0,0,0,0,0,0,0,0
136734,2021,Netherlands,Brazil,0,0,9,9,9/6/2021,2,0,0,2,3,1,2,6,4,4,3,11,0,0,0,0,1,1,1,3
136734,2021,Brazil,Serbia,1,2,10,13,5/6/2021,0,0,1,1,3,0,2,5,0,6,2,8,2,0,4,6,0,0,0,0
136734,2021,Brazil,Japan,0,1,5,6,4/6/2021,0,0,0,0,1,0,0,1,0,2,1,3,0,0,0,0,0,0,0,0
142741,2021,Brazil,Poland,0,0,1,1,27/06/2021,0,0,0,0,1,0,0,1,0,0,0,0,0,0,0,0,0,0,0,0
142741,2021,Brazil,France,0,0,0,0,26/06/2021,0,0,0,0,0,0,0,0,0,0,0,0,0,0,0,0,0,0,0,0
142741,2021,Brazil,Russia,1,2,2,5,23/06/2021,0,0,1,1,2,1,1,4,0,0,1,1,1,0,10,11,2,0,1,3
142741,2021,Brazil,Germany,2,3,13,18,22/06/2021,0,0,4,4,8,3,12,23,1,1,2,4,8,0,8,16,6,0,0,6
142741,2021,Brazil,Italy,0,0,1,1,21/06/2021,0,0,0,0,0,0,0,0,0,0,0,0,0,0,0,0,0,0,0,0
142741,2021,Australia,Brazil,0,0,10,10,17/06/2021,0,0,5,5,10,1,2,13,0,4,2,6,11,2,6,19,2,2,0,4
142741,2021,Iran,Brazil,0,2,6,8,16/06/2021,0,0,5,5,5,2,12,19,1,4,0,5,5,4,10,19,3,1,0,4
142741,2021,Brazil,Slovenia,3,3,7,13,15/06/2021,0,0,4,4,8,4,11,23,0,2,1,3,5,2,6,13,4,2,1,7
142741,2021,Poland,Brazil,0,0,0,0,11/6/2021,0,0,0,0,0,0,0,0,0,0,0,0,0,0,0,0,0,0,0,0
142741,2021,Bulgaria,Brazil,0,1,8,9,10/6/2021,0,0,3,3,7,3,3,13,1,3,1,5,5,0,5,10,1,2,0,3
142741,2021,Netherlands,Brazil,0,0,0,0,9/6/2021,0,0,0,0,0,0,0,0,0,0,0,0,0,0,0,0,0,0,0,0
142741,2021,Brazil,Serbia,1,3,12,16,5/6/2021,0,0,4,4,17,3,10,30,4,2,1,7,8,0,11,19,3,1,1,5
142741,2021,Brazil,Japan,2,3,9,14,4/6/2021,0,0,4,4,11,4,5,20,0,1,1,2,2,2,7,11,6,0,1,7
142741,2021,Brazil,France,0,1,2,3,3/6/2021,0,0,2,2,6,2,0,8,0,0,1,1,1,0,3,4,1,0,1,2
142741,2021,Canada,Brazil,1,1,13,15,30/05/2021,0,0,0,0,20,9,3,32,1,2,3,6,4,0,15,19,3,2,1,6
142741,2021,USA,Brazil,0,0,0,0,29/05/2021,0,0,0,0,0,0,0,0,0,0,0,0,0,0,0,0,0,0,0,0
142741,2021,Brazil,Argentina,0,1,1,2,28/05/2021,0,0,0,0,6,2,0,8,0,0,0,0,1,0,1,2,1,1,0,2
161939,2021,Brazil,Poland,0,0,0,0,27/06/2021,0,0,0,0,0,0,0,0,0,0,0,0,0,0,0,0,0,0,0,0
161939,2021,Brazil,France,0,0,0,0,26/06/2021,0,0,0,0,0,0,0,0,0,0,0,0,0,0,0,0,0,0,0,0
161939,2021,Brazil,Russia,0,0,0,0,23/06/2021,0,0,0,0,0,0,0,0,0,0,0,0,0,0,0,0,0,0,0,0
161939,2021,Brazil,Germany,0,0,0,0,22/06/2021,0,0,0,0,0,0,0,0,0,0,0,0,0,0,0,0,0,0,0,0
161939,2021,Brazil,Italy,0,0,0,0,21/06/2021,0,0,0,0,0,0,0,0,0,0,0,0,0,0,0,0,0,0,0,0
161939,2021,Australia,Brazil,0,0,0,0,17/06/2021,0,0,0,0,0,0,0,0,0,0,0,0,4,0,1,5,13,2,1,16
161939,2021,Iran,Brazil,0,0,0,0,16/06/2021,0,0,0,0,0,0,0,0,0,0,0,0,0,0,0,0,0,0,0,0
161939,2021,Brazil,Slovenia,0,0,0,0,15/06/2021,0,0,0,0,0,0,0,0,0,0,0,0,0,0,0,0,0,0,0,0
161939,2021,Poland,Brazil,0,0,0,0,11/6/2021,0,0,0,0,0,0,0,0,0,0,0,0,0,0,0,0,0,0,0,0
161939,2021,Bulgaria,Brazil,0,0,0,0,10/6/2021,0,0,1,1,0,0,0,0,0,0,0,0,4,0,9,13,7,1,1,9
161939,2021,Netherlands,Brazil,0,0,0,0,9/6/2021,0,0,0,0,0,0,0,0,0,0,0,0,0,0,0,0,0,0,1,1
161939,2021,Brazil,Serbia,0,0,0,0,5/6/2021,0,0,0,0,0,0,0,0,0,0,0,0,0,0,0,0,3,4,0,7
161939,2021,Brazil,Japan,0,0,0,0,4/6/2021,0,0,1,1,0,0,0,0,0,0,0,0,0,0,0,0,4,1,0,5
161939,2021,Brazil,France,0,0,0,0,3/6/2021,0,0,0,0,0,0,0,0,0,0,0,0,0,0,0,0,0,0,0,0
161939,2021,Canada,Brazil,0,0,0,0,30/05/2021,0,0,0,0,0,0,0,0,0,0,0,0,0,0,0,0,0,0,0,0
161939,2021,USA,Brazil,0,0,0,0,29/05/2021,0,0,0,0,0,0,0,0,0,0,0,0,0,0,0,0,0,0,0,0
161939,2021,Brazil,Argentina,0,0,0,0,28/05/2021,5,0,0,5,0,0,0,0,0,0,0,0,0,0,0,0,0,0,0,0
116081,2021,Brazil,Poland,1,3,14,18,27/06/2021,0,0,0,0,6,1,2,9,0,2,1,3,0,0,0,0,0,0,0,0
116081,2021,Brazil,France,0,2,12,14,26/06/2021,0,0,0,0,3,1,3,7,2,1,4,7,0,0,0,0,2,0,1,3
116081,2021,Brazil,Russia,0,0,4,4,23/06/2021,0,0,0,0,4,1,1,6,0,5,3,8,0,0,0,0,0,0,0,0
116081,2021,Brazil,Germany,0,3,1,4,22/06/2021,0,0,0,0,1,0,4,5,0,1,0,1,0,0,0,0,0,0,0,0
116081,2021,Brazil,Italy,1,5,6,12,21/06/2021,0,0,1,1,5,2,7,14,1,7,3,11,0,0,1,1,1,0,0,1
118916,2021,Brazil,Poland,0,0,0,0,27/06/2021,0,0,7,7,0,0,0,0,0,0,0,0,7,1,5,13,8,1,1,10
118916,2021,Brazil,France,0,0,0,0,26/06/2021,0,0,5,5,0,0,0,0,0,0,0,0,4,1,6,11,8,2,0,10
118916,2021,Brazil,Russia,0,0,0,0,23/06/2021,0,0,4,4,0,0,0,0,0,0,0,0,5,1,11,17,4,3,0,7
118916,2021,Brazil,Germany,0,0,0,0,22/06/2021,0,0,3,3,0,0,0,0,0,0,0,0,7,1,6,14,10,2,0,12
118916,2021,Brazil,Italy,0,0,0,0,21/06/2021,0,1,4,5,0,0,0,0,0,0,0,0,6,0,11,17,13,2,2,17
118916,2021,Australia,Brazil,0,0,0,0,17/06/2021,0,0,0,0,0,0,0,0,0,0,0,0,0,0,0,0,0,0,0,0
118916,2021,Iran,Brazil,0,0,0,0,16/06/2021,0,0,5,5,0,0,0,0,0,0,0,0,6,0,9,15,13,2,0,15
118916,2021,Brazil,Slovenia,0,0,0,0,15/06/2021,0,0,3,3,0,0,0,0,0,0,0,0,8,0,12,20,8,3,1,12
118916,2021,Poland,Brazil,0,0,0,0,11/6/2021,0,0,4,4,0,0,0,0,0,0,0,0,5,0,7,12,4,3,0,7
118916,2021,Bulgaria,Brazil,0,0,0,0,10/6/2021,0,0,0,0,0,0,0,0,0,0,0,0,0,0,0,0,0,0,0,0
118916,2021,Netherlands,Brazil,0,0,0,0,9/6/2021,0,0,2,2,0,0,0,0,0,0,0,0,5,0,12,17,6,1,0,7
118916,2021,Brazil,Serbia,0,0,0,0,5/6/2021,0,0,6,6,0,0,0,0,0,0,0,0,7,2,6,15,3,0,0,3
118916,2021,Brazil,Japan,0,0,0,0,4/6/2021,0,0,1,1,0,0,0,0,0,0,0,0,8,0,8,16,1,0,0,1
118916,2021,Brazil,France,0,0,0,0,3/6/2021,0,0,3,3,0,0,0,0,0,0,0,0,8,1,9,18,9,4,3,16
118916,2021,Canada,Brazil,0,0,0,0,30/05/2021,0,0,6,6,0,0,0,0,0,0,0,0,13,0,9,22,7,4,1,12
118916,2021,USA,Brazil,0,0,0,0,29/05/2021,0,0,5,5,0,0,0,0,0,0,0,0,6,1,8,15,2,0,1,3
118916,2021,Brazil,Argentina,0,0,0,0,28/05/2021,0,0,8,8,0,0,0,0,0,0,0,0,8,0,3,11,7,3,0,10
136468,2021,Brazil,Poland,2,4,12,18,27/06/2021,0,0,6,6,10,1,10,21,1,1,3,5,4,0,14,18,12,4,3,19
136468,2021,Brazil,France,0,3,6,9,26/06/2021,0,0,1,1,9,5,3,17,0,1,2,3,3,0,18,21,3,3,0,6
136468,2021,Brazil,Russia,1,2,7,10,23/06/2021,0,0,3,3,6,3,1,10,0,0,1,1,4,2,13,19,5,2,0,7
136468,2021,Brazil,Italy,3,3,15,21,21/06/2021,0,0,7,7,15,3,10,28,3,5,6,14,7,1,16,24,9,4,1,14
136468,2021,Iran,Brazil,1,3,18,22,16/06/2021,0,0,4,4,17,5,9,31,2,0,2,4,2,0,10,12,5,1,0,6
136468,2021,Brazil,Slovenia,1,1,4,6,15/06/2021,0,0,1,1,1,3,4,8,0,0,0,0,1,1,7,9,1,0,0,1
136468,2021,Poland,Brazil,1,3,6,10,11/6/2021,0,0,9,9,14,1,7,22,1,1,0,2,3,0,9,12,6,4,0,10
136468,2021,Bulgaria,Brazil,5,3,15,23,10/6/2021,0,0,0,0,10,1,1,12,0,1,1,2,2,0,11,13,6,1,0,7
136468,2021,Netherlands,Brazil,0,0,0,0,9/6/2021,0,0,0,0,0,0,1,1,0,0,0,0,0,0,0,0,0,0,0,0
136468,2021,Brazil,Serbia,0,3,15,18,5/6/2021,0,0,2,2,14,3,5,22,4,4,3,11,12,2,20,34,7,0,1,8
136468,2021,Brazil,Japan,0,0,0,0,4/6/2021,0,0,0,0,0,0,0,0,0,0,0,0,0,0,0,0,0,0,0,0
136468,2021,Brazil,France,1,6,10,17,3/6/2021,0,0,0,0,11,5,9,25,0,4,4,8,10,0,18,28,7,2,1,10
136468,2021,Canada,Brazil,0,0,2,2,30/05/2021,0,0,0,0,2,0,4,6,0,0,1,1,0,0,3,3,3,0,0,3
136468,2021,USA,Brazil,0,3,6,9,29/05/2021,0,0,1,1,10,6,10,26,1,1,0,2,6,1,5,12,0,0,0,0
136468,2021,Brazil,Argentina,2,1,10,13,28/05/2021,0,0,0,0,12,2,5,19,0,3,1,4,11,1,10,22,5,2,0,7
136947,2021,Brazil,Poland,0,0,0,0,27/06/2021,0,0,0,0,0,0,0,0,0,0,0,0,0,0,0,0,0,0,0,0
136947,2021,Brazil,France,0,0,0,0,26/06/2021,0,0,0,0,0,0,0,0,0,0,0,0,0,0,0,0,0,0,0,0
136947,2021,Brazil,Russia,0,0,7,7,23/06/2021,0,0,0,0,4,0,2,6,1,1,1,3,0,0,0,0,0,0,0,0
136947,2021,Brazil,Germany,0,2,10,12,22/06/2021,0,0,0,0,13,2,7,22,1,3,1,5,1,0,1,2,4,1,0,5
136947,2021,Brazil,Italy,0,0,0,0,21/06/2021,0,0,0,0,0,0,1,1,0,0,0,0,0,0,0,0,0,0,0,0
136947,2021,Australia,Brazil,0,0,9,9,17/06/2021,0,0,1,1,9,3,7,19,0,2,3,5,0,0,1,1,3,3,1,7
136947,2021,Iran,Brazil,0,2,10,12,16/06/2021,0,0,3,3,13,6,12,31,3,2,1,6,0,0,0,0,7,1,0,8
136947,2021,Brazil,Slovenia,1,1,1,3,15/06/2021,0,0,0,0,0,2,1,3,0,0,1,1,0,0,0,0,2,0,0,2
136947,2021,Poland,Brazil,0,0,0,0,11/6/2021,0,0,2,2,0,0,0,0,0,0,0,0,0,0,0,0,1,0,0,1
136947,2021,Bulgaria,Brazil,1,3,6,10,10/6/2021,0,0,2,2,9,0,3,12,0,2,0,2,0,0,0,0,2,2,0,4
136947,2021,Netherlands,Brazil,0,0,0,0,9/6/2021,0,0,0,0,1,0,0,1,0,0,0,0,0,0,0,0,0,0,0,0
136947,2021,Brazil,Serbia,0,5,8,13,5/6/2021,0,0,0,0,17,2,8,27,2,4,2,8,0,0,0,0,7,2,1,10
136947,2021,Brazil,Japan,0,0,0,0,4/6/2021,0,0,0,0,0,0,0,0,0,0,1,1,0,0,0,0,0,0,0,0
136947,2021,Brazil,France,0,1,4,5,3/6/2021,0,0,0,0,9,1,2,12,0,4,1,5,0,0,0,0,2,1,2,5
136947,2021,Canada,Brazil,0,0,0,0,30/05/2021,0,0,0,0,0,0,0,0,0,0,0,0,0,0,0,0,0,0,0,0
136947,2021,USA,Brazil,1,0,5,6,29/05/2021,0,0,1,1,10,2,6,18,1,0,1,2,1,0,0,1,0,0,0,0
136956,2021,Brazil,Poland,0,0,0,0,27/06/2021,0,0,0,0,0,0,0,0,0,0,0,0,0,0,0,0,0,0,0,0
136956,2021,Brazil,France,0,0,0,0,26/06/2021,0,0,0,0,0,0,0,0,0,0,0,0,0,0,0,0,0,0,0,0
136956,2021,Brazil,Russia,0,0,4,4,23/06/2021,0,0,1,1,1,0,1,2,0,0,0,0,0,0,0,0,0,0,0,0
136956,2021,Brazil,Germany,0,0,7,7,22/06/2021,0,0,1,1,5,1,2,8,0,1,0,1,0,0,0,0,1,1,0,2
136956,2021,Brazil,Italy,0,0,0,0,21/06/2021,0,0,0,0,0,0,0,0,0,0,0,0,0,0,0,0,0,0,0,0
136956,2021,Australia,Brazil,0,2,12,14,17/06/2021,0,0,1,1,4,0,0,4,1,4,6,11,0,0,2,2,4,0,0,4
136956,2021,Iran,Brazil,0,0,0,0,16/06/2021,0,0,0,0,0,0,0,0,0,0,0,0,0,0,0,0,0,0,0,0
136956,2021,Brazil,Slovenia,0,0,12,12,15/06/2021,0,0,1,1,7,1,3,11,2,9,8,19,1,1,0,2,5,1,0,6
136956,2021,Poland,Brazil,0,0,0,0,11/6/2021,0,0,0,0,0,0,0,0,0,0,0,0,0,0,0,0,0,0,0,0
136956,2021,Bulgaria,Brazil,2,1,8,11,10/6/2021,0,0,0,0,5,0,4,9,3,3,1,7,0,1,0,1,0,1,0,1
136956,2021,Netherlands,Brazil,0,1,12,13,9/6/2021,0,0,0,0,5,2,2,9,2,3,2,7,0,0,0,0,3,0,0,3
136956,2021,Brazil,Serbia,0,2,7,9,5/6/2021,0,0,0,0,3,1,2,6,0,5,2,7,0,0,0,0,1,0,1,2
136956,2021,Brazil,Japan,0,0,9,9,4/6/2021,0,0,5,5,4,2,0,6,0,2,2,4,0,0,0,0,2,0,0,2
136956,2021,Brazil,France,0,0,11,11,3/6/2021,0,0,0,0,0,2,5,7,0,6,5,11,0,0,1,1,3,0,0,3
136956,2021,Canada,Brazil,1,2,15,18,30/05/2021,0,0,0,0,6,2,6,14,1,4,2,7,1,0,0,1,4,2,0,6
136956,2021,USA,Brazil,0,1,13,14,29/05/2021,0,0,0,0,2,2,5,9,0,1,1,2,0,0,1,1,1,0,0,1
136956,2021,Brazil,Argentina,1,1,10,12,28/05/2021,0,0,0,0,3,1,2,6,1,1,3,5,0,0,0,0,2,1,0,3
174445,2021,Slovenia,Bulgaria,1,2,10,13,23/06/2021,0,0,1,1,8,5,7,20,1,3,1,5,0,0,0,0,0,0,0,0
174445,2021,Bulgaria,USA,0,0,1,1,22/06/2021,0,1,0,1,0,3,2,5,0,0,0,0,0,0,0,0,1,0,0,1
174445,2021,Japan,Bulgaria,0,0,5,5,21/06/2021,0,0,0,0,6,3,10,19,0,1,0,1,0,0,0,0,4,1,0,5
174445,2021,Bulgaria,Russia,0,2,4,6,17/06/2021,0,1,0,1,1,3,6,10,1,1,2,4,0,0,0,0,0,0,0,0
174445,2021,Serbia,Bulgaria,0,0,1,1,16/06/2021,0,0,0,0,1,1,2,4,0,0,1,1,0,0,0,0,0,0,0,0
174445,2021,Argentina,Bulgaria,0,1,2,3,15/06/2021,0,0,1,1,3,1,4,8,0,0,1,1,0,0,0,0,0,1,0,1
174445,2021,Netherlands,Bulgaria,1,0,9,10,11/6/2021,0,0,1,1,14,1,9,24,0,1,2,3,0,0,0,0,0,3,0,3
174445,2021,Bulgaria,Brazil,0,2,5,7,10/6/2021,0,0,2,2,7,4,4,15,0,1,1,2,0,2,10,12,2,0,0,2
174445,2021,Poland,Bulgaria,1,1,2,4,9/6/2021,0,0,1,1,2,2,2,6,0,0,0,0,1,0,0,1,0,0,0,0
174445,2021,Bulgaria,Iran,0,4,6,10,5/6/2021,0,0,4,4,6,2,4,12,0,2,1,3,1,3,13,17,4,1,1,6
174445,2021,Canada,Bulgaria,0,1,1,2,4/6/2021,0,0,0,0,0,1,3,4,0,0,0,0,0,2,3,5,1,0,0,1
174445,2021,Italy,Bulgaria,0,0,2,2,3/6/2021,0,0,0,0,2,2,1,5,0,0,0,0,0,1,4,5,1,1,0,2
174445,2021,Germany,Bulgaria,1,0,1,2,30/05/2021,0,0,0,0,1,0,2,3,0,0,0,0,0,1,1,2,0,1,0,1
174445,2021,Australia,Bulgaria,0,1,1,2,29/05/2021,0,0,0,0,0,0,0,0,0,0,0,0,0,0,0,0,0,0,0,0
174445,2021,France,Bulgaria,0,3,1,4,28/05/2021,0,0,0,0,6,0,1,7,0,0,0,0,2,2,5,9,0,0,0,0
180588,2021,Slovenia,Bulgaria,0,3,3,6,23/06/2021,0,0,0,0,3,0,0,3,3,5,1,9,0,0,0,0,1,0,1,2
180588,2021,Bulgaria,USA,0,1,5,6,22/06/2021,0,0,0,0,4,0,2,6,0,4,6,10,0,0,2,2,4,1,0,5
180588,2021,Japan,Bulgaria,0,3,8,11,21/06/2021,0,0,0,0,2,0,2,4,1,4,3,8,0,0,1,1,2,0,0,2
180588,2021,Bulgaria,Russia,0,2,4,6,17/06/2021,0,0,0,0,0,0,0,0,0,3,2,5,0,0,0,0,1,0,0,1
180588,2021,Serbia,Bulgaria,0,4,7,11,16/06/2021,0,0,0,0,5,0,4,9,2,1,0,3,1,0,2,3,2,1,1,4
180588,2021,Argentina,Bulgaria,0,2,5,7,15/06/2021,0,0,0,0,4,2,0,6,0,2,2,4,0,0,0,0,3,1,0,4
180588,2021,Poland,Bulgaria,0,0,0,0,9/6/2021,0,0,0,0,0,0,0,0,0,0,0,0,0,0,0,0,0,0,0,0
180588,2021,Bulgaria,Iran,1,1,11,13,5/6/2021,0,0,0,0,3,0,3,6,1,6,3,10,0,0,0,0,1,1,0,2
180588,2021,Canada,Bulgaria,0,3,5,8,4/6/2021,0,0,0,0,3,0,2,5,0,2,1,3,0,0,0,0,2,2,0,4
180588,2021,Italy,Bulgaria,0,1,9,10,3/6/2021,0,0,1,1,4,0,3,7,1,2,0,3,0,0,1,1,1,0,0,1
180588,2021,Germany,Bulgaria,0,0,1,1,30/05/2021,0,0,0,0,0,0,2,2,0,0,1,1,1,0,0,1,0,0,0,0
180588,2021,Australia,Bulgaria,1,2,3,6,29/05/2021,0,0,0,0,0,0,1,1,1,0,3,4,0,0,0,0,1,0,0,1
180588,2021,France,Bulgaria,0,0,3,3,28/05/2021,0,0,0,0,0,0,0,0,0,0,0,0,0,0,0,0,0,0,0,0
173067,2021,Slovenia,Bulgaria,0,0,7,7,23/06/2021,0,0,2,2,4,0,0,4,2,3,2,7,0,0,1,1,0,0,1,1
173067,2021,Bulgaria,USA,0,0,12,12,22/06/2021,0,0,2,2,5,0,2,7,0,4,4,8,0,0,0,0,3,0,1,4
173067,2021,Japan,Bulgaria,0,0,6,6,21/06/2021,0,0,1,1,5,0,3,8,3,3,3,9,0,0,2,2,0,1,0,1
173067,2021,Bulgaria,Russia,1,1,8,10,17/06/2021,0,0,2,2,6,0,5,11,0,8,5,13,0,0,0,0,1,1,0,2
173067,2021,Serbia,Bulgaria,0,0,6,6,16/06/2021,0,0,0,0,1,2,0,3,0,5,2,7,0,0,1,1,0,0,1,1
173067,2021,Argentina,Bulgaria,0,0,13,13,15/06/2021,0,0,1,1,5,1,5,11,2,3,0,5,0,0,1,1,0,2,0,2
173067,2021,Netherlands,Bulgaria,0,0,12,12,11/6/2021,0,0,1,1,7,0,1,8,1,6,4,11,0,0,0,0,2,0,1,3
173067,2021,Bulgaria,Brazil,1,3,6,10,10/6/2021,0,0,0,0,3,0,1,4,0,4,0,4,0,0,1,1,0,0,0,0
173067,2021,Poland,Bulgaria,0,0,5,5,9/6/2021,0,0,0,0,1,2,1,4,0,2,0,2,0,0,1,1,0,1,0,1
173067,2021,Bulgaria,Iran,0,0,12,12,5/6/2021,0,0,2,2,7,0,6,13,1,6,5,12,0,0,0,0,0,1,0,1
173067,2021,Canada,Bulgaria,0,0,0,0,4/6/2021,0,0,0,0,0,0,0,0,0,0,0,0,0,0,0,0,1,0,0,1
173067,2021,Italy,Bulgaria,0,0,7,7,3/6/2021,0,0,2,2,3,1,4,8,1,3,1,5,0,0,2,2,2,1,0,3
173067,2021,Germany,Bulgaria,0,0,0,0,30/05/2021,0,0,0,0,0,0,0,0,0,0,0,0,0,0,0,0,0,0,0,0
173067,2021,Australia,Bulgaria,0,0,0,0,29/05/2021,0,0,0,0,0,0,0,0,0,0,0,0,0,0,0,0,0,0,0,0
173067,2021,France,Bulgaria,0,0,0,0,28/05/2021,0,0,0,0,0,0,0,0,0,0,0,0,0,0,0,0,0,0,0,0
156676,2021,Slovenia,Bulgaria,0,0,0,0,23/06/2021,0,0,0,0,0,0,0,0,0,0,0,0,0,0,0,0,0,0,0,0
156676,2021,Bulgaria,USA,0,0,0,0,22/06/2021,0,0,0,0,0,0,0,0,0,0,0,0,0,0,0,0,0,0,0,0
156676,2021,Japan,Bulgaria,1,0,9,10,21/06/2021,0,0,1,1,2,1,7,10,0,2,0,2,4,0,13,17,5,3,0,8
156676,2021,Bulgaria,Russia,2,2,9,13,17/06/2021,0,0,3,3,7,5,6,18,0,1,0,1,4,0,13,17,6,4,1,11
156676,2021,Serbia,Bulgaria,2,1,8,11,16/06/2021,0,0,2,2,7,2,7,16,1,4,0,5,4,0,11,15,1,1,0,2
156676,2021,Argentina,Bulgaria,2,4,9,15,15/06/2021,0,0,1,1,11,3,14,28,1,1,1,3,9,0,10,19,4,1,1,6
156676,2021,Netherlands,Bulgaria,0,0,0,0,11/6/2021,0,0,0,0,0,0,0,0,0,0,0,0,0,0,0,0,0,0,0,0
156676,2021,Bulgaria,Brazil,0,0,0,0,10/6/2021,0,0,0,0,0,0,0,0,0,0,0,0,0,0,0,0,0,0,0,0
156676,2021,Poland,Bulgaria,0,0,0,0,9/6/2021,0,0,0,0,0,0,0,0,0,0,0,0,0,0,0,0,0,0,0,0
156676,2021,Bulgaria,Iran,0,0,0,0,5/6/2021,0,0,0,0,0,0,0,0,0,0,0,0,0,0,0,0,0,0,0,0
156676,2021,Canada,Bulgaria,0,0,0,0,4/6/2021,0,0,0,0,0,0,0,0,0,0,0,0,0,0,0,0,0,0,0,0
156676,2021,Italy,Bulgaria,0,0,0,0,3/6/2021,0,0,0,0,0,0,0,0,0,0,0,0,0,0,0,0,0,0,0,0
156676,2021,Germany,Bulgaria,3,5,6,14,30/05/2021,0,0,0,0,6,7,9,22,1,2,0,3,6,2,16,24,5,1,0,6
156676,2021,Australia,Bulgaria,1,2,6,9,29/05/2021,0,0,0,0,10,5,5,20,2,1,1,4,9,0,11,20,5,0,1,6
156676,2021,France,Bulgaria,2,3,5,10,28/05/2021,0,0,0,0,2,4,8,14,1,2,0,3,2,0,6,8,0,0,0,0
162124,2021,Slovenia,Bulgaria,0,1,1,2,23/06/2021,0,0,0,0,0,0,0,0,0,0,0,0,0,0,0,0,0,0,0,0
162124,2021,Bulgaria,USA,0,4,7,11,22/06/2021,11,1,49,61,0,1,0,1,1,1,1,3,0,0,0,0,3,1,1,5
162124,2021,Japan,Bulgaria,0,1,1,2,21/06/2021,6,0,6,12,0,0,0,0,0,0,0,0,0,0,1,1,0,0,0,0
162124,2021,Bulgaria,Russia,0,0,7,7,17/06/2021,5,1,38,44,0,0,0,0,0,3,1,4,0,0,0,0,0,1,0,1
162124,2021,Serbia,Bulgaria,0,0,1,1,16/06/2021,1,1,6,8,0,0,0,0,0,0,0,0,0,0,0,0,0,0,0,0
162124,2021,Netherlands,Bulgaria,0,1,0,1,11/6/2021,3,0,5,8,0,0,0,0,0,0,1,1,0,0,0,0,1,0,1,2
162124,2021,Bulgaria,Brazil,0,0,2,2,10/6/2021,3,0,19,22,0,0,1,1,0,2,0,2,0,0,0,0,1,1,0,2
162124,2021,Bulgaria,Iran,2,4,11,17,5/6/2021,26,0,56,82,3,0,0,3,2,2,0,4,0,0,1,1,6,0,1,7
162124,2021,Canada,Bulgaria,0,0,0,0,4/6/2021,0,0,0,0,0,0,0,0,0,0,0,0,0,0,0,0,0,0,0,0
162124,2021,Italy,Bulgaria,0,1,6,7,3/6/2021,6,0,56,62,0,0,1,1,0,4,6,10,0,0,0,0,3,2,1,6
137012,2021,Slovenia,Bulgaria,1,2,5,8,23/06/2021,27,2,32,61,2,1,1,4,1,2,2,5,0,0,0,0,1,2,3,6
137012,2021,Bulgaria,USA,0,0,0,0,22/06/2021,1,0,12,13,0,0,0,0,0,0,0,0,0,0,0,0,0,1,0,1
137012,2021,Japan,Bulgaria,0,1,8,9,21/06/2021,13,0,44,57,0,1,0,1,2,0,3,5,0,0,0,0,2,3,0,5
137012,2021,Bulgaria,Russia,0,0,0,0,17/06/2021,0,0,0,0,0,0,0,0,0,0,0,0,0,0,0,0,0,0,0,0
137012,2021,Serbia,Bulgaria,0,1,6,7,16/06/2021,15,1,39,55,1,0,2,3,1,0,1,2,0,0,0,0,3,2,1,6
137012,2021,Argentina,Bulgaria,1,4,11,16,15/06/2021,12,1,75,88,1,0,0,1,1,5,3,9,0,0,1,1,5,2,0,7
137012,2021,Netherlands,Bulgaria,3,1,12,16,11/6/2021,26,2,45,73,2,0,0,2,1,2,1,4,0,0,0,0,7,0,0,7
137012,2021,Bulgaria,Brazil,0,1,4,5,10/6/2021,11,0,22,33,1,0,0,1,0,0,0,0,0,0,0,0,0,0,0,0
137012,2021,Poland,Bulgaria,0,1,3,4,9/6/2021,7,0,36,43,1,0,0,1,0,1,0,1,0,0,0,0,0,1,0,1
137012,2021,Bulgaria,Iran,0,0,0,0,5/6/2021,0,0,0,0,0,0,0,0,0,0,0,0,0,0,0,0,0,0,0,0
137012,2021,Canada,Bulgaria,2,1,16,19,4/6/2021,15,0,53,68,0,0,0,0,0,1,2,3,0,0,0,0,4,3,0,7
137012,2021,Italy,Bulgaria,0,0,7,7,3/6/2021,9,0,36,45,1,0,0,1,0,0,0,0,0,0,0,0,1,0,0,1
137012,2021,Germany,Bulgaria,0,2,18,20,30/05/2021,31,0,86,117,0,0,1,1,3,3,3,9,0,0,1,1,2,1,3,6
137012,2021,Australia,Bulgaria,1,3,6,10,29/05/2021,22,0,46,68,2,0,0,2,0,3,1,4,0,1,1,2,3,2,1,6
137012,2021,France,Bulgaria,0,2,13,15,28/05/2021,3,0,66,69,0,1,0,1,1,0,0,1,0,0,0,0,0,0,0,0
181285,2021,Slovenia,Bulgaria,0,0,0,0,23/06/2021,0,0,0,0,0,0,0,0,0,0,0,0,0,0,0,0,0,0,0,0
181285,2021,Bulgaria,Russia,1,0,2,3,17/06/2021,1,0,16,17,0,0,0,0,0,1,0,1,0,0,0,0,1,1,0,2
181285,2021,Serbia,Bulgaria,0,0,1,1,16/06/2021,0,0,0,0,0,0,0,0,0,0,0,0,0,0,0,0,0,1,0,1
181285,2021,Argentina,Bulgaria,0,0,0,0,15/06/2021,0,0,4,4,0,0,0,0,0,0,0,0,0,0,0,0,0,0,0,0
181285,2021,Poland,Bulgaria,0,0,1,1,9/6/2021,4,0,9,13,0,0,0,0,0,0,0,0,0,0,0,0,1,1,0,2
181285,2021,Bulgaria,Iran,0,0,0,0,5/6/2021,0,0,0,0,0,0,0,0,0,0,0,0,0,0,0,0,0,0,0,0
181285,2021,Germany,Bulgaria,0,0,0,0,30/05/2021,0,0,0,0,0,0,0,0,0,0,0,0,0,0,0,0,0,0,0,0
181285,2021,Australia,Bulgaria,0,0,0,0,29/05/2021,0,0,0,0,0,0,0,0,0,0,0,0,0,0,0,0,0,0,0,0
181285,2021,France,Bulgaria,0,0,0,0,28/05/2021,0,0,0,0,0,0,0,0,0,0,0,0,0,0,0,0,0,0,0,0
152619,2021,Germany,Bulgaria,0,3,10,13,30/05/2021,1,0,0,1,5,1,4,10,6,5,10,21,3,0,1,4,4,0,1,5
152619,2021,Australia,Bulgaria,5,3,6,14,29/05/2021,0,1,0,1,3,0,3,6,1,5,4,10,0,0,1,1,1,0,0,1
152619,2021,France,Bulgaria,0,3,6,9,28/05/2021,0,0,2,2,3,3,1,7,0,3,0,3,0,0,0,0,0,0,0,0
173010,2021,Slovenia,Bulgaria,0,2,3,5,23/06/2021,0,0,0,0,5,1,7,13,0,1,0,1,5,1,14,20,1,1,0,2
173010,2021,Bulgaria,USA,0,0,7,7,22/06/2021,0,0,0,0,7,1,8,16,0,2,4,6,5,1,11,17,3,0,0,3
173010,2021,Japan,Bulgaria,0,0,0,0,21/06/2021,0,0,0,0,0,0,0,0,0,0,0,0,0,0,0,0,0,0,0,0
173010,2021,Bulgaria,Russia,0,0,0,0,17/06/2021,0,0,0,0,0,0,0,0,0,0,0,0,0,0,0,0,0,0,0,0
173010,2021,Serbia,Bulgaria,0,1,2,3,16/06/2021,0,0,0,0,1,0,2,3,1,0,0,1,0,2,6,8,1,0,0,1
173010,2021,Argentina,Bulgaria,0,0,0,0,15/06/2021,0,0,0,0,0,0,0,0,0,0,0,0,0,0,0,0,0,0,0,0
173010,2021,Netherlands,Bulgaria,0,1,0,1,11/6/2021,0,0,0,0,0,1,0,1,0,2,0,2,1,1,0,2,0,0,0,0
173010,2021,Bulgaria,Brazil,0,1,0,1,10/6/2021,0,0,1,1,2,3,0,5,2,0,0,2,1,4,8,13,3,1,1,5
173010,2021,Poland,Bulgaria,0,4,4,8,9/6/2021,0,0,0,0,7,3,9,19,2,3,0,5,7,3,16,26,1,1,0,2
173010,2021,Bulgaria,Iran,0,4,3,7,5/6/2021,0,0,2,2,8,4,11,23,0,2,4,6,1,1,21,23,7,0,0,7
173010,2021,Canada,Bulgaria,0,0,1,1,4/6/2021,0,0,0,0,1,0,0,1,0,0,0,0,2,0,4,6,0,1,1,2
173010,2021,Italy,Bulgaria,0,1,3,4,3/6/2021,0,0,1,1,2,2,1,5,0,3,0,3,2,1,7,10,1,0,0,1
173010,2021,Germany,Bulgaria,0,0,2,2,30/05/2021,0,0,0,0,1,1,1,3,0,2,0,2,0,0,6,6,1,0,0,1
173010,2021,Australia,Bulgaria,0,0,0,0,29/05/2021,0,0,0,0,0,0,0,0,0,0,0,0,0,0,0,0,0,0,0,0
173010,2021,France,Bulgaria,0,1,2,3,28/05/2021,0,0,0,0,3,1,2,6,0,1,0,1,7,2,7,16,0,0,0,0
168269,2021,Slovenia,Bulgaria,0,4,5,9,23/06/2021,0,0,1,1,10,6,1,17,0,2,1,3,10,1,14,25,1,1,1,3
168269,2021,Bulgaria,USA,0,0,1,1,22/06/2021,0,0,0,0,2,0,1,3,0,0,0,0,0,0,4,4,0,0,0,0
168269,2021,Japan,Bulgaria,1,2,4,7,21/06/2021,0,0,0,0,14,3,6,23,2,2,2,6,3,3,14,20,3,3,0,6
168269,2021,Bulgaria,Russia,0,2,4,6,17/06/2021,0,0,1,1,9,1,7,17,1,3,3,7,5,4,12,21,2,1,0,3
168269,2021,Serbia,Bulgaria,1,2,5,8,16/06/2021,0,0,3,3,4,2,6,12,0,3,1,4,3,5,12,20,1,1,1,3
168269,2021,Argentina,Bulgaria,0,0,4,4,15/06/2021,0,0,1,1,2,0,4,6,0,2,0,2,4,0,5,9,1,1,0,2
168269,2021,Netherlands,Bulgaria,1,3,12,16,11/6/2021,0,0,4,4,9,2,9,20,2,2,3,7,7,5,21,33,7,4,0,11
168269,2021,Bulgaria,Brazil,0,0,6,6,10/6/2021,0,0,3,3,8,1,3,12,0,1,0,1,2,1,7,10,2,2,0,4
168269,2021,Poland,Bulgaria,0,2,3,5,9/6/2021,0,0,1,1,8,0,7,15,0,1,0,1,7,2,4,13,1,1,0,2
168269,2021,Bulgaria,Iran,1,2,3,6,5/6/2021,0,0,1,1,3,4,5,12,0,1,1,2,1,1,5,7,2,2,0,4
168269,2021,Canada,Bulgaria,0,4,4,8,4/6/2021,0,0,3,3,6,2,5,13,1,3,2,6,5,3,11,19,2,3,0,5
168269,2021,Italy,Bulgaria,1,2,12,15,3/6/2021,0,0,3,3,16,2,13,31,2,1,4,7,16,1,20,37,6,4,0,10
168269,2021,Germany,Bulgaria,3,4,13,20,30/05/2021,0,0,0,0,7,6,11,24,0,2,1,3,8,3,19,30,7,0,0,7
168269,2021,Australia,Bulgaria,3,3,8,14,29/05/2021,0,0,0,0,5,2,6,13,0,2,3,5,6,0,9,15,5,0,1,6
168269,2021,France,Bulgaria,0,0,4,4,28/05/2021,0,0,1,1,3,0,2,5,0,0,0,0,3,0,6,9,0,0,0,0
152624,2021,Slovenia,Bulgaria,0,2,1,3,23/06/2021,0,0,0,0,1,0,6,7,0,1,0,1,2,1,8,11,1,0,0,1
152624,2021,Bulgaria,USA,0,2,5,7,22/06/2021,0,0,1,1,8,5,7,20,1,2,0,3,5,2,12,19,1,1,1,3
152624,2021,Japan,Bulgaria,0,0,1,1,21/06/2021,0,0,0,0,1,0,2,3,0,1,0,1,1,0,4,5,1,0,0,1
152624,2021,Bulgaria,Russia,0,0,0,0,17/06/2021,0,0,0,0,0,0,0,0,0,0,0,0,0,0,0,0,0,0,0,0
152624,2021,Serbia,Bulgaria,0,0,0,0,16/06/2021,0,0,0,0,1,0,0,1,0,1,0,1,0,0,1,1,1,0,0,1
152624,2021,Argentina,Bulgaria,0,0,1,1,15/06/2021,0,0,0,0,0,1,0,1,0,0,0,0,0,0,2,2,0,0,0,0
152624,2021,Netherlands,Bulgaria,0,1,3,4,11/6/2021,0,0,0,0,0,0,0,0,0,0,0,0,0,0,0,0,0,1,0,1
152624,2021,Bulgaria,Brazil,0,0,3,3,10/6/2021,0,0,0,0,0,1,1,2,0,0,0,0,2,0,2,4,0,0,0,0
152624,2021,Poland,Bulgaria,0,0,2,2,9/6/2021,0,0,0,0,0,0,0,0,0,1,0,1,0,0,0,0,0,0,0,0
118484,2021,Slovenia,Bulgaria,0,0,0,0,23/06/2021,0,0,6,6,0,0,0,0,0,0,0,0,1,0,7,8,5,1,0,6
118484,2021,Bulgaria,USA,0,0,0,0,22/06/2021,0,0,0,0,0,0,0,0,0,0,0,0,0,0,0,0,0,0,0,0
118484,2021,Japan,Bulgaria,0,0,0,0,21/06/2021,0,0,8,8,0,0,0,0,0,0,0,0,3,0,10,13,8,5,0,13
118484,2021,Bulgaria,Russia,0,0,0,0,17/06/2021,0,0,2,2,0,0,0,0,0,0,0,0,1,1,5,7,3,2,0,5
118484,2021,Serbia,Bulgaria,0,0,0,0,16/06/2021,0,0,4,4,0,0,0,0,0,0,0,0,5,2,11,18,5,4,1,10
118484,2021,Argentina,Bulgaria,0,0,0,0,15/06/2021,0,0,4,4,0,0,0,0,0,0,0,0,4,2,11,17,12,6,2,20
118484,2021,Netherlands,Bulgaria,0,0,0,0,11/6/2021,0,0,10,10,0,0,0,0,0,0,0,0,5,3,16,24,9,6,1,16
118484,2021,Bulgaria,Brazil,0,0,0,0,10/6/2021,0,0,2,2,0,0,0,0,0,0,0,0,3,2,5,10,5,4,0,9
118484,2021,Poland,Bulgaria,0,0,0,0,9/6/2021,0,0,6,6,0,0,0,0,0,0,0,0,8,2,5,15,4,2,1,7
118484,2021,Canada,Bulgaria,0,0,0,0,4/6/2021,0,0,10,10,0,0,0,0,0,0,0,0,6,1,13,20,10,2,0,12
118484,2021,Italy,Bulgaria,0,0,0,0,3/6/2021,0,0,2,2,0,0,0,0,0,0,0,0,4,0,6,10,5,6,0,11
118484,2021,Germany,Bulgaria,0,0,0,0,30/05/2021,0,0,3,3,0,0,0,0,0,0,0,0,6,2,11,19,14,1,0,15
118484,2021,Australia,Bulgaria,0,0,0,0,29/05/2021,0,0,4,4,0,0,0,0,0,0,0,0,4,0,9,13,5,0,1,6
118484,2021,France,Bulgaria,0,0,0,0,28/05/2021,0,0,5,5,0,0,0,0,0,0,0,0,8,0,5,13,8,0,2,10
118488,2021,Netherlands,Bulgaria,0,0,0,0,11/6/2021,0,0,0,0,0,0,0,0,0,0,0,0,0,0,0,0,0,0,0,0
118488,2021,Bulgaria,Brazil,0,0,0,0,10/6/2021,0,0,0,0,0,0,0,0,0,0,0,0,0,0,0,0,0,0,0,0
118488,2021,Bulgaria,Iran,0,0,0,0,5/6/2021,0,0,0,0,0,0,0,0,0,0,0,0,0,0,0,0,0,0,0,0
118488,2021,Canada,Bulgaria,2,4,6,12,4/6/2021,0,0,1,1,20,8,11,39,1,4,1,6,0,0,3,3,5,1,1,7
118488,2021,Italy,Bulgaria,0,0,0,0,3/6/2021,0,0,0,0,0,0,0,0,0,0,0,0,0,0,0,0,0,0,0,0
118488,2021,Germany,Bulgaria,1,5,11,17,30/05/2021,0,0,0,0,23,7,13,43,2,4,1,7,0,0,0,0,7,2,3,12
118488,2021,Australia,Bulgaria,2,4,8,14,29/05/2021,0,0,0,0,10,6,11,27,0,3,1,4,0,0,0,0,3,1,0,4
118488,2021,France,Bulgaria,2,3,8,13,28/05/2021,0,0,0,0,15,5,11,31,2,1,0,3,0,0,0,0,0,0,0,0
162123,2021,Slovenia,Bulgaria,0,0,3,3,23/06/2021,0,0,0,0,1,1,2,4,1,3,0,4,0,0,0,0,1,0,1,2
162123,2021,Bulgaria,USA,0,0,0,0,22/06/2021,0,0,0,0,0,0,0,0,0,0,0,0,0,0,0,0,0,0,0,0
162123,2021,Japan,Bulgaria,0,0,0,0,21/06/2021,0,0,0,0,0,0,0,0,0,0,0,0,0,0,0,0,0,0,0,0
162123,2021,Argentina,Bulgaria,0,1,1,2,15/06/2021,0,0,1,1,0,0,2,2,0,1,0,1,0,0,0,0,2,0,0,2
162123,2021,Netherlands,Bulgaria,0,3,11,14,11/6/2021,0,0,0,0,6,0,4,10,1,6,6,13,0,0,0,0,1,0,0,1
162123,2021,Bulgaria,Brazil,0,2,4,6,10/6/2021,0,0,0,0,1,1,4,6,1,1,3,5,1,0,0,1,1,0,0,1
162123,2021,Poland,Bulgaria,0,2,6,8,9/6/2021,0,0,1,1,2,1,0,3,0,0,0,0,0,0,0,0,1,1,0,2
162123,2021,Bulgaria,Iran,0,0,0,0,5/6/2021,0,0,0,0,0,0,0,0,0,2,0,2,0,0,0,0,0,0,0,0
162123,2021,Canada,Bulgaria,0,0,11,11,4/6/2021,0,0,1,1,4,3,3,10,2,1,1,4,0,0,0,0,1,2,0,3
162123,2021,Italy,Bulgaria,0,1,17,18,3/6/2021,0,0,0,0,8,1,2,11,1,9,0,10,0,1,0,1,0,0,0,0
162123,2021,Germany,Bulgaria,1,3,14,18,30/05/2021,0,0,0,0,7,1,3,11,2,7,4,13,0,0,0,0,1,1,0,2
162123,2021,Australia,Bulgaria,0,1,4,5,29/05/2021,0,0,0,0,4,1,0,5,1,4,0,5,0,0,0,0,0,0,2,2
162123,2021,France,Bulgaria,0,2,8,10,28/05/2021,0,0,1,1,4,1,0,5,1,0,2,3,0,0,1,1,1,0,0,1
173009,2021,Slovenia,Bulgaria,0,0,0,0,23/06/2021,0,0,0,0,0,0,0,0,0,0,0,0,0,0,0,0,0,0,0,0
173009,2021,Bulgaria,USA,0,0,0,0,22/06/2021,0,0,1,1,0,0,0,0,0,0,0,0,4,1,14,19,5,3,1,9
173009,2021,Japan,Bulgaria,0,0,0,0,21/06/2021,0,0,0,0,0,0,0,0,0,0,0,0,0,0,0,0,0,0,0,0
173009,2021,Bulgaria,Russia,0,0,0,0,17/06/2021,0,0,0,0,0,0,0,0,0,0,0,0,3,1,3,7,3,0,0,3
173009,2021,Serbia,Bulgaria,0,0,0,0,16/06/2021,0,0,0,0,0,0,0,0,0,0,0,0,0,0,0,0,0,0,0,0
173009,2021,Argentina,Bulgaria,0,0,0,0,15/06/2021,0,0,0,0,0,0,0,0,0,0,0,0,0,0,0,0,0,0,0,0
173009,2021,Netherlands,Bulgaria,0,0,0,0,11/6/2021,0,0,0,0,0,0,0,0,0,0,0,0,0,0,0,0,0,0,0,0
173009,2021,Bulgaria,Brazil,0,0,0,0,10/6/2021,0,0,2,2,0,0,0,0,0,0,0,0,0,0,2,2,0,0,0,0
173009,2021,Poland,Bulgaria,0,0,0,0,9/6/2021,0,0,0,0,0,0,0,0,0,0,0,0,0,0,0,0,0,0,0,0
173009,2021,Bulgaria,Iran,0,0,0,0,5/6/2021,0,0,1,1,0,0,0,0,0,0,0,0,5,0,14,19,9,0,0,9
173009,2021,Canada,Bulgaria,0,0,0,0,4/6/2021,0,0,0,0,0,0,0,0,0,0,0,0,0,0,0,0,0,0,0,0
173009,2021,Italy,Bulgaria,0,0,0,0,3/6/2021,0,0,2,2,0,0,0,0,0,0,0,0,2,0,11,13,6,0,2,8
173009,2021,Germany,Bulgaria,0,0,0,0,30/05/2021,0,0,0,0,0,0,0,0,0,0,0,0,0,0,0,0,0,0,0,0
173009,2021,Australia,Bulgaria,0,0,0,0,29/05/2021,0,0,0,0,0,0,0,0,0,0,0,0,0,0,0,0,0,0,0,0
173009,2021,France,Bulgaria,0,0,0,0,28/05/2021,0,0,0,0,0,0,0,0,0,0,0,0,0,0,0,0,0,0,0,0
150277,2021,Slovenia,Bulgaria,0,1,1,2,23/06/2021,0,0,0,0,0,2,0,2,0,0,0,0,0,0,0,0,0,0,0,0
150277,2021,Bulgaria,USA,0,2,6,8,22/06/2021,0,0,1,1,4,9,8,21,0,4,3,7,0,0,0,0,2,2,0,4
150277,2021,Japan,Bulgaria,0,1,2,3,21/06/2021,0,0,0,0,3,3,4,10,0,0,0,0,0,0,0,0,0,1,0,1
150277,2021,Bulgaria,Russia,1,1,4,6,17/06/2021,0,0,0,0,1,3,5,9,1,0,2,3,0,0,0,0,3,0,0,3
150277,2021,Serbia,Bulgaria,0,1,5,6,16/06/2021,0,0,0,0,11,5,5,21,2,0,1,3,0,0,0,0,4,2,1,7
150277,2021,Argentina,Bulgaria,0,4,6,10,15/06/2021,0,0,1,1,11,4,5,20,2,3,5,10,0,0,0,0,2,3,0,5
150277,2021,Netherlands,Bulgaria,0,4,3,7,11/6/2021,0,0,1,1,7,2,7,16,1,4,2,7,0,0,0,0,2,2,0,4
150277,2021,Bulgaria,Brazil,0,2,3,5,10/6/2021,0,0,0,0,7,4,3,14,1,1,1,3,0,0,0,0,0,0,0,0
150277,2021,Poland,Bulgaria,0,3,5,8,9/6/2021,0,0,1,1,6,6,4,16,0,0,1,1,0,0,0,0,0,3,0,3
150277,2021,Bulgaria,Iran,0,4,5,9,5/6/2021,0,0,1,1,10,8,11,29,1,2,1,4,0,0,1,1,6,1,0,7
150277,2021,Canada,Bulgaria,0,0,0,0,4/6/2021,0,0,0,0,0,0,0,0,0,0,0,0,0,0,0,0,0,0,0,0
150277,2021,Italy,Bulgaria,1,5,10,16,3/6/2021,0,0,1,1,17,8,10,35,4,1,3,8,0,0,0,0,4,3,2,9
150277,2021,Germany,Bulgaria,1,2,1,4,30/05/2021,0,0,0,0,5,0,0,5,0,1,0,1,0,1,0,1,2,0,0,2
150277,2021,Australia,Bulgaria,0,0,0,0,29/05/2021,0,0,0,0,0,0,0,0,0,0,0,0,0,0,0,0,0,0,0,0
150277,2021,France,Bulgaria,0,0,0,0,28/05/2021,0,0,0,0,0,0,0,0,0,0,0,0,0,0,0,0,0,0,0,0
164812,2021,Bulgaria,USA,0,0,0,0,22/06/2021,0,0,0,0,0,0,1,1,0,0,0,0,0,1,1,2,0,0,0,0
164812,2021,Japan,Bulgaria,0,1,2,3,21/06/2021,0,0,0,0,1,1,2,4,0,1,0,1,0,0,7,7,0,2,0,2
164812,2021,Bulgaria,Russia,0,0,0,0,17/06/2021,0,0,0,0,0,0,0,0,0,0,0,0,0,0,0,0,0,0,0,0
164812,2021,Serbia,Bulgaria,0,0,0,0,16/06/2021,0,0,0,0,0,0,0,0,0,0,0,0,0,0,0,0,0,0,0,0
164812,2021,Argentina,Bulgaria,1,0,10,11,15/06/2021,0,0,0,0,8,0,11,19,1,1,0,2,7,4,11,22,0,1,0,1
164812,2021,Netherlands,Bulgaria,2,1,15,18,11/6/2021,0,0,2,2,8,4,9,21,3,2,1,6,5,1,15,21,3,2,1,6
164812,2021,Bulgaria,Brazil,0,1,5,6,10/6/2021,0,0,2,2,2,1,3,6,0,0,0,0,3,1,6,10,3,1,0,4
164812,2021,Poland,Bulgaria,0,0,2,2,9/6/2021,0,0,0,0,0,0,1,1,0,0,0,0,0,1,2,3,0,1,0,1
164812,2021,Bulgaria,Iran,0,0,0,0,5/6/2021,0,0,0,0,0,0,0,0,0,0,0,0,0,0,0,0,0,0,0,0
164812,2021,Canada,Bulgaria,0,2,3,5,4/6/2021,0,0,0,0,5,1,5,11,0,2,1,3,6,1,6,13,2,0,0,2
164812,2021,Italy,Bulgaria,0,1,7,8,3/6/2021,0,0,0,0,7,2,4,13,0,1,1,2,4,3,5,12,2,2,0,4
136299,2021,Japan,Canada,0,0,12,12,17/06/2021,28,1,35,64,0,0,3,3,0,1,2,3,0,0,0,0,9,1,2,12
136299,2021,Canada,Poland,0,2,9,11,15/06/2021,15,1,47,63,0,0,0,0,0,4,2,6,0,0,0,0,6,0,0,6
136299,2021,Canada,France,0,1,12,13,11/6/2021,26,2,73,101,1,0,1,2,3,3,2,8,0,0,0,0,7,1,0,8
136299,2021,Russia,Canada,0,0,0,0,10/6/2021,0,0,0,0,0,0,0,0,0,0,0,0,0,0,0,0,0,0,0,0
136299,2021,Slovenia,Canada,1,2,8,11,9/6/2021,9,1,49,59,0,0,0,0,0,1,0,1,0,0,0,0,2,3,0,5
136299,2021,Canada,Italy,0,1,3,4,5/6/2021,4,0,22,26,0,0,0,0,0,0,2,2,0,0,0,0,2,0,1,3
136299,2021,Canada,Bulgaria,0,0,11,11,4/6/2021,17,0,42,59,0,0,0,0,0,1,1,2,0,0,1,1,2,1,1,4
136299,2021,Iran,Canada,0,0,3,3,3/6/2021,12,1,18,31,0,0,0,0,0,1,0,1,0,0,0,0,1,2,0,3
124556,2021,Canada,Serbia,1,3,19,23,23/06/2021,0,0,4,4,11,3,16,30,2,4,5,11,10,4,15,29,9,2,0,11
124556,2021,Canada,Australia,0,0,0,0,22/06/2021,0,0,0,0,0,0,0,0,0,0,0,0,0,0,0,0,0,0,0,0
124556,2021,Canada,Netherlands,0,2,6,8,21/06/2021,0,0,1,1,11,2,7,20,0,2,1,3,6,0,7,13,7,2,1,10
124556,2021,Japan,Canada,2,2,12,16,17/06/2021,0,0,6,6,12,1,9,22,0,1,2,3,7,1,12,20,4,2,1,7
124556,2021,Canada,Poland,1,2,9,12,15/06/2021,0,0,2,2,7,1,7,15,1,1,1,3,3,2,12,17,3,4,2,9
124556,2021,Canada,France,1,4,10,15,11/6/2021,0,0,4,4,12,6,12,30,2,1,4,7,8,1,16,25,5,1,0,6
124556,2021,Russia,Canada,0,0,0,0,10/6/2021,0,0,1,1,0,0,0,0,0,0,0,0,0,0,0,0,0,0,0,0
124556,2021,Slovenia,Canada,0,2,14,16,9/6/2021,0,0,1,1,10,1,12,23,0,1,1,2,4,1,7,12,3,5,1,9
124556,2021,Canada,Italy,0,0,3,3,5/6/2021,0,0,2,2,9,1,8,18,1,2,1,4,3,2,2,7,1,0,0,1
124556,2021,Canada,Bulgaria,1,3,12,16,4/6/2021,0,0,4,4,8,1,8,17,2,3,2,7,1,1,11,13,7,1,0,8
124556,2021,Iran,Canada,0,3,16,19,3/6/2021,0,0,5,5,13,3,8,24,3,5,1,9,5,1,18,24,3,2,1,6
124556,2021,Argentina,Canada,1,3,9,13,29/05/2021,0,1,0,1,10,1,7,18,1,2,1,4,4,1,8,13,9,0,0,9
124556,2021,USA,Canada,0,1,8,9,28/05/2021,0,1,0,1,6,0,12,18,0,2,2,4,3,1,9,13,4,1,0,5
139429,2021,Canada,Serbia,0,1,8,9,23/06/2021,0,0,4,4,1,3,10,14,6,0,2,8,3,1,4,8,9,0,0,9
139429,2021,Canada,Australia,0,1,6,7,22/06/2021,0,0,1,1,2,1,1,4,0,2,0,2,1,0,2,3,2,0,0,2
139429,2021,Canada,Netherlands,0,0,0,0,21/06/2021,0,0,0,0,0,0,0,0,0,0,0,0,0,0,0,0,0,0,0,0
139429,2021,Japan,Canada,0,0,0,0,17/06/2021,0,0,0,0,0,0,0,0,0,0,0,0,0,0,0,0,0,0,0,0
139429,2021,Canada,Germany,0,0,0,0,16/06/2021,0,0,0,0,0,0,0,0,0,0,0,0,1,0,1,2,0,0,0,0
139429,2021,Canada,Poland,0,0,0,0,15/06/2021,0,0,4,4,0,0,0,0,0,0,0,0,2,2,18,22,5,1,1,7
139429,2021,Canada,France,0,0,0,0,11/6/2021,0,0,3,3,0,0,0,0,0,0,0,0,14,1,14,29,14,2,2,18
139429,2021,Russia,Canada,0,0,0,0,10/6/2021,0,0,3,3,0,0,0,0,0,0,0,0,11,3,15,29,10,5,0,15
139429,2021,Slovenia,Canada,0,0,0,0,9/6/2021,0,0,2,2,0,0,0,0,0,0,0,0,5,2,8,15,2,4,1,7
139429,2021,Canada,Italy,0,0,0,0,5/6/2021,0,0,0,0,0,0,0,0,0,0,0,0,0,0,0,0,0,0,0,0
139429,2021,Canada,Bulgaria,0,0,0,0,4/6/2021,0,0,0,0,0,0,0,0,0,0,0,0,0,0,0,0,0,0,0,0
139429,2021,Iran,Canada,0,1,8,9,3/6/2021,0,0,0,0,0,2,2,4,0,1,1,2,1,0,5,6,3,0,1,4
139429,2021,Canada,Brazil,0,0,0,0,30/05/2021,0,0,0,0,0,0,0,0,0,0,0,0,1,0,3,4,2,1,0,3
136291,2021,Canada,Serbia,0,0,0,0,23/06/2021,0,0,1,1,0,0,0,0,0,0,0,0,0,0,0,0,0,0,0,0
136291,2021,Canada,Australia,2,0,10,12,22/06/2021,0,0,3,3,4,1,3,8,0,0,3,3,4,0,6,10,5,1,1,7
136291,2021,Canada,Netherlands,4,3,8,15,21/06/2021,0,1,1,2,6,6,5,17,1,2,6,9,5,0,8,13,5,0,0,5
136291,2021,Japan,Canada,0,0,0,0,17/06/2021,0,0,0,0,0,0,0,0,0,0,0,0,0,0,0,0,0,0,0,0
136291,2021,Canada,Germany,0,3,11,14,16/06/2021,0,0,4,4,9,4,6,19,1,0,0,1,5,2,8,15,2,3,1,6
136291,2021,Canada,Poland,1,4,4,9,15/06/2021,0,0,3,3,9,3,10,22,1,3,4,8,1,0,16,17,1,2,2,5
136291,2021,Canada,France,0,1,2,3,11/6/2021,0,0,0,0,3,1,3,7,0,0,1,1,0,0,1,1,1,1,0,2
136291,2021,Russia,Canada,2,4,10,16,10/6/2021,0,0,3,3,10,5,8,23,1,1,1,3,8,2,17,27,4,3,0,7
136291,2021,Slovenia,Canada,1,3,4,8,9/6/2021,0,0,1,1,14,3,6,23,1,3,0,4,4,2,22,28,2,0,1,3
136291,2021,Canada,Italy,1,5,16,22,5/6/2021,0,0,7,7,16,10,16,42,1,2,0,3,16,0,18,34,5,0,1,6
136291,2021,Canada,Bulgaria,4,2,11,17,4/6/2021,0,0,1,1,12,3,7,22,0,1,1,2,5,1,14,20,2,2,3,7
136291,2021,Iran,Canada,0,1,4,5,3/6/2021,0,0,1,1,0,0,0,0,0,0,0,0,0,0,0,0,0,0,0,0
136291,2021,Canada,Brazil,0,3,10,13,30/05/2021,0,0,0,0,7,5,9,21,1,0,1,2,10,3,15,28,5,2,0,7
136291,2021,Argentina,Canada,2,3,6,11,29/05/2021,0,0,0,0,5,4,7,16,2,3,1,6,5,0,5,10,4,2,0,6
136291,2021,USA,Canada,0,0,2,2,28/05/2021,0,0,0,0,0,0,1,1,0,0,0,0,0,0,0,0,0,0,0,0
157334,2021,Japan,Canada,0,0,0,0,17/06/2021,0,0,0,0,0,0,0,0,0,0,0,0,0,0,0,0,0,0,0,0
157334,2021,Canada,Germany,0,0,0,0,16/06/2021,0,0,0,0,0,0,0,0,0,0,0,0,0,0,0,0,0,0,0,0
157334,2021,Canada,Poland,0,0,0,0,15/06/2021,0,0,0,0,0,0,0,0,0,0,0,0,0,0,0,0,0,0,0,0
157334,2021,Canada,France,0,0,0,0,11/6/2021,0,0,0,0,0,0,0,0,0,0,0,0,0,0,0,0,0,0,0,0
157334,2021,Russia,Canada,0,0,0,0,10/6/2021,0,0,0,0,0,0,0,0,0,0,0,0,0,0,0,0,1,0,0,1
157334,2021,Slovenia,Canada,0,0,0,0,9/6/2021,0,0,0,0,0,0,0,0,0,0,0,0,0,0,0,0,0,0,0,0
157334,2021,Canada,Italy,0,0,0,0,5/6/2021,0,0,0,0,0,0,0,0,0,0,0,0,0,0,0,0,0,0,0,0
157334,2021,Canada,Bulgaria,0,0,0,0,4/6/2021,0,0,0,0,0,0,0,0,0,0,0,0,0,0,0,0,0,0,0,0
157334,2021,Iran,Canada,0,0,0,0,3/6/2021,0,0,0,0,0,0,0,0,0,0,0,0,0,0,0,0,0,0,0,0
157334,2021,Canada,Brazil,0,0,0,0,30/05/2021,0,0,2,2,0,0,0,0,0,0,0,0,0,0,0,0,5,4,1,10
157334,2021,Argentina,Canada,0,0,0,0,29/05/2021,0,0,0,0,0,0,0,0,0,0,0,0,0,0,0,0,0,0,0,0
157334,2021,USA,Canada,0,0,0,0,28/05/2021,0,0,0,0,0,0,0,0,0,0,0,0,0,0,0,0,0,0,0,0
140061,2021,Canada,Serbia,0,0,3,3,23/06/2021,0,1,3,4,2,2,8,12,1,2,1,4,4,3,6,13,1,0,1,2
140061,2021,Canada,Australia,1,5,6,12,22/06/2021,0,0,3,3,10,1,9,20,2,1,2,5,5,0,4,9,5,0,0,5
140061,2021,Canada,Netherlands,0,0,0,0,21/06/2021,0,0,0,0,1,0,0,1,0,0,0,0,0,0,0,0,1,0,0,1
140061,2021,Japan,Canada,1,2,7,10,17/06/2021,0,0,1,1,8,3,10,21,2,2,2,6,2,0,11,13,5,2,3,10
140061,2021,Canada,Germany,0,3,5,8,16/06/2021,0,0,2,2,10,1,10,21,1,2,0,3,4,1,14,19,2,0,1,3
140061,2021,Canada,Poland,0,0,0,0,15/06/2021,0,0,0,0,1,2,1,4,0,0,0,0,0,0,0,0,1,0,0,1
140061,2021,Slovenia,Canada,0,0,0,0,9/6/2021,0,0,0,0,0,0,0,0,0,0,0,0,0,0,0,0,0,0,0,0
140061,2021,Canada,Brazil,0,0,0,0,30/05/2021,0,0,0,0,0,0,0,0,0,0,0,0,0,0,0,0,0,0,0,0
140061,2021,Argentina,Canada,0,0,0,0,29/05/2021,0,0,0,0,0,0,0,0,0,0,0,0,0,0,0,0,0,0,0,0
140061,2021,USA,Canada,0,4,1,5,28/05/2021,0,0,0,0,8,5,5,18,1,0,1,2,2,1,10,13,5,1,0,6
124553,2021,Canada,Serbia,0,0,18,18,23/06/2021,20,0,79,99,0,1,4,5,0,4,1,5,0,0,0,0,9,2,2,13
124553,2021,Canada,Australia,0,1,10,11,22/06/2021,22,1,30,53,2,0,2,4,0,1,2,3,0,0,0,0,8,3,1,12
124553,2021,Canada,Netherlands,0,2,13,15,21/06/2021,20,2,35,57,1,0,0,1,1,0,2,3,0,0,1,1,3,0,2,5
124553,2021,Japan,Canada,0,0,0,0,17/06/2021,0,0,0,0,0,0,0,0,0,0,0,0,0,0,0,0,0,0,0,0
124553,2021,Canada,Germany,1,1,15,17,16/06/2021,8,0,51,59,2,0,1,3,0,2,0,2,0,0,0,0,9,2,0,11
124553,2021,Canada,Poland,0,0,0,0,15/06/2021,2,0,4,6,0,0,0,0,0,0,0,0,0,0,0,0,1,0,0,1
124553,2021,Canada,France,0,0,0,0,11/6/2021,0,0,0,0,0,0,0,0,0,0,0,0,0,0,0,0,0,0,0,0
124553,2021,Russia,Canada,0,2,10,12,10/6/2021,19,0,68,87,1,0,2,3,1,1,0,2,0,1,1,2,5,6,1,12
124553,2021,Slovenia,Canada,0,0,1,1,9/6/2021,0,0,3,3,0,0,0,0,0,0,0,0,0,0,0,0,0,0,0,0
124553,2021,Canada,Italy,1,1,10,12,5/6/2021,23,0,62,85,1,0,3,4,0,3,2,5,0,0,0,0,5,5,1,11
124553,2021,Iran,Canada,0,2,7,9,3/6/2021,25,0,28,53,2,0,1,3,0,1,0,1,0,0,1,1,6,1,0,7
124553,2021,Canada,Brazil,0,0,0,0,30/05/2021,0,0,0,0,0,0,0,0,0,0,0,0,0,0,0,0,0,0,0,0
124553,2021,Argentina,Canada,0,0,0,0,29/05/2021,0,0,0,0,0,0,0,0,0,0,0,0,0,0,0,0,0,0,0,0
124553,2021,USA,Canada,0,0,6,6,28/05/2021,14,0,58,72,2,0,1,3,1,1,1,3,0,0,1,1,6,3,1,10
140428,2021,Canada,Serbia,0,1,8,9,23/06/2021,0,0,0,0,16,4,9,29,1,5,6,12,0,0,1,1,8,1,2,11
140428,2021,Canada,Australia,2,2,10,14,22/06/2021,0,0,0,0,12,1,9,22,2,3,3,8,0,0,0,0,7,0,0,7
140428,2021,Canada,Netherlands,0,0,3,3,21/06/2021,0,0,0,0,0,0,0,0,0,0,0,0,0,0,0,0,1,0,0,1
140428,2021,Japan,Canada,1,4,6,11,17/06/2021,0,0,2,2,15,1,8,24,0,5,4,9,0,0,0,0,2,2,3,7
140428,2021,Canada,Germany,0,0,0,0,16/06/2021,0,0,0,0,0,0,0,0,0,0,0,0,0,0,0,0,0,0,0,0
140428,2021,Canada,Poland,0,0,3,3,15/06/2021,0,0,0,0,0,0,0,0,0,0,0,0,0,0,0,0,1,0,0,1
140428,2021,Canada,France,0,3,7,10,11/6/2021,0,0,4,4,11,7,12,30,0,5,3,8,0,0,0,0,8,4,0,12
140428,2021,Russia,Canada,0,1,2,3,10/6/2021,0,0,0,0,0,0,0,0,0,0,0,0,0,0,0,0,0,1,0,1
140428,2021,Slovenia,Canada,0,1,3,4,9/6/2021,0,0,0,0,1,0,3,4,0,1,1,2,0,0,0,0,2,0,0,2
140428,2021,Canada,Italy,1,1,4,6,5/6/2021,0,0,0,0,2,6,8,16,0,4,3,7,0,0,0,0,4,0,0,4
140428,2021,Canada,Bulgaria,0,0,0,0,4/6/2021,0,0,0,0,0,0,0,0,0,0,0,0,0,0,0,0,0,0,0,0
140428,2021,Iran,Canada,1,3,8,12,3/6/2021,0,0,0,0,16,7,14,37,0,6,5,11,0,0,1,1,8,2,0,10
140428,2021,Canada,Brazil,0,0,4,4,30/05/2021,0,0,0,0,0,0,0,0,0,0,0,0,0,0,0,0,0,0,0,0
140428,2021,Argentina,Canada,1,4,11,16,29/05/2021,0,0,0,0,11,3,0,14,2,2,0,4,0,0,0,0,4,1,0,5
140428,2021,USA,Canada,0,0,2,2,28/05/2021,0,0,0,0,1,1,3,5,1,0,0,1,0,0,0,0,0,0,0,0
139499,2021,Canada,Serbia,0,0,0,0,23/06/2021,0,0,0,0,0,0,0,0,0,0,0,0,0,0,0,0,0,0,0,0
139499,2021,Canada,Australia,0,1,7,8,22/06/2021,0,0,0,0,7,0,1,8,2,1,6,9,1,0,0,1,0,1,1,2
139499,2021,Canada,Netherlands,0,0,0,0,21/06/2021,0,0,0,0,0,0,0,0,0,0,0,0,0,0,0,0,0,0,0,0
139499,2021,Japan,Canada,0,0,0,0,17/06/2021,0,0,0,0,0,0,0,0,0,0,0,0,0,0,0,0,0,0,0,0
139499,2021,Canada,Germany,0,1,11,12,16/06/2021,0,0,0,0,2,0,4,6,1,4,1,6,1,0,1,2,2,0,0,2
139499,2021,Canada,Poland,0,0,0,0,15/06/2021,0,0,0,0,0,0,0,0,0,0,0,0,0,0,0,0,0,0,0,0
139499,2021,Canada,France,0,3,2,5,11/6/2021,0,0,0,0,5,3,1,9,1,4,5,10,1,0,1,2,2,1,0,3
139499,2021,Russia,Canada,0,2,10,12,10/6/2021,0,0,1,1,4,2,4,10,1,0,1,2,1,0,1,2,2,1,0,3
139499,2021,Slovenia,Canada,0,0,5,5,9/6/2021,0,0,0,0,2,0,0,2,1,1,1,3,0,0,0,0,0,0,0,0
139499,2021,Canada,Italy,0,2,7,9,5/6/2021,0,0,2,2,5,2,4,11,1,5,1,7,0,0,2,2,3,1,0,4
139499,2021,Canada,Bulgaria,0,0,10,10,4/6/2021,0,0,0,0,3,2,1,6,2,4,0,6,0,0,1,1,3,3,0,6
139499,2021,Iran,Canada,0,0,0,0,3/6/2021,0,0,0,0,0,0,0,0,0,0,0,0,0,0,0,0,0,0,0,0
139499,2021,Canada,Brazil,0,0,0,0,30/05/2021,0,0,0,0,0,0,0,0,0,0,0,0,0,0,0,0,0,0,0,0
139499,2021,Argentina,Canada,0,2,10,12,29/05/2021,0,0,0,0,1,1,1,3,1,2,2,5,0,0,1,1,0,0,0,0
139499,2021,USA,Canada,0,0,5,5,28/05/2021,0,0,0,0,3,0,0,3,0,1,1,2,0,0,0,0,0,0,0,0
136296,2021,Canada,Serbia,0,1,21,22,23/06/2021,1,0,2,3,4,1,3,8,5,5,2,12,1,0,0,1,0,0,0,0
136296,2021,Canada,Australia,0,0,0,0,22/06/2021,0,0,0,0,0,0,0,0,0,0,0,0,0,0,0,0,0,0,0,0
136296,2021,Canada,Netherlands,0,1,11,12,21/06/2021,0,0,0,0,7,0,3,10,2,2,4,8,1,0,0,1,0,1,0,1
136296,2021,Japan,Canada,0,0,0,0,17/06/2021,0,0,0,0,0,0,0,0,0,0,0,0,0,0,0,0,0,0,0,0
136296,2021,Canada,Germany,0,0,0,0,16/06/2021,0,0,0,0,0,0,0,0,0,0,0,0,0,0,0,0,0,0,0,0
136296,2021,Canada,Poland,0,0,9,9,15/06/2021,0,0,0,0,5,0,4,9,1,7,4,12,0,0,2,2,3,0,0,3
136296,2021,Canada,France,0,2,13,15,11/6/2021,0,0,0,0,2,2,2,6,3,3,1,7,0,0,0,0,3,0,0,3
136296,2021,Russia,Canada,0,0,0,0,10/6/2021,0,0,0,0,0,0,0,0,0,0,0,0,0,0,0,0,0,0,0,0
136296,2021,Slovenia,Canada,0,0,4,4,9/6/2021,0,0,0,0,3,0,1,4,2,3,3,8,0,0,2,2,0,0,0,0
136296,2021,Canada,Italy,0,0,12,12,5/6/2021,0,0,1,1,6,1,3,10,2,6,3,11,0,0,1,1,4,2,0,6
136296,2021,Canada,Bulgaria,0,0,0,0,4/6/2021,0,0,0,0,0,0,0,0,0,0,0,0,0,0,0,0,0,0,0,0
136296,2021,Iran,Canada,0,0,11,11,3/6/2021,0,0,3,3,7,1,2,10,2,5,5,12,0,1,4,5,4,2,0,6
136296,2021,Canada,Brazil,1,0,14,15,30/05/2021,0,0,0,0,4,0,2,6,3,7,2,12,2,0,3,5,0,0,0,0
136296,2021,Argentina,Canada,0,0,1,1,29/05/2021,0,0,0,0,0,0,0,0,0,0,0,0,0,0,0,0,0,0,0,0
157321,2021,Canada,Serbia,0,3,4,7,23/06/2021,0,0,2,2,7,2,7,16,2,1,1,4,0,0,1,1,0,4,0,4
157321,2021,Canada,Australia,0,0,0,0,22/06/2021,0,0,0,0,0,0,0,0,0,0,0,0,0,0,0,0,0,0,0,0
157321,2021,Canada,Netherlands,0,1,6,7,21/06/2021,0,0,1,1,11,1,2,14,3,1,4,8,0,0,0,0,4,4,0,8
157321,2021,Japan,Canada,0,0,0,0,17/06/2021,0,0,0,0,0,0,0,0,0,0,0,0,0,0,0,0,0,0,0,0
157321,2021,Canada,Germany,0,3,9,12,16/06/2021,1,0,4,5,14,3,11,28,1,1,0,2,0,0,0,0,4,4,0,8
157321,2021,Canada,Poland,2,3,7,12,15/06/2021,0,0,1,1,13,3,4,20,1,7,3,11,1,0,2,3,5,0,0,5
157321,2021,Canada,France,0,0,0,0,11/6/2021,0,0,0,0,0,0,0,0,0,0,0,0,0,0,0,0,0,0,0,0
157321,2021,Russia,Canada,1,7,7,15,10/6/2021,0,0,0,0,13,6,12,31,1,2,0,3,0,0,1,1,2,2,0,4
157321,2021,Slovenia,Canada,0,4,3,7,9/6/2021,0,0,1,1,4,3,1,8,0,1,0,1,0,0,0,0,4,1,1,6
157321,2021,Canada,Italy,4,6,7,17,5/6/2021,0,0,1,1,6,5,3,14,2,2,1,5,0,0,0,0,9,0,1,10
157321,2021,Canada,Bulgaria,0,2,7,9,4/6/2021,0,0,4,4,9,2,8,19,3,6,0,9,0,0,0,0,2,1,0,3
157321,2021,Iran,Canada,0,2,0,2,3/6/2021,0,0,0,0,1,1,1,3,0,0,0,0,0,0,0,0,0,0,0,0
157321,2021,Canada,Brazil,1,6,7,14,30/05/2021,0,0,0,0,21,5,18,44,2,4,2,8,0,0,1,1,5,4,2,11
157321,2021,Argentina,Canada,0,0,0,0,29/05/2021,0,0,0,0,0,0,0,0,0,0,0,0,0,0,0,0,0,0,0,0
157321,2021,USA,Canada,2,1,9,12,28/05/2021,0,0,0,0,4,6,7,17,1,1,2,4,0,0,0,0,4,0,0,4
157327,2021,Canada,Serbia,0,0,0,0,23/06/2021,0,0,0,0,0,0,0,0,0,0,0,0,0,0,0,0,0,0,0,0
157327,2021,Canada,Australia,0,0,0,0,22/06/2021,0,0,0,0,0,0,0,0,0,0,0,0,0,0,0,0,0,0,0,0
157327,2021,Canada,Netherlands,0,0,0,0,21/06/2021,0,0,0,0,0,0,0,0,0,0,0,0,0,0,0,0,0,0,0,0
157327,2021,Canada,Germany,0,0,0,0,16/06/2021,0,0,0,0,0,0,0,0,0,0,0,0,0,0,0,0,0,0,0,0
157327,2021,Canada,Poland,0,0,0,0,15/06/2021,0,0,0,0,0,0,0,0,0,0,0,0,0,0,0,0,0,0,0,0
157327,2021,Canada,France,0,2,15,17,11/6/2021,0,0,4,4,17,5,11,33,0,6,1,7,7,2,18,27,7,1,2,10
157327,2021,Russia,Canada,0,1,8,9,10/6/2021,0,1,5,6,10,5,12,27,0,2,2,4,4,0,11,15,6,3,0,9
157327,2021,Slovenia,Canada,0,0,0,0,9/6/2021,0,0,0,0,0,0,0,0,0,1,0,1,0,0,0,0,0,0,0,0
157327,2021,Canada,Italy,1,2,12,15,5/6/2021,0,0,2,2,13,6,6,25,1,4,2,7,7,1,16,24,9,1,0,10
157327,2021,Canada,Bulgaria,0,0,0,0,4/6/2021,0,0,0,0,0,0,0,0,0,0,0,0,0,0,0,0,0,0,0,0
157327,2021,Iran,Canada,1,2,5,8,3/6/2021,0,0,1,1,5,3,5,13,0,2,1,3,3,3,8,14,1,1,0,2
157327,2021,Canada,Brazil,0,1,12,13,30/05/2021,0,0,0,0,13,2,11,26,1,2,2,5,6,0,15,21,7,3,2,12
157327,2021,Argentina,Canada,0,0,0,0,29/05/2021,0,0,0,0,0,0,0,0,0,0,0,0,0,0,0,0,0,0,0,0
157327,2021,USA,Canada,0,1,2,3,28/05/2021,0,0,0,0,0,2,2,4,0,0,0,0,2,1,6,9,1,1,0,2
124551,2021,Canada,Serbia,0,3,8,11,23/06/2021,0,0,0,0,5,1,4,10,2,7,5,14,0,0,0,0,4,1,0,5
124551,2021,Canada,Australia,0,0,0,0,22/06/2021,0,0,0,0,0,0,0,0,0,0,0,0,0,0,0,0,0,0,0,0
124551,2021,Canada,Netherlands,1,0,13,14,21/06/2021,0,0,1,1,5,0,0,5,4,2,2,8,0,0,0,0,1,2,1,4
124551,2021,Japan,Canada,2,0,10,12,17/06/2021,0,0,1,1,3,0,5,8,0,5,2,7,0,0,2,2,1,0,0,1
124551,2021,Canada,Germany,0,0,7,7,16/06/2021,0,0,0,0,2,0,1,3,1,3,2,6,0,0,0,0,2,3,0,5
124551,2021,Canada,Poland,0,0,0,0,15/06/2021,0,0,0,0,0,0,0,0,0,0,0,0,0,0,0,0,0,0,0,0
124551,2021,Argentina,Canada,0,1,10,11,29/05/2021,0,0,0,0,6,0,1,7,0,1,2,3,1,0,0,1,0,2,0,2
124551,2021,USA,Canada,0,0,10,10,28/05/2021,0,1,0,1,5,0,3,8,1,2,2,5,1,1,0,2,2,0,0,2
139490,2021,Canada,Serbia,0,0,0,0,23/06/2021,0,0,6,6,0,0,0,0,0,0,0,0,7,0,16,23,17,3,1,21
139490,2021,Canada,Australia,0,0,0,0,22/06/2021,0,0,5,5,0,0,0,0,0,0,0,0,6,2,3,11,11,2,1,14
139490,2021,Canada,Netherlands,0,0,0,0,21/06/2021,0,0,3,3,0,0,0,0,0,0,0,0,2,0,12,14,6,3,0,9
139490,2021,Japan,Canada,0,0,0,0,17/06/2021,0,1,6,7,0,0,0,0,0,0,0,0,5,0,13,18,6,0,2,8
139490,2021,Canada,Germany,0,0,0,0,16/06/2021,0,0,6,6,0,0,0,0,0,0,0,0,8,0,3,11,9,3,0,12
139490,2021,Canada,Italy,0,0,0,0,5/6/2021,0,0,15,15,0,0,0,0,0,0,0,0,9,2,15,26,13,3,0,16
139490,2021,Canada,Bulgaria,0,0,0,0,4/6/2021,0,0,4,4,0,0,0,0,0,0,0,0,6,2,7,15,7,2,2,11
139490,2021,Iran,Canada,0,0,0,0,3/6/2021,0,0,7,7,0,0,0,0,0,0,0,0,10,1,14,25,8,3,0,11
139490,2021,Canada,Brazil,0,0,0,0,30/05/2021,0,0,1,1,0,0,0,0,0,0,0,0,9,2,15,26,4,1,1,6
139490,2021,Argentina,Canada,0,0,0,0,29/05/2021,0,0,0,0,0,0,0,0,0,0,0,0,7,1,7,15,3,2,0,5
139490,2021,USA,Canada,0,0,0,0,28/05/2021,0,0,2,2,0,0,0,0,0,0,0,0,9,0,10,19,12,5,0,17
151871,2021,Canada,Serbia,0,2,0,2,23/06/2021,0,0,0,0,1,0,1,2,0,1,3,4,0,0,0,0,0,0,0,0
151871,2021,Canada,Australia,0,5,4,9,22/06/2021,0,0,0,0,4,0,4,8,3,2,6,11,0,0,0,0,2,0,1,3
151871,2021,Canada,Netherlands,0,0,0,0,21/06/2021,0,0,0,0,0,0,0,0,0,0,0,0,0,0,0,0,0,0,0,0
151871,2021,Japan,Canada,1,3,9,13,17/06/2021,0,0,0,0,6,0,1,7,4,10,5,19,1,0,0,1,3,0,0,3
151871,2021,Canada,Germany,0,0,3,3,16/06/2021,0,0,0,0,0,0,0,0,1,2,0,3,0,0,0,0,0,0,0,0
151871,2021,Canada,Poland,1,3,5,9,15/06/2021,0,1,1,2,4,0,3,7,0,1,4,5,0,0,0,0,2,0,2,4
151871,2021,Canada,France,0,0,0,0,11/6/2021,0,0,0,0,0,0,0,0,0,0,0,0,0,0,0,0,0,0,0,0
151871,2021,Russia,Canada,4,0,14,18,10/6/2021,0,0,1,1,6,3,2,11,1,2,2,5,1,0,1,2,0,1,0,1
151871,2021,Slovenia,Canada,0,2,6,8,9/6/2021,0,2,4,6,0,0,3,3,1,2,3,6,1,0,1,2,0,1,0,1
151871,2021,Canada,Italy,0,1,4,5,5/6/2021,0,0,0,0,3,3,0,6,0,0,0,0,0,0,1,1,0,2,0,2
151871,2021,Canada,Bulgaria,2,3,8,13,4/6/2021,0,0,0,0,9,2,1,12,3,4,2,9,1,0,0,1,2,0,0,2
151871,2021,Iran,Canada,1,2,11,14,3/6/2021,0,0,1,1,7,2,4,13,2,4,3,9,0,0,0,0,2,2,0,4
151871,2021,Canada,Brazil,0,3,11,14,30/05/2021,0,0,0,0,6,2,3,11,4,3,2,9,0,1,0,1,4,0,0,4
151871,2021,Argentina,Canada,0,0,0,0,29/05/2021,0,0,0,0,0,0,0,0,0,0,0,0,0,0,0,0,0,0,0,0
151871,2021,USA,Canada,1,1,6,8,28/05/2021,0,0,1,1,1,2,0,3,1,3,2,6,0,0,0,0,0,0,0,0
143745,2021,Canada,Serbia,0,0,0,0,23/06/2021,0,0,1,1,0,0,0,0,0,0,0,0,0,0,0,0,0,0,0,0
143745,2021,Canada,Australia,0,0,0,0,22/06/2021,0,0,4,4,0,0,0,0,1,0,0,1,0,0,0,0,0,0,0,0
143745,2021,Canada,Netherlands,0,0,0,0,21/06/2021,1,0,3,4,0,0,0,0,0,0,0,0,0,0,0,0,0,0,0,0
143745,2021,Canada,Germany,0,0,0,0,16/06/2021,0,0,1,1,0,0,0,0,0,0,0,0,0,0,0,0,0,0,0,0
143745,2021,Canada,France,0,0,0,0,11/6/2021,1,0,5,6,0,0,0,0,0,0,0,0,0,0,0,0,0,0,0,0
143745,2021,Russia,Canada,0,0,0,0,10/6/2021,0,0,0,0,0,0,0,0,0,0,0,0,0,0,0,0,0,0,0,0
143745,2021,Canada,Bulgaria,0,1,0,1,4/6/2021,0,0,2,2,0,0,1,1,0,0,0,0,0,0,0,0,0,0,0,0
143745,2021,Canada,Brazil,0,4,11,15,30/05/2021,24,1,78,103,1,1,1,3,1,1,4,6,0,0,0,0,3,4,0,7
143745,2021,Argentina,Canada,0,0,9,9,29/05/2021,17,0,38,55,0,0,2,2,1,3,1,5,0,0,0,0,2,3,0,5
143745,2021,USA,Canada,0,1,0,1,28/05/2021,4,0,0,4,0,0,0,0,0,0,0,0,0,0,1,1,2,0,0,2
140042,2021,Canada,France,0,1,7,8,11/6/2021,0,0,0,0,1,1,1,3,0,1,3,4,0,0,0,0,0,0,0,0
140042,2021,Russia,Canada,0,0,0,0,10/6/2021,0,0,0,0,0,0,0,0,0,0,0,0,0,0,0,0,0,0,0,0
140042,2021,Slovenia,Canada,0,0,0,0,9/6/2021,0,0,0,0,0,0,0,0,0,0,0,0,0,0,0,0,0,0,0,0
140042,2021,Canada,Italy,0,0,0,0,5/6/2021,0,0,0,0,0,0,0,0,0,0,0,0,0,0,0,0,0,0,0,0
140042,2021,Canada,Bulgaria,0,0,0,0,4/6/2021,0,0,0,0,0,0,0,0,0,0,0,0,0,0,0,0,0,0,0,0
140042,2021,Iran,Canada,0,0,0,0,3/6/2021,0,0,0,0,0,0,0,0,0,0,0,0,0,0,0,0,0,0,0,0
140042,2021,Canada,Brazil,0,0,0,0,30/05/2021,0,0,0,0,0,0,0,0,0,0,0,0,0,0,0,0,0,0,0,0
140042,2021,USA,Canada,0,0,0,0,28/05/2021,0,0,0,0,0,0,0,0,0,0,0,0,0,0,0,0,0,0,0,0
152494,2021,France,Slovenia,0,0,9,9,27/06/2021,0,0,1,1,4,2,0,6,1,3,5,9,0,0,0,0,1,1,0,2
152494,2021,Brazil,France,0,0,10,10,26/06/2021,1,0,1,2,5,2,1,8,0,5,3,8,0,0,1,1,1,1,0,2
152494,2021,France,Poland,0,3,17,20,23/06/2021,0,0,1,1,6,1,5,12,0,3,2,5,0,0,0,0,2,0,0,2
152494,2021,France,Argentina,2,0,14,16,22/06/2021,0,0,0,0,7,1,1,9,0,6,1,7,1,0,0,1,4,2,0,6
152494,2021,France,Iran,0,2,7,9,21/06/2021,0,0,0,0,5,0,2,7,2,2,0,4,0,0,0,0,2,1,0,3
152494,2021,France,Italy,1,1,11,13,17/06/2021,0,0,0,0,2,1,5,8,2,1,2,5,0,0,1,1,1,0,0,1
152494,2021,USA,France,0,2,13,15,16/06/2021,0,1,1,2,6,1,5,12,2,3,7,12,2,0,0,2,4,0,3,7
152494,2021,Netherlands,France,0,2,15,17,15/06/2021,0,0,1,1,11,1,3,15,2,7,4,13,0,0,0,0,1,0,0,1
152494,2021,Canada,France,0,0,16,16,11/6/2021,1,0,4,5,3,1,5,9,2,6,2,10,0,0,0,0,2,1,0,3
152494,2021,France,Slovenia,0,0,0,0,10/6/2021,0,0,0,0,0,0,0,0,0,0,0,0,0,0,0,0,0,0,0,0
152494,2021,France,Russia,0,1,8,9,9/6/2021,0,0,3,3,2,0,6,8,3,5,8,16,0,0,0,0,4,1,1,6
152494,2021,France,Japan,1,1,13,15,5/6/2021,0,0,1,1,8,1,6,15,3,5,2,10,1,0,0,1,3,0,0,3
152494,2021,Serbia,France,0,2,11,13,4/6/2021,0,0,0,0,3,1,4,8,0,8,2,10,3,1,0,4,2,0,1,3
152494,2021,Brazil,France,0,1,10,11,3/6/2021,0,0,2,2,6,1,4,11,1,9,4,14,1,0,1,2,4,0,0,4
152494,2021,Australia,France,0,0,1,1,30/05/2021,0,0,0,0,3,0,0,3,0,1,0,1,0,0,0,0,2,0,0,2
152494,2021,Germany,France,0,4,12,16,29/05/2021,0,0,0,0,8,1,4,13,3,3,3,9,2,0,0,2,0,0,0,0
152494,2021,France,Bulgaria,0,2,7,9,28/05/2021,0,0,1,1,5,1,2,8,2,0,0,2,0,0,0,0,0,0,0,0
119792,2021,France,Slovenia,0,0,0,0,27/06/2021,1,0,7,8,0,0,0,0,0,0,0,0,6,0,4,10,6,1,1,8
119792,2021,Brazil,France,0,0,0,0,26/06/2021,0,0,2,2,0,0,0,0,0,0,0,0,3,1,9,13,6,5,2,13
119792,2021,France,Poland,0,0,0,0,23/06/2021,0,0,2,2,0,0,0,0,0,0,0,0,10,1,10,21,12,2,0,14
119792,2021,France,Argentina,0,0,0,0,22/06/2021,0,0,6,6,0,0,0,0,0,0,0,0,5,0,6,11,12,2,0,14
119792,2021,France,Iran,0,0,0,0,21/06/2021,0,0,0,0,0,0,0,0,0,0,0,0,13,0,11,24,5,6,2,13
119792,2021,France,Italy,0,0,0,0,17/06/2021,0,0,3,3,0,0,0,0,0,0,0,0,0,0,2,2,4,2,0,6
119792,2021,USA,France,0,0,0,0,16/06/2021,0,0,10,10,0,0,0,0,0,0,0,0,8,0,16,24,11,5,2,18
119792,2021,Netherlands,France,0,0,0,0,15/06/2021,0,0,7,7,0,0,0,0,0,0,0,0,8,0,12,20,17,2,1,20
119792,2021,Canada,France,0,0,0,0,11/6/2021,0,0,7,7,0,0,0,0,0,0,0,0,8,0,16,24,8,4,0,12
119792,2021,France,Slovenia,0,0,0,0,10/6/2021,0,0,3,3,0,0,0,0,0,0,0,0,9,1,3,13,10,4,3,17
119792,2021,France,Russia,0,0,0,0,9/6/2021,0,0,4,4,0,0,0,0,0,0,0,0,6,0,10,16,15,2,1,18
119792,2021,France,Japan,0,0,0,0,5/6/2021,0,0,3,3,0,0,0,0,0,0,0,0,6,3,13,22,8,6,1,15
119792,2021,Serbia,France,0,0,0,0,4/6/2021,0,0,4,4,0,0,0,0,0,0,0,0,7,1,16,24,10,3,3,16
119792,2021,Brazil,France,0,0,0,0,3/6/2021,0,0,4,4,0,0,0,0,0,0,0,0,7,1,14,22,13,6,3,22
142694,2021,France,Slovenia,0,0,0,0,27/06/2021,0,0,0,0,0,0,0,0,0,0,0,0,0,0,0,0,0,0,0,0
142694,2021,Brazil,France,0,2,4,6,26/06/2021,0,0,0,0,11,0,8,19,1,5,1,7,0,0,0,0,3,0,1,4
142694,2021,France,Poland,2,1,8,11,23/06/2021,0,0,0,0,6,6,7,19,1,5,3,9,0,0,0,0,8,1,2,11
142694,2021,France,Argentina,1,1,9,11,22/06/2021,0,0,1,1,12,7,8,27,1,1,1,3,0,0,0,0,3,2,1,6
142694,2021,France,Iran,0,0,0,0,21/06/2021,0,0,0,0,0,0,0,0,0,0,0,0,0,0,0,0,0,0,0,0
142694,2021,France,Italy,0,0,0,0,17/06/2021,0,0,0,0,0,0,0,0,0,0,0,0,0,0,0,0,0,0,0,0
142694,2021,USA,France,0,1,12,13,16/06/2021,0,0,6,6,13,4,9,26,1,1,6,8,0,0,0,0,8,2,0,10
142694,2021,Canada,France,0,2,11,13,11/6/2021,0,0,5,5,13,2,9,24,0,0,4,4,0,0,0,0,3,1,1,5
142694,2021,France,Russia,4,3,15,22,9/6/2021,0,0,2,2,14,5,13,32,0,3,4,7,0,0,0,0,5,5,0,10
142694,2021,France,Japan,1,8,12,21,5/6/2021,0,0,1,1,16,4,16,36,2,4,0,6,0,0,0,0,2,3,1,6
142694,2021,Brazil,France,0,3,14,17,3/6/2021,0,0,0,0,20,4,15,39,0,4,0,4,0,0,0,0,5,0,0,5
142694,2021,Australia,France,2,2,15,19,30/05/2021,0,0,0,0,14,6,6,26,1,3,3,7,0,0,0,0,7,0,1,8
142694,2021,Germany,France,0,0,1,1,29/05/2021,0,0,0,0,0,0,0,0,0,1,0,1,0,0,0,0,1,0,0,1
142694,2021,France,Bulgaria,1,4,7,12,28/05/2021,0,0,0,0,8,4,13,25,1,0,0,1,0,0,0,0,1,0,0,1
119804,2021,France,Slovenia,0,0,0,0,27/06/2021,0,0,0,0,0,0,0,0,0,0,0,0,0,0,0,0,0,0,0,0
119804,2021,Brazil,France,0,0,6,6,26/06/2021,7,0,30,37,0,0,0,0,0,0,0,0,0,0,0,0,1,0,0,1
119804,2021,France,Poland,1,1,7,9,23/06/2021,4,1,47,52,0,0,0,0,0,1,2,3,0,0,0,0,3,0,0,3
119804,2021,France,Argentina,0,0,0,0,22/06/2021,0,0,0,0,0,0,0,0,0,0,0,0,0,0,0,0,0,0,0,0
119804,2021,France,Iran,0,1,11,12,21/06/2021,17,0,49,66,0,0,0,0,0,1,3,4,0,0,0,0,5,3,0,8
119804,2021,France,Italy,0,1,7,8,17/06/2021,13,0,46,59,0,0,0,0,1,1,0,2,0,0,0,0,3,2,0,5
119804,2021,USA,France,0,1,13,14,16/06/2021,13,0,50,63,0,0,0,0,0,1,0,1,0,0,0,0,9,0,1,10
119804,2021,Netherlands,France,0,0,0,0,15/06/2021,0,0,0,0,0,0,0,0,0,0,0,0,0,0,0,0,0,0,0,0
119804,2021,Canada,France,0,0,8,8,11/6/2021,9,1,31,41,0,0,0,0,0,1,1,2,0,0,0,0,4,1,2,7
119804,2021,France,Slovenia,0,1,13,14,10/6/2021,38,0,33,71,0,0,0,0,0,3,3,6,0,0,0,0,2,3,0,5
119804,2021,France,Russia,0,0,0,0,9/6/2021,0,0,0,0,0,0,0,0,0,0,0,0,0,0,0,0,0,0,0,0
119804,2021,Serbia,France,0,3,12,15,4/6/2021,19,1,90,110,0,0,2,2,0,3,2,5,0,0,1,1,4,4,1,9
119804,2021,Brazil,France,0,1,10,11,3/6/2021,34,0,52,86,0,0,0,0,1,3,3,7,0,0,0,0,5,1,0,6
119804,2021,Germany,France,0,2,11,13,29/05/2021,25,0,0,25,1,0,0,1,1,0,0,1,0,0,0,0,3,2,0,5
119804,2021,France,Bulgaria,0,0,0,0,28/05/2021,0,0,0,0,0,0,0,0,0,0,0,0,0,0,0,0,0,0,0,0
124518,2021,France,Slovenia,0,1,2,3,27/06/2021,0,0,0,0,0,0,0,0,0,0,0,0,0,0,0,0,0,1,0,1
124518,2021,Brazil,France,0,0,3,3,26/06/2021,0,0,1,1,3,3,5,11,0,0,0,0,1,0,4,5,3,0,0,3
124518,2021,France,Poland,0,3,6,9,23/06/2021,0,0,2,2,4,4,6,14,2,1,0,3,5,0,13,18,2,3,1,6
124518,2021,France,Argentina,0,0,0,0,22/06/2021,0,0,0,0,0,0,0,0,0,0,0,0,0,0,0,0,0,0,0,0
124518,2021,France,Iran,0,0,7,7,21/06/2021,0,0,0,0,8,1,3,12,0,0,1,1,4,0,6,10,1,2,0,3
124518,2021,France,Italy,0,1,4,5,17/06/2021,0,0,2,2,10,1,3,14,0,1,0,1,3,2,10,15,1,1,0,2
124518,2021,USA,France,0,1,6,7,16/06/2021,0,0,2,2,7,1,4,12,0,1,2,3,4,0,7,11,4,2,0,6
124518,2021,Netherlands,France,0,1,1,2,15/06/2021,0,0,0,0,2,0,1,3,0,0,1,1,1,1,2,4,1,3,1,5
124518,2021,Canada,France,0,1,9,10,11/6/2021,0,0,2,2,13,2,15,30,4,1,4,9,12,1,9,22,7,1,0,8
124518,2021,France,Slovenia,0,2,2,4,10/6/2021,0,0,0,0,5,1,5,11,0,1,0,1,3,2,7,12,1,1,0,2
124518,2021,France,Russia,0,1,4,5,9/6/2021,0,0,0,0,0,0,0,0,0,0,0,0,0,0,0,0,2,0,0,2
124518,2021,France,Japan,1,1,13,15,5/6/2021,0,0,2,2,13,2,6,21,1,3,0,4,7,1,12,20,1,2,0,3
124518,2021,Brazil,France,1,4,14,19,3/6/2021,0,0,4,4,12,3,7,22,0,2,1,3,4,1,10,15,5,5,2,12
124518,2021,Australia,France,2,2,14,18,30/05/2021,0,0,0,0,12,0,8,20,2,3,4,9,5,0,9,14,9,1,4,14
124518,2021,Germany,France,0,1,2,3,29/05/2021,0,0,0,0,0,0,0,0,0,0,0,0,0,0,0,0,0,0,0,0
124518,2021,France,Bulgaria,1,1,13,15,28/05/2021,0,0,1,1,7,1,5,13,0,1,0,1,6,2,13,21,1,0,0,1
119798,2021,Canada,France,1,1,5,7,11/6/2021,0,0,1,1,1,3,3,7,1,0,0,1,4,0,9,13,2,5,0,7
119798,2021,France,Slovenia,1,2,2,5,10/6/2021,0,0,0,0,0,0,0,0,0,0,0,0,0,0,0,0,0,0,0,0
119798,2021,France,Japan,0,1,8,9,5/6/2021,0,0,0,0,1,2,2,5,0,0,0,0,1,0,4,5,1,0,0,1
119798,2021,Serbia,France,0,2,9,11,4/6/2021,0,0,2,2,4,2,1,7,0,1,0,1,6,0,5,11,2,2,0,4
119798,2021,Australia,France,0,0,0,0,30/05/2021,0,0,2,2,0,0,0,0,0,0,0,0,2,1,4,7,3,0,0,3
119798,2021,Germany,France,0,0,0,0,29/05/2021,0,0,0,0,0,0,0,0,0,0,0,0,3,0,10,13,6,2,0,8
119798,2021,France,Bulgaria,0,0,0,0,28/05/2021,0,0,0,0,0,0,0,0,0,0,0,0,0,0,0,0,0,0,0,0
119800,2021,France,Slovenia,3,4,9,16,27/06/2021,0,0,7,7,14,3,0,17,1,4,1,6,4,2,14,20,3,1,0,4
119800,2021,Brazil,France,1,4,8,13,26/06/2021,0,0,5,5,4,5,7,16,0,2,1,3,9,1,14,24,8,0,0,8
119800,2021,France,Poland,1,5,11,17,23/06/2021,0,0,12,12,15,6,7,28,2,2,1,5,14,2,15,31,7,2,0,9
119800,2021,France,Argentina,0,0,0,0,22/06/2021,0,0,0,0,0,0,0,0,0,0,0,0,0,0,0,0,0,0,0,0
119800,2021,France,Iran,2,3,15,20,21/06/2021,0,0,3,3,7,5,2,14,0,3,0,3,5,2,10,17,3,1,1,5
119800,2021,USA,France,3,5,11,19,16/06/2021,0,0,7,7,12,7,16,35,1,2,1,4,4,1,19,24,10,4,0,14
119800,2021,Netherlands,France,0,4,7,11,15/06/2021,0,0,4,4,7,2,5,14,0,1,0,1,4,0,14,18,3,2,1,6
119800,2021,France,Slovenia,1,4,8,13,10/6/2021,0,0,4,4,12,2,2,16,1,1,2,4,8,2,6,16,4,1,1,6
119800,2021,France,Russia,3,4,13,20,9/6/2021,0,0,7,7,18,6,7,31,0,1,2,3,8,1,20,29,8,1,2,11
119800,2021,Serbia,France,3,1,9,13,4/6/2021,0,0,1,1,5,1,2,8,0,4,0,4,4,0,4,8,0,3,1,4
119800,2021,Brazil,France,1,7,4,12,3/6/2021,0,0,5,5,11,1,12,24,0,5,0,5,6,2,15,23,6,1,1,8
119800,2021,Australia,France,0,1,5,6,30/05/2021,0,0,0,0,6,5,11,22,0,1,0,1,7,0,17,24,4,1,1,6
136851,2021,France,Slovenia,1,3,9,13,27/06/2021,14,0,34,48,4,0,1,5,3,0,3,6,0,0,1,1,2,0,0,2
136851,2021,Brazil,France,1,1,3,5,26/06/2021,8,0,22,30,0,0,2,2,1,0,0,1,0,0,0,0,2,0,0,2
136851,2021,France,Poland,1,2,6,9,23/06/2021,17,0,31,48,3,0,0,3,1,0,2,3,0,0,0,0,2,2,0,4
136851,2021,France,Argentina,2,3,9,14,22/06/2021,24,2,44,70,3,0,2,5,2,1,1,4,0,0,2,2,5,2,0,7
136851,2021,France,Iran,0,0,0,0,21/06/2021,0,0,0,0,0,0,0,0,0,0,0,0,0,0,0,0,0,0,0,0
136851,2021,France,Italy,0,3,9,12,17/06/2021,9,0,46,55,0,1,0,1,1,2,0,3,0,0,0,0,3,0,0,3
136851,2021,USA,France,0,1,3,4,16/06/2021,9,0,27,36,0,0,1,1,0,1,1,2,0,0,0,0,3,0,0,3
136851,2021,Netherlands,France,0,3,14,17,15/06/2021,38,0,69,107,1,0,2,3,2,2,4,8,0,0,0,0,5,2,1,8
136851,2021,Canada,France,0,3,7,10,11/6/2021,9,1,36,46,1,0,0,1,0,1,1,2,0,0,0,0,7,2,2,11
136851,2021,France,Slovenia,0,0,2,2,10/6/2021,9,0,9,18,0,0,0,0,0,1,2,3,0,0,0,0,1,2,0,3
136851,2021,France,Russia,0,3,13,16,9/6/2021,33,0,53,86,2,0,0,2,0,5,4,9,0,0,2,2,4,0,1,5
136851,2021,France,Japan,1,4,12,17,5/6/2021,25,0,82,107,4,0,1,5,2,2,1,5,0,0,0,0,3,5,0,8
136851,2021,Serbia,France,0,0,0,0,4/6/2021,0,0,0,0,0,0,0,0,0,0,0,0,0,0,0,0,0,0,0,0
136851,2021,Australia,France,0,2,8,10,30/05/2021,26,0,42,68,4,1,1,6,3,2,2,7,0,0,1,1,4,1,1,6
136851,2021,Germany,France,0,0,8,8,29/05/2021,15,0,2,17,1,0,2,3,1,2,0,3,0,0,0,0,2,1,2,5
136851,2021,France,Bulgaria,0,6,6,12,28/05/2021,3,0,62,65,3,0,0,3,1,0,0,1,0,0,0,0,0,0,0,0
142710,2021,France,Slovenia,1,2,7,10,27/06/2021,0,0,3,3,13,3,8,24,1,5,2,8,0,0,2,2,7,0,1,8
142710,2021,Brazil,France,0,0,1,1,26/06/2021,0,0,0,0,2,1,2,5,0,0,1,1,0,0,0,0,0,1,0,1
142710,2021,France,Poland,0,1,6,7,23/06/2021,0,0,0,0,5,4,3,12,3,0,2,5,0,0,0,0,3,0,0,3
142710,2021,France,Argentina,0,0,0,0,22/06/2021,0,0,0,0,0,0,0,0,0,0,0,0,0,0,0,0,0,0,0,0
142710,2021,France,Iran,1,5,3,9,21/06/2021,0,0,1,1,15,3,8,26,1,2,1,4,0,0,0,0,1,1,1,3
142710,2021,France,Italy,0,3,13,16,17/06/2021,0,0,1,1,21,7,21,49,0,3,1,4,0,0,0,0,3,6,0,9
142710,2021,USA,France,0,2,3,5,16/06/2021,0,0,1,1,10,2,4,16,0,1,1,2,0,0,0,0,2,2,1,5
142710,2021,Netherlands,France,0,0,0,0,15/06/2021,0,0,0,0,0,0,0,0,0,0,0,0,0,0,0,0,0,0,0,0
142710,2021,France,Slovenia,0,5,7,12,10/6/2021,0,0,1,1,8,7,7,22,0,1,3,4,0,0,0,0,2,4,2,8
142710,2021,France,Russia,0,0,0,0,9/6/2021,0,0,0,0,0,0,0,0,0,0,0,0,0,0,0,0,0,0,0,0
142710,2021,Serbia,France,2,3,12,17,4/6/2021,0,0,0,0,22,5,12,39,2,4,0,6,0,0,0,0,5,5,2,12
142710,2021,Brazil,France,0,0,0,0,3/6/2021,0,0,0,0,0,0,0,0,0,0,0,0,0,0,0,0,0,0,0,0
142710,2021,Australia,France,0,0,0,0,30/05/2021,0,0,0,0,0,0,0,0,0,0,0,0,0,0,0,0,0,0,0,0
142710,2021,Germany,France,0,3,11,14,29/05/2021,0,0,0,0,17,5,10,32,3,1,6,10,0,0,0,0,7,4,0,11
142710,2021,France,Bulgaria,0,0,0,0,28/05/2021,0,0,0,0,0,0,0,0,0,0,0,0,0,0,0,0,0,0,0,0
125073,2021,France,Slovenia,0,1,11,12,27/06/2021,0,0,2,2,3,1,4,8,3,1,3,7,0,0,0,0,3,0,0,3
125073,2021,Brazil,France,0,1,6,7,26/06/2021,0,0,0,0,3,2,1,6,1,1,1,3,0,0,0,0,1,2,1,4
125073,2021,France,Poland,0,2,14,16,23/06/2021,0,0,1,1,8,1,7,16,2,7,11,20,0,0,0,0,3,0,0,3
125073,2021,France,Argentina,0,0,0,0,22/06/2021,0,0,0,0,0,0,0,0,0,0,0,0,0,0,0,0,0,0,0,0
125073,2021,France,Iran,1,1,10,12,21/06/2021,0,0,1,1,4,1,1,6,4,2,1,7,0,0,1,1,2,0,0,2
125073,2021,France,Italy,0,0,0,0,17/06/2021,0,0,0,0,0,0,0,0,0,0,0,0,0,0,0,0,0,0,0,0
125073,2021,USA,France,0,0,15,15,16/06/2021,0,0,2,2,4,1,3,8,0,4,4,8,1,0,1,2,2,0,0,2
125073,2021,Netherlands,France,0,3,11,14,15/06/2021,0,0,2,2,11,2,4,17,4,3,5,12,0,0,0,0,3,0,1,4
125073,2021,Canada,France,0,0,0,0,11/6/2021,0,0,0,0,0,0,0,0,0,0,0,0,0,0,0,0,0,0,0,0
125073,2021,France,Slovenia,0,1,13,14,10/6/2021,0,0,2,2,4,1,1,6,2,1,4,7,0,0,1,1,2,0,0,2
125073,2021,France,Russia,0,1,9,10,9/6/2021,0,0,0,0,7,1,2,10,5,3,6,14,0,0,0,0,1,0,0,1
125073,2021,France,Japan,0,0,0,0,5/6/2021,0,0,0,0,0,0,0,0,0,0,0,0,0,0,0,0,0,0,0,0
125073,2021,Serbia,France,0,0,0,0,4/6/2021,0,0,0,0,0,0,0,0,0,0,0,0,0,0,0,0,0,0,0,0
125073,2021,Brazil,France,1,1,13,15,3/6/2021,0,0,2,2,2,1,1,4,4,6,4,14,0,0,0,0,1,2,0,3
125073,2021,Australia,France,0,2,8,10,30/05/2021,0,0,0,0,1,0,3,4,1,4,7,12,0,0,0,0,2,0,1,3
125073,2021,Germany,France,0,0,0,0,29/05/2021,0,0,0,0,0,0,0,0,0,0,0,0,0,0,0,0,0,0,0,0
125073,2021,France,Bulgaria,1,1,6,8,28/05/2021,0,0,1,1,4,2,3,9,2,2,0,4,0,0,1,1,0,0,0,0
142677,2021,France,Slovenia,0,0,0,0,27/06/2021,0,0,0,0,0,0,0,0,0,0,0,0,0,0,0,0,0,0,0,0
142677,2021,Brazil,France,0,0,0,0,26/06/2021,0,0,0,0,0,0,0,0,0,0,0,0,0,0,0,0,0,0,0,0
142677,2021,France,Poland,0,0,0,0,23/06/2021,0,0,0,0,0,0,0,0,0,0,0,0,0,0,0,0,0,0,0,0
142677,2021,France,Argentina,0,4,4,8,22/06/2021,0,0,0,0,6,0,2,8,2,1,2,5,0,0,1,1,2,0,0,2
142677,2021,France,Iran,0,0,0,0,21/06/2021,0,0,0,0,0,0,0,0,0,0,0,0,0,0,0,0,0,0,0,0
142677,2021,France,Italy,2,4,10,16,17/06/2021,0,0,0,0,10,1,3,14,1,0,3,4,0,0,0,0,2,1,0,3
142677,2021,USA,France,0,0,0,0,16/06/2021,0,0,0,0,0,0,0,0,0,0,0,0,0,0,0,0,0,0,0,0
142677,2021,Netherlands,France,0,0,0,0,15/06/2021,0,0,0,0,0,0,0,0,0,0,0,0,0,0,0,0,0,0,0,0
142677,2021,Canada,France,2,2,15,19,11/6/2021,0,0,0,0,4,2,2,8,2,2,2,6,0,0,0,0,2,1,0,3
142677,2021,France,Slovenia,2,3,10,15,10/6/2021,0,0,0,0,5,3,8,16,0,8,5,13,0,0,1,1,2,1,0,3
142677,2021,France,Russia,0,0,0,0,9/6/2021,0,0,0,0,0,0,0,0,0,0,0,0,0,0,0,0,0,0,0,0
142677,2021,France,Japan,1,1,8,10,5/6/2021,0,0,0,0,7,3,1,11,0,5,0,5,1,0,0,1,0,1,0,1
142677,2021,Serbia,France,1,4,6,11,4/6/2021,0,0,0,0,8,3,2,13,3,4,5,12,2,0,0,2,2,0,1,3
142677,2021,Brazil,France,0,0,0,0,3/6/2021,0,0,0,0,0,0,0,0,0,0,0,0,0,0,0,0,0,0,0,0
142677,2021,Australia,France,0,4,7,11,30/05/2021,0,0,0,0,0,2,7,9,2,4,4,10,0,1,1,2,2,3,1,6
142677,2021,Germany,France,0,5,9,14,29/05/2021,0,0,0,0,12,1,0,13,1,5,2,8,0,0,0,0,2,0,0,2
142677,2021,France,Bulgaria,0,0,0,0,28/05/2021,0,0,0,0,0,0,0,0,0,0,0,0,0,0,0,0,0,0,0,0
132948,2021,France,Slovenia,0,1,8,9,27/06/2021,0,0,2,2,6,1,8,15,2,3,1,6,7,1,7,15,8,1,0,9
132948,2021,Brazil,France,0,1,5,6,26/06/2021,0,0,0,0,3,3,6,12,0,2,0,2,6,1,11,18,1,2,0,3
132948,2021,France,Poland,0,1,6,7,23/06/2021,0,0,1,1,10,2,6,18,0,2,1,3,5,0,4,9,2,0,0,2
132948,2021,France,Argentina,0,3,8,11,22/06/2021,0,0,1,1,8,4,7,19,1,3,4,8,4,0,16,20,3,2,1,6
132948,2021,France,Iran,1,1,2,4,21/06/2021,0,0,0,0,2,1,2,5,1,0,0,1,0,0,0,0,1,0,0,1
132948,2021,France,Italy,0,1,9,10,17/06/2021,0,0,1,1,5,1,4,10,1,1,0,2,1,0,10,11,1,2,0,3
132948,2021,USA,France,0,2,6,8,16/06/2021,0,0,2,2,5,6,7,18,2,1,1,4,6,2,5,13,5,0,0,5
132948,2021,Canada,France,1,0,8,9,11/6/2021,0,0,3,3,7,3,4,14,4,1,1,6,3,0,7,10,4,2,0,6
132948,2021,France,Russia,0,3,13,16,9/6/2021,0,0,2,2,13,2,9,24,1,2,2,5,5,2,14,21,5,3,2,10
132948,2021,France,Japan,0,2,11,13,5/6/2021,0,0,0,0,12,2,3,17,1,2,0,3,8,0,10,18,4,1,0,5
132948,2021,Brazil,France,0,0,3,3,3/6/2021,0,0,0,0,3,0,2,5,0,0,1,1,4,0,3,7,0,1,1,2
132948,2021,Australia,France,0,0,1,1,30/05/2021,0,0,0,0,0,0,0,0,0,0,0,0,0,0,0,0,0,1,0,1
132948,2021,Germany,France,5,1,18,24,29/05/2021,0,0,1,1,14,5,9,28,2,4,2,8,17,0,12,29,9,2,1,12
132948,2021,France,Bulgaria,0,0,7,7,28/05/2021,0,0,0,0,4,0,1,5,0,0,0,0,4,0,2,6,0,0,0,0
136867,2021,France,Italy,0,1,11,12,17/06/2021,0,0,1,1,8,4,2,14,0,0,0,0,6,1,7,14,0,1,0,1
136867,2021,USA,France,0,0,2,2,16/06/2021,0,0,1,1,0,0,0,0,0,0,0,0,0,0,0,0,0,0,0,0
136867,2021,Netherlands,France,2,3,6,11,15/06/2021,0,0,3,3,8,2,2,12,0,1,0,1,6,1,7,14,3,2,1,6
136867,2021,France,Slovenia,2,4,12,18,10/6/2021,0,0,1,1,12,3,11,26,0,2,2,4,12,0,14,26,10,6,1,17
136867,2021,France,Russia,0,2,1,3,9/6/2021,0,0,0,0,0,0,0,0,0,0,0,0,0,0,0,0,0,0,0,0
136867,2021,Serbia,France,2,4,9,15,4/6/2021,0,0,1,1,5,4,5,14,0,2,0,2,9,1,13,23,2,2,0,4
136867,2021,Brazil,France,0,1,4,5,3/6/2021,0,0,0,0,0,0,0,0,0,0,0,0,0,0,0,0,2,0,0,2
136867,2021,Australia,France,2,2,4,8,30/05/2021,0,0,0,0,5,1,3,9,0,0,1,1,4,0,3,7,2,0,0,2
136867,2021,Germany,France,0,3,11,14,29/05/2021,0,0,0,0,9,1,11,21,0,1,0,1,7,2,10,19,2,2,1,5
136867,2021,France,Bulgaria,0,1,2,3,28/05/2021,0,0,0,0,0,0,0,0,0,0,0,0,0,0,0,0,0,0,0,0
120735,2021,France,Slovenia,0,0,1,1,27/06/2021,0,0,0,0,0,0,0,0,0,0,0,0,0,0,0,0,0,1,0,1
120735,2021,Brazil,France,0,1,1,2,26/06/2021,0,0,0,0,0,0,0,0,0,0,0,0,0,0,0,0,0,0,0,0
120735,2021,France,Poland,0,1,1,2,23/06/2021,0,0,0,0,0,0,0,0,0,0,0,0,0,0,0,0,0,0,1,1
120735,2021,France,Argentina,1,2,11,14,22/06/2021,0,0,2,2,5,3,7,15,2,0,0,2,5,0,13,18,4,1,0,5
120735,2021,France,Iran,0,0,0,0,21/06/2021,0,0,0,0,0,0,0,0,0,0,0,0,0,0,0,0,0,0,0,0
120735,2021,France,Italy,0,3,3,6,17/06/2021,0,0,0,0,4,2,10,16,0,2,0,2,4,2,24,30,5,6,0,11
120735,2021,USA,France,0,0,0,0,16/06/2021,0,0,0,0,0,0,0,0,0,0,0,0,0,0,0,0,0,0,0,0
120735,2021,Netherlands,France,0,2,11,13,15/06/2021,0,0,2,2,10,4,11,25,1,6,3,10,7,5,25,37,6,2,0,8
120735,2021,Canada,France,0,0,0,0,11/6/2021,0,0,0,0,0,0,0,0,0,0,0,0,0,0,0,0,0,0,0,0
120735,2021,France,Japan,1,1,7,9,5/6/2021,0,0,1,1,4,2,6,12,0,2,0,2,8,1,11,20,1,0,0,1
120735,2021,Serbia,France,1,2,8,11,4/6/2021,0,0,0,0,11,4,11,26,0,2,0,2,4,0,11,15,5,1,0,6
120735,2021,Germany,France,0,1,3,4,29/05/2021,0,0,0,0,1,2,4,7,0,1,0,1,7,0,2,9,2,0,0,2
120735,2021,France,Bulgaria,1,4,4,9,28/05/2021,0,1,0,1,8,0,6,14,1,1,1,3,7,2,4,13,0,0,1,1
152506,2021,France,Slovenia,0,0,0,0,27/06/2021,0,0,0,0,0,0,0,0,0,0,0,0,0,0,0,0,0,0,0,0
152506,2021,Brazil,France,0,0,0,0,26/06/2021,0,0,0,0,0,0,0,0,0,0,0,0,0,0,0,0,0,0,0,0
152506,2021,France,Poland,0,0,0,0,23/06/2021,0,0,0,0,0,0,0,0,0,0,0,0,0,0,0,0,0,0,0,0
152506,2021,France,Argentina,0,0,0,0,22/06/2021,0,0,0,0,0,0,0,0,0,0,0,0,0,0,0,0,0,0,0,0
152506,2021,France,Iran,0,0,0,0,21/06/2021,0,0,0,0,0,0,0,0,0,0,0,0,0,0,0,0,0,0,0,0
152506,2021,France,Italy,0,0,0,0,17/06/2021,0,0,4,4,0,0,0,0,0,0,0,0,10,1,8,19,6,6,0,12
152506,2021,USA,France,0,0,0,0,16/06/2021,0,0,0,0,0,0,0,0,0,0,0,0,0,0,0,0,0,0,0,0
152506,2021,Netherlands,France,0,0,0,0,15/06/2021,0,0,0,0,0,0,0,0,0,0,0,0,0,0,0,0,0,0,0,0
152506,2021,Canada,France,0,0,0,0,11/6/2021,0,0,0,0,0,0,0,0,0,0,0,0,0,0,0,0,0,0,0,0
152506,2021,France,Slovenia,0,0,0,0,10/6/2021,0,0,0,0,0,0,0,0,0,0,0,0,0,0,0,0,0,0,0,0
152506,2021,France,Russia,0,0,0,0,9/6/2021,0,0,0,0,0,0,0,0,0,0,0,0,0,0,0,0,0,0,0,0
152506,2021,France,Japan,0,0,0,0,5/6/2021,0,0,0,0,0,0,0,0,0,0,0,0,0,0,0,0,1,0,0,1
152506,2021,Serbia,France,0,0,0,0,4/6/2021,0,0,0,0,0,0,0,0,0,0,0,0,0,0,0,0,0,0,0,0
152506,2021,Brazil,France,0,0,0,0,3/6/2021,0,0,0,0,0,0,0,0,0,0,0,0,0,0,0,0,0,0,0,0
152506,2021,Australia,France,0,0,0,0,30/05/2021,0,0,3,3,0,0,0,0,0,0,0,0,4,1,7,12,6,2,1,9
152506,2021,Germany,France,0,0,0,0,29/05/2021,0,0,0,0,0,0,0,0,0,0,0,0,2,3,4,9,3,4,0,7
152506,2021,France,Bulgaria,0,0,0,0,28/05/2021,0,0,5,5,0,0,0,0,0,0,0,0,7,0,6,13,9,0,1,10
163309,2021,Netherlands,France,4,6,22,32,15/06/2021,0,0,2,2,23,3,14,40,3,7,7,17,0,0,0,0,8,5,2,15
163309,2021,Canada,France,0,1,1,2,11/6/2021,0,0,0,0,4,5,4,13,1,1,2,4,0,0,0,0,0,2,0,2
163309,2021,France,Slovenia,0,0,4,4,10/6/2021,0,0,0,0,2,2,2,6,0,0,2,2,0,0,0,0,1,1,2,4
163309,2021,France,Japan,0,0,0,0,5/6/2021,0,0,0,0,0,0,0,0,0,0,0,0,0,0,0,0,0,0,0,0
163309,2021,Serbia,France,0,0,0,0,4/6/2021,0,0,0,0,0,0,0,0,0,0,0,0,0,0,0,0,0,0,0,0
152514,2021,France,Japan,0,0,0,0,5/6/2021,0,0,0,0,0,0,0,0,0,0,0,0,0,0,0,0,0,0,0,0
152514,2021,Brazil,France,0,0,0,0,3/6/2021,0,0,0,0,0,0,0,0,0,0,0,0,0,0,0,0,0,0,0,0
152514,2021,Australia,France,0,1,4,5,30/05/2021,11,0,16,27,1,0,0,1,1,1,1,3,0,0,0,0,0,1,0,1
181197,2021,France,Slovenia,0,0,0,0,27/06/2021,0,0,0,0,0,0,0,0,0,0,0,0,0,0,0,0,0,0,0,0
181197,2021,Brazil,France,0,0,0,0,26/06/2021,0,0,0,0,0,0,0,0,0,0,0,0,0,0,0,0,0,0,0,0
181197,2021,France,Poland,0,0,0,0,23/06/2021,0,0,0,0,0,0,0,0,0,0,0,0,0,0,0,0,0,0,0,0
181197,2021,France,Argentina,0,0,0,0,22/06/2021,0,0,0,0,0,0,0,0,0,0,0,0,0,0,0,0,0,0,0,0
181197,2021,France,Iran,0,0,0,0,21/06/2021,0,0,0,0,0,0,0,0,0,0,0,0,0,0,0,0,0,0,0,0
181197,2021,France,Italy,0,0,4,4,17/06/2021,0,0,0,0,5,0,2,7,2,3,1,6,0,0,0,0,1,0,0,1
181197,2021,Netherlands,France,0,0,0,0,15/06/2021,0,0,0,0,0,0,0,0,0,0,0,0,0,0,0,0,0,0,0,0
181197,2021,Canada,France,0,0,0,0,11/6/2021,0,0,0,0,0,0,0,0,0,0,0,0,0,0,0,0,0,0,0,0
181197,2021,France,Slovenia,0,0,0,0,10/6/2021,0,0,0,0,0,0,0,0,0,0,0,0,0,0,0,0,0,0,0,0
181197,2021,France,Russia,0,0,0,0,9/6/2021,0,0,0,0,0,0,0,0,0,0,0,0,0,0,0,0,0,0,0,0
181197,2021,France,Japan,0,0,0,0,5/6/2021,0,0,0,0,0,0,0,0,0,0,0,0,0,0,0,0,0,0,0,0
181197,2021,Serbia,France,0,0,0,0,4/6/2021,0,0,0,0,0,0,0,0,0,0,0,0,0,0,0,0,0,0,0,0
181197,2021,Brazil,France,0,0,0,0,3/6/2021,0,0,0,0,0,0,0,0,0,0,0,0,0,0,0,0,0,0,0,0
181197,2021,Australia,France,1,2,5,8,30/05/2021,0,0,0,0,3,2,2,7,0,3,1,4,0,0,1,1,1,0,0,1
181197,2021,Germany,France,0,0,0,0,29/05/2021,0,0,0,0,0,0,0,0,0,0,0,0,0,0,0,0,0,0,0,0
181197,2021,France,Bulgaria,0,0,0,0,28/05/2021,0,0,0,0,0,0,0,0,0,0,0,0,0,0,0,0,0,0,0,0
119779,2021,Italy,Germany,0,0,0,0,23/06/2021,0,0,0,0,0,0,0,0,0,0,0,0,0,0,0,0,0,0,0,0
119779,2021,Brazil,Germany,0,2,8,10,22/06/2021,0,0,3,3,3,3,13,19,0,1,1,2,3,2,11,16,1,2,0,3
119779,2021,Germany,Russia,0,0,0,0,21/06/2021,0,0,1,1,0,0,1,1,0,0,0,0,0,0,0,0,0,0,0,0
119779,2021,Germany,Poland,0,3,7,10,17/06/2021,0,0,3,3,11,5,11,27,0,3,1,4,4,0,12,16,4,1,0,5
119779,2021,Canada,Germany,0,0,0,0,16/06/2021,0,0,0,0,1,0,0,1,0,1,0,1,0,0,0,0,0,0,0,0
119779,2021,Japan,Germany,0,0,0,0,15/06/2021,0,0,0,0,0,0,0,0,0,0,0,0,0,0,0,0,0,0,0,0
119779,2021,Iran,Germany,0,0,0,0,11/6/2021,0,0,0,0,0,0,0,0,0,0,0,0,0,0,0,0,0,0,0,0
119779,2021,Germany,USA,0,1,3,4,10/6/2021,0,1,2,3,3,3,6,12,0,0,0,0,1,0,12,13,2,0,0,2
119779,2021,Serbia,Germany,0,2,4,6,9/6/2021,0,0,1,1,8,3,9,20,0,2,2,4,2,1,2,5,4,2,1,7
119779,2021,Slovenia,Germany,1,4,5,10,5/6/2021,0,0,1,1,18,2,16,36,1,0,2,3,7,2,8,17,7,0,0,7
119779,2021,Netherlands,Germany,2,2,1,5,4/6/2021,0,0,2,2,2,0,1,3,0,1,0,1,2,1,5,8,0,0,0,0
119779,2021,Germany,Argentina,0,0,0,0,3/6/2021,0,0,0,0,0,0,0,0,0,0,0,0,0,0,0,0,0,0,0,0
119779,2021,Germany,Bulgaria,0,2,6,8,30/05/2021,0,0,0,0,6,1,4,11,0,0,2,2,0,1,3,4,2,1,0,3
119779,2021,Germany,France,0,0,0,0,29/05/2021,0,0,0,0,0,0,0,0,0,0,0,0,0,0,0,0,0,0,0,0
119779,2021,Germany,Australia,0,4,9,13,28/05/2021,0,0,1,1,14,1,5,20,1,4,1,6,2,0,4,6,2,0,0,2
136441,2021,Italy,Germany,3,3,15,21,23/06/2021,0,1,8,9,10,5,16,31,1,5,0,6,15,2,26,43,10,1,1,12
136441,2021,Brazil,Germany,1,4,5,10,22/06/2021,0,0,5,5,12,0,10,22,0,4,1,5,10,1,10,21,1,5,0,6
136441,2021,Germany,Russia,0,2,3,5,21/06/2021,0,0,0,0,0,0,0,0,0,0,0,0,0,0,0,0,0,0,0,0
136441,2021,Germany,Poland,0,0,0,0,17/06/2021,0,0,0,0,0,0,0,0,0,0,0,0,0,0,0,0,0,0,0,0
136441,2021,Canada,Germany,0,3,7,10,16/06/2021,0,0,1,1,4,4,8,16,0,5,0,5,13,1,6,20,6,6,0,12
136441,2021,Japan,Germany,0,2,3,5,15/06/2021,0,0,0,0,7,1,8,16,0,1,1,2,6,2,10,18,2,5,0,7
136441,2021,Iran,Germany,1,3,3,7,11/6/2021,0,0,1,1,1,0,3,4,1,2,0,3,2,1,2,5,2,2,0,4
136441,2021,Germany,USA,0,3,8,11,10/6/2021,0,0,4,4,3,3,7,13,0,2,1,3,6,1,5,12,4,1,1,6
136441,2021,Serbia,Germany,4,3,10,17,9/6/2021,0,1,7,8,9,5,7,21,0,0,2,2,10,3,23,36,8,3,3,14
136441,2021,Slovenia,Germany,2,3,8,13,5/6/2021,0,1,5,6,9,3,5,17,0,1,1,2,3,1,11,15,8,4,2,14
136441,2021,Netherlands,Germany,1,5,16,22,4/6/2021,0,0,2,2,10,2,7,19,0,2,2,4,16,3,13,32,7,4,1,12
136441,2021,Germany,Argentina,1,5,13,19,3/6/2021,0,0,8,8,6,2,10,18,1,6,6,13,15,1,15,31,5,3,1,9
136441,2021,Germany,Bulgaria,3,2,10,15,30/05/2021,0,0,0,0,5,4,8,17,0,2,2,4,4,2,13,19,8,0,0,8
136441,2021,Germany,France,1,1,17,19,29/05/2021,0,0,0,0,9,1,5,15,0,3,0,3,13,1,16,30,7,0,0,7
136441,2021,Germany,Australia,1,1,2,4,28/05/2021,0,0,0,0,0,0,0,0,0,0,0,0,0,0,0,0,0,0,0,0
139386,2021,Italy,Germany,1,3,9,13,23/06/2021,0,0,2,2,6,6,9,21,2,0,2,4,4,1,6,11,6,3,0,9
139386,2021,Brazil,Germany,0,0,1,1,22/06/2021,0,0,1,1,0,0,0,0,0,0,0,0,1,0,1,2,0,0,0,0
139386,2021,Germany,Russia,0,3,11,14,21/06/2021,0,0,5,5,12,4,13,29,0,4,2,6,8,3,13,24,3,1,1,5
139386,2021,Germany,Poland,0,0,0,0,17/06/2021,0,0,0,0,2,0,0,2,0,0,0,0,0,0,1,1,0,1,0,1
139386,2021,Canada,Germany,0,0,0,0,16/06/2021,0,0,0,0,0,0,0,0,0,0,0,0,0,0,0,0,0,0,0,0
139386,2021,Japan,Germany,2,2,8,12,15/06/2021,0,0,1,1,8,1,8,17,0,1,1,2,3,0,7,10,2,0,0,2
139386,2021,Iran,Germany,0,4,17,21,11/6/2021,0,0,0,0,7,1,9,17,0,2,0,2,5,0,8,13,2,2,2,6
139386,2021,Germany,USA,0,1,0,1,10/6/2021,0,0,0,0,0,0,0,0,0,0,0,0,0,1,0,1,1,0,0,1
139386,2021,Serbia,Germany,0,2,6,8,9/6/2021,0,0,0,0,4,1,5,10,0,1,0,1,0,1,2,3,4,1,1,6
139386,2021,Slovenia,Germany,0,0,2,2,5/6/2021,1,0,0,1,0,0,0,0,0,0,0,0,0,0,2,2,1,0,0,1
139386,2021,Netherlands,Germany,1,3,13,17,4/6/2021,0,0,3,3,9,3,9,21,0,3,4,7,3,2,7,12,5,0,0,5
139386,2021,Germany,Argentina,0,2,17,19,3/6/2021,0,1,3,4,9,3,8,20,0,2,0,2,11,1,15,27,3,1,1,5
139386,2021,Germany,Bulgaria,0,3,5,8,30/05/2021,0,0,0,0,6,3,7,16,1,1,0,2,4,0,14,18,3,0,0,3
139386,2021,Germany,France,0,6,8,14,29/05/2021,0,0,0,0,15,7,23,45,4,1,1,6,12,0,16,28,7,3,1,11
139386,2021,Germany,Australia,0,1,0,1,28/05/2021,0,0,1,1,0,0,0,0,0,0,0,0,0,0,1,1,0,0,0,0
119775,2021,Italy,Germany,0,0,0,0,23/06/2021,0,0,0,0,0,0,0,0,0,0,0,0,0,0,0,0,0,0,0,0
119775,2021,Brazil,Germany,0,0,0,0,22/06/2021,0,0,0,0,0,0,0,0,0,0,0,0,0,0,0,0,0,0,0,0
119775,2021,Germany,Russia,0,4,12,16,21/06/2021,0,0,5,5,9,1,7,17,1,3,1,5,8,2,19,29,6,1,3,10
119775,2021,Germany,Poland,0,0,0,0,17/06/2021,0,0,0,0,0,0,0,0,0,0,0,0,0,0,0,0,0,0,0,0
119775,2021,Canada,Germany,0,2,10,12,16/06/2021,0,0,3,3,6,0,7,13,1,2,0,3,6,0,15,21,7,2,0,9
119775,2021,Japan,Germany,0,1,5,6,15/06/2021,0,0,3,3,3,3,3,9,0,1,0,1,6,0,10,16,1,1,0,2
119775,2021,Iran,Germany,0,3,13,16,11/6/2021,0,0,3,3,12,1,10,23,1,0,4,5,3,0,17,20,6,3,0,9
119775,2021,Germany,USA,0,0,0,0,10/6/2021,0,0,0,0,0,0,0,0,0,0,0,0,0,0,0,0,0,0,0,0
119775,2021,Netherlands,Germany,0,0,0,0,4/6/2021,0,0,0,0,0,0,0,0,0,0,0,0,0,0,0,0,0,0,0,0
119775,2021,Germany,Argentina,0,0,0,0,3/6/2021,0,0,0,0,0,0,0,0,0,0,0,0,0,0,0,0,0,0,0,0
119775,2021,Germany,Bulgaria,1,4,14,19,30/05/2021,0,0,0,0,10,6,10,26,1,0,2,3,2,4,4,10,7,1,1,9
119775,2021,Germany,France,0,0,0,0,29/05/2021,0,0,0,0,0,0,0,0,0,0,0,0,0,0,0,0,0,0,0,0
119775,2021,Germany,Australia,1,3,7,11,28/05/2021,0,0,0,0,7,1,7,15,1,1,0,2,4,0,10,14,7,0,0,7
156599,2021,Italy,Germany,0,4,5,9,23/06/2021,0,0,2,2,1,2,5,8,0,1,2,3,0,1,8,9,2,0,1,3
156599,2021,Brazil,Germany,0,0,1,1,22/06/2021,0,0,0,0,0,0,0,0,0,0,0,0,0,0,0,0,0,0,0,0
156599,2021,Germany,Russia,0,1,1,2,21/06/2021,0,0,0,0,0,0,0,0,0,0,0,0,0,0,0,0,0,0,0,0
156599,2021,Germany,Poland,1,3,5,9,17/06/2021,0,0,3,3,8,2,5,15,0,0,3,3,4,0,19,23,6,3,0,9
156599,2021,Canada,Germany,0,2,0,2,16/06/2021,0,0,0,0,0,0,0,0,0,0,0,0,0,0,0,0,0,0,0,0
156599,2021,Japan,Germany,0,1,1,2,15/06/2021,0,0,0,0,0,0,0,0,0,0,0,0,0,0,0,0,0,0,0,0
156599,2021,Slovenia,Germany,0,3,5,8,5/6/2021,0,0,6,6,5,2,6,13,0,3,1,4,1,2,6,9,4,2,0,6
156599,2021,Netherlands,Germany,0,2,3,5,4/6/2021,0,0,0,0,0,0,0,0,0,0,0,0,0,0,0,0,1,0,0,1
156599,2021,Germany,Argentina,0,1,4,5,3/6/2021,0,0,0,0,3,1,1,5,1,1,0,2,0,0,2,2,0,0,1,1
156599,2021,Germany,Bulgaria,2,1,5,8,30/05/2021,1,0,0,1,0,0,0,0,0,0,0,0,0,0,0,0,0,0,0,0
156599,2021,Germany,France,2,2,6,10,29/05/2021,0,0,0,0,0,0,0,0,0,0,0,0,0,0,0,0,0,0,0,0
156599,2021,Germany,Australia,0,0,0,0,28/05/2021,0,0,0,0,0,0,0,0,0,0,0,0,0,0,0,0,0,0,0,0
116015,2021,Italy,Germany,0,1,6,7,23/06/2021,0,0,0,0,4,1,2,7,0,5,0,5,0,0,1,1,1,0,1,2
116015,2021,Brazil,Germany,0,0,0,0,22/06/2021,0,0,0,0,0,0,0,0,0,0,0,0,0,0,0,0,0,0,0,0
116015,2021,Germany,Russia,0,0,0,0,21/06/2021,0,0,0,0,0,0,0,0,0,0,0,0,0,0,0,0,0,0,0,0
116015,2021,Germany,Poland,0,1,10,11,17/06/2021,0,0,0,0,3,2,1,6,1,6,2,9,0,0,1,1,1,1,0,2
116015,2021,Canada,Germany,0,0,0,0,16/06/2021,0,0,0,0,0,0,0,0,0,0,0,0,0,0,0,0,0,0,0,0
116015,2021,Japan,Germany,0,0,0,0,15/06/2021,0,0,0,0,0,0,0,0,0,0,0,0,0,0,0,0,0,0,0,0
116015,2021,Serbia,Germany,0,0,0,0,9/6/2021,0,0,0,0,0,0,0,0,0,0,0,0,0,0,0,0,0,0,0,0
116015,2021,Slovenia,Germany,0,0,0,0,5/6/2021,0,0,0,0,0,0,0,0,0,0,0,0,0,0,0,0,0,0,0,0
116015,2021,Netherlands,Germany,0,0,2,2,4/6/2021,0,0,0,0,1,0,2,3,0,1,0,1,0,0,0,0,1,1,0,2
116015,2021,Germany,Argentina,0,0,8,8,3/6/2021,0,0,0,0,4,0,2,6,1,7,4,12,0,0,0,0,0,0,1,1
116015,2021,Germany,Bulgaria,0,0,6,6,30/05/2021,0,0,0,0,5,1,2,8,1,3,3,7,0,0,0,0,1,0,1,2
116015,2021,Germany,France,0,0,6,6,29/05/2021,0,0,0,0,8,0,4,12,1,5,0,6,0,0,1,1,0,1,0,1
116015,2021,Germany,Australia,0,0,0,0,28/05/2021,0,0,0,0,0,0,0,0,0,0,0,0,0,0,0,0,0,0,0,0
152470,2021,Italy,Germany,0,0,0,0,23/06/2021,0,0,7,7,0,0,0,0,0,0,0,0,8,1,13,22,11,6,3,20
152470,2021,Brazil,Germany,0,0,0,0,22/06/2021,0,0,4,4,0,0,0,0,0,0,0,0,5,0,10,15,8,2,1,11
152470,2021,Germany,Russia,0,0,0,0,21/06/2021,0,0,4,4,0,0,0,0,0,0,0,0,7,2,11,20,8,2,1,11
152470,2021,Germany,Poland,0,0,0,0,17/06/2021,0,0,7,7,0,0,0,0,0,0,0,0,5,1,7,13,6,3,2,11
152470,2021,Canada,Germany,0,0,0,0,16/06/2021,0,0,5,5,0,0,0,0,0,0,0,0,9,0,11,20,7,3,2,12
152470,2021,Japan,Germany,0,0,0,0,15/06/2021,0,0,4,4,0,0,0,0,0,0,0,0,4,2,11,17,2,6,1,9
152470,2021,Iran,Germany,0,0,0,0,11/6/2021,0,0,3,3,0,0,0,0,0,0,0,0,12,2,17,31,13,8,1,22
152470,2021,Germany,USA,0,0,0,0,10/6/2021,0,0,1,1,0,0,0,0,0,0,0,0,4,2,11,17,7,2,0,9
152470,2021,Serbia,Germany,0,0,0,0,9/6/2021,0,1,5,6,0,0,0,0,0,0,0,0,4,2,17,23,14,2,2,18
152470,2021,Slovenia,Germany,0,0,0,0,5/6/2021,0,0,5,5,0,0,0,0,0,0,0,0,7,0,13,20,15,6,0,21
152470,2021,Netherlands,Germany,0,0,0,0,4/6/2021,0,0,2,2,0,0,0,0,0,0,0,0,17,3,16,36,12,6,4,22
152470,2021,Germany,Argentina,0,0,0,0,3/6/2021,0,0,5,5,0,0,0,0,0,0,0,0,6,0,13,19,8,5,2,15
152470,2021,Germany,Bulgaria,0,0,0,0,30/05/2021,0,0,7,7,0,0,0,0,0,0,0,0,15,2,16,33,14,6,2,22
152470,2021,Germany,France,0,0,0,0,29/05/2021,0,0,0,0,0,0,0,0,0,0,0,0,10,3,14,27,7,1,1,9
152470,2021,Germany,Australia,0,0,0,0,28/05/2021,1,0,2,3,0,0,0,0,0,0,0,0,8,0,10,18,9,0,1,10
116575,2021,,,-,-,-,-,-,-,-,-,-,-,-,-,-,-,-,-,-,-,-,-,-,-,-,-,-
136253,2021,Italy,Germany,1,1,17,19,23/06/2021,0,0,4,4,12,6,15,33,2,1,2,5,0,0,1,1,8,2,0,10
136253,2021,Brazil,Germany,0,0,0,0,22/06/2021,0,0,0,0,1,0,1,2,0,0,0,0,0,0,0,0,0,0,0,0
136253,2021,Germany,Russia,0,1,11,12,21/06/2021,0,0,2,2,9,5,13,27,1,3,2,6,1,0,0,1,7,2,0,9
136253,2021,Germany,Poland,1,2,10,13,17/06/2021,0,0,3,3,7,4,12,23,0,3,3,6,0,1,0,1,3,1,0,4
136253,2021,Canada,Germany,0,0,0,0,16/06/2021,0,0,0,0,2,0,3,5,0,0,1,1,0,0,0,0,0,0,0,0
136253,2021,Japan,Germany,0,0,0,0,15/06/2021,0,0,1,1,0,0,0,0,0,0,0,0,0,0,0,0,0,0,0,0
136253,2021,Iran,Germany,0,0,0,0,11/6/2021,0,0,0,0,0,0,0,0,0,0,0,0,0,0,0,0,0,0,0,0
136253,2021,Germany,USA,0,0,0,0,10/6/2021,0,0,0,0,0,0,0,0,0,0,0,0,0,0,0,0,0,0,0,0
136253,2021,Serbia,Germany,0,0,0,0,9/6/2021,0,0,0,0,0,0,0,0,0,0,0,0,0,0,0,0,0,0,0,0
136253,2021,Netherlands,Germany,0,0,4,4,4/6/2021,0,0,1,1,2,1,2,5,0,0,0,0,0,0,0,0,0,1,1,2
136253,2021,Germany,Argentina,0,2,4,6,3/6/2021,0,0,0,0,6,1,5,12,2,1,1,4,0,0,0,0,0,0,0,0
136253,2021,Germany,Bulgaria,1,3,9,13,30/05/2021,0,0,0,0,10,4,9,23,1,4,1,6,0,0,0,0,4,1,1,6
136253,2021,Germany,France,0,4,9,13,29/05/2021,0,0,0,0,14,4,8,26,1,5,2,8,0,0,0,0,6,1,0,7
136253,2021,Germany,Australia,0,0,0,0,28/05/2021,0,0,0,0,0,0,0,0,1,0,0,1,0,0,0,0,0,0,0,0
156596,2021,Italy,Germany,0,1,4,5,23/06/2021,0,0,0,0,2,0,2,4,1,1,3,5,0,0,0,0,2,0,0,2
156596,2021,Germany,Poland,0,1,11,12,17/06/2021,0,1,0,1,3,0,0,3,0,2,1,3,0,0,1,1,1,1,0,2
156596,2021,Iran,Germany,0,0,2,2,11/6/2021,0,0,0,0,1,0,2,3,0,0,1,1,0,0,0,0,0,0,0,0
156596,2021,Germany,USA,0,0,0,0,10/6/2021,0,0,0,0,0,0,0,0,0,0,0,0,0,0,0,0,0,0,0,0
156596,2021,Serbia,Germany,0,0,3,3,9/6/2021,0,0,0,0,0,0,0,0,0,3,0,3,0,0,0,0,0,0,0,0
156596,2021,Slovenia,Germany,0,0,0,0,5/6/2021,0,0,0,0,0,0,0,0,0,0,0,0,0,0,0,0,0,0,0,0
156596,2021,Netherlands,Germany,0,1,9,10,4/6/2021,0,0,0,0,5,1,0,6,3,5,3,11,0,0,0,0,0,1,0,1
156596,2021,Germany,Bulgaria,0,1,0,1,30/05/2021,0,0,0,0,0,0,0,0,0,0,0,0,0,0,0,0,0,0,0,0
156596,2021,Germany,France,0,0,0,0,29/05/2021,0,0,0,0,0,0,0,0,0,0,0,0,0,0,0,0,0,0,0,0
156596,2021,Germany,Australia,0,0,0,0,28/05/2021,0,0,0,0,0,0,0,0,0,0,0,0,0,0,0,0,0,0,0,0
162788,2021,Italy,Germany,0,0,0,0,23/06/2021,0,0,0,0,0,0,0,0,0,0,0,0,0,0,0,0,0,0,0,0
162788,2021,Brazil,Germany,1,2,2,5,22/06/2021,1,0,5,6,0,0,0,0,0,0,0,0,0,0,0,0,0,0,0,0
162788,2021,Germany,Russia,0,0,1,1,21/06/2021,0,0,7,7,0,0,0,0,0,0,0,0,0,0,0,0,1,0,0,1
162788,2021,Germany,Poland,0,0,0,0,17/06/2021,1,0,4,5,0,0,0,0,0,0,0,0,0,0,0,0,0,1,1,2
162788,2021,Canada,Germany,0,0,0,0,16/06/2021,3,1,5,9,0,0,0,0,0,0,0,0,0,0,1,1,0,0,0,0
162788,2021,Japan,Germany,0,0,0,0,15/06/2021,0,0,1,1,0,0,0,0,0,0,0,0,0,0,0,0,0,0,0,0
162788,2021,Iran,Germany,1,1,1,3,11/6/2021,0,0,0,0,0,0,0,0,0,0,0,0,0,0,0,0,0,0,0,0
162788,2021,Germany,USA,0,1,0,1,10/6/2021,1,0,4,5,0,0,0,0,0,0,0,0,0,0,0,0,0,1,0,1
162788,2021,Serbia,Germany,0,0,1,1,9/6/2021,0,0,0,0,0,0,0,0,0,0,0,0,0,0,0,0,0,0,0,0
162788,2021,Slovenia,Germany,0,0,0,0,5/6/2021,0,0,0,0,0,0,0,0,0,0,0,0,0,0,0,0,0,0,0,0
162788,2021,Netherlands,Germany,0,0,0,0,4/6/2021,0,0,1,1,0,0,0,0,0,0,0,0,0,0,0,0,0,0,0,0
162788,2021,Germany,Argentina,0,0,3,3,3/6/2021,0,0,0,0,0,0,0,0,0,0,0,0,0,0,0,0,1,0,0,1
162788,2021,Germany,Bulgaria,0,1,0,1,30/05/2021,0,0,0,0,0,0,0,0,0,0,0,0,0,0,0,0,0,0,0,0
162788,2021,Germany,France,0,1,1,2,29/05/2021,0,0,0,0,0,0,0,0,0,0,0,0,0,0,0,0,0,0,0,0
162788,2021,Germany,Australia,0,0,0,0,28/05/2021,0,0,0,0,0,0,0,0,0,0,0,0,0,0,0,0,0,0,0,0
136442,2021,Italy,Germany,0,4,10,14,23/06/2021,33,0,74,107,2,0,0,2,0,5,3,8,0,0,0,0,9,2,1,12
136442,2021,Brazil,Germany,0,2,7,9,22/06/2021,10,0,50,60,0,0,0,0,0,0,1,1,0,0,2,2,4,1,0,5
136442,2021,Germany,Russia,0,3,8,11,21/06/2021,20,1,51,72,0,0,2,2,0,4,2,6,0,0,0,0,5,5,1,11
136442,2021,Germany,Poland,0,2,6,8,17/06/2021,14,1,41,56,0,0,0,0,1,0,2,3,0,0,1,1,5,2,1,8
136442,2021,Canada,Germany,0,1,9,10,16/06/2021,15,2,49,66,1,0,1,2,0,0,0,0,0,0,0,0,0,3,0,3
136442,2021,Japan,Germany,0,1,8,9,15/06/2021,5,0,65,70,1,0,0,1,0,1,0,1,0,0,1,1,3,2,0,5
136442,2021,Iran,Germany,1,2,14,17,11/6/2021,20,0,58,78,1,1,0,2,2,4,0,6,0,1,1,2,1,3,0,4
136442,2021,Germany,USA,0,1,7,8,10/6/2021,21,0,39,60,0,0,1,1,0,1,4,5,0,0,0,0,4,1,0,5
136442,2021,Serbia,Germany,1,2,8,11,9/6/2021,33,0,49,82,0,1,1,2,0,1,1,2,0,0,0,0,1,2,2,5
136442,2021,Slovenia,Germany,0,3,10,13,5/6/2021,24,1,70,95,1,0,2,3,1,4,2,7,0,0,0,0,12,2,1,15
136442,2021,Netherlands,Germany,0,2,13,15,4/6/2021,11,2,85,98,1,0,1,2,0,2,2,4,0,0,0,0,6,3,0,9
136442,2021,Germany,Argentina,1,2,13,16,3/6/2021,19,1,75,95,0,0,1,1,2,2,2,6,0,0,0,0,9,5,1,15
136442,2021,Germany,Bulgaria,2,0,14,16,30/05/2021,21,0,90,111,0,0,0,0,0,0,5,5,0,0,0,0,7,5,1,13
136442,2021,Germany,France,1,2,9,12,29/05/2021,45,2,0,47,1,0,0,1,2,1,3,6,0,0,1,1,3,3,2,8
136442,2021,Germany,Australia,1,1,10,12,28/05/2021,20,0,46,66,0,0,0,0,0,2,1,3,0,0,1,1,4,0,0,4
162790,2021,Brazil,Germany,1,1,9,11,22/06/2021,0,0,0,0,2,0,1,3,3,7,0,10,1,0,0,1,1,1,0,2
162790,2021,Germany,Russia,0,0,8,8,21/06/2021,0,0,0,0,2,3,2,7,4,2,0,6,0,1,0,1,1,0,0,1
162790,2021,Canada,Germany,0,1,5,6,16/06/2021,0,0,0,0,5,1,4,10,1,3,1,5,0,0,0,0,0,1,0,1
162790,2021,Japan,Germany,0,0,8,8,15/06/2021,0,0,0,0,3,1,3,7,1,1,0,2,0,0,0,0,2,2,0,4
162790,2021,Iran,Germany,1,1,12,14,11/6/2021,0,0,0,0,9,0,1,10,3,6,0,9,0,0,0,0,0,0,0,0
162790,2021,Germany,USA,0,0,7,7,10/6/2021,0,0,0,0,5,1,1,7,1,5,3,9,0,0,1,1,1,1,0,2
162790,2021,Serbia,Germany,0,2,11,13,9/6/2021,0,0,0,0,2,2,1,5,1,2,3,6,0,0,0,0,0,0,0,0
162790,2021,Slovenia,Germany,1,1,16,18,5/6/2021,0,0,1,1,1,0,4,5,1,4,2,7,0,0,2,2,3,2,0,5
162790,2021,Netherlands,Germany,0,2,8,10,4/6/2021,0,0,1,1,8,3,2,13,1,7,2,10,0,0,0,0,1,0,0,1
162790,2021,Germany,Argentina,1,0,5,6,3/6/2021,0,0,0,0,2,0,1,3,0,1,0,1,0,0,0,0,0,0,1,1
162790,2021,Germany,Bulgaria,0,3,8,11,30/05/2021,0,0,0,0,6,1,2,9,2,7,2,11,0,1,0,1,1,0,0,1
162790,2021,Germany,France,0,0,6,6,29/05/2021,0,0,0,0,1,1,0,2,1,4,1,6,1,1,1,3,1,1,0,2
162790,2021,Germany,Australia,0,1,9,10,28/05/2021,0,0,0,0,4,1,4,9,1,4,0,5,0,0,0,0,0,0,1,1
174660,2021,Italy,Germany,0,0,0,0,23/06/2021,0,0,0,0,0,0,0,0,0,0,0,0,0,0,0,0,0,0,0,0
174660,2021,Brazil,Germany,0,0,0,0,22/06/2021,0,0,0,0,0,0,0,0,0,0,0,0,0,0,0,0,0,0,0,0
174660,2021,Germany,Russia,0,0,0,0,21/06/2021,0,0,0,0,0,0,0,0,0,0,0,0,0,0,0,0,0,0,0,0
174660,2021,Germany,Poland,0,0,0,0,17/06/2021,0,0,0,0,0,0,0,0,0,0,0,0,0,0,0,0,0,0,0,0
174660,2021,Canada,Germany,0,0,0,0,16/06/2021,0,0,0,0,0,0,0,0,0,0,0,0,0,0,0,0,0,0,0,0
174660,2021,Japan,Germany,0,0,0,0,15/06/2021,0,0,0,0,0,0,0,0,0,0,0,0,0,0,0,0,0,0,0,0
174660,2021,Iran,Germany,0,0,0,0,11/6/2021,0,0,0,0,0,0,0,0,0,0,0,0,0,0,0,0,0,0,0,0
174660,2021,Germany,USA,2,2,3,7,10/6/2021,0,0,0,0,4,3,3,10,0,2,1,3,0,2,10,12,2,0,0,2
174660,2021,Serbia,Germany,0,1,0,1,9/6/2021,0,0,0,0,1,0,1,2,0,0,0,0,0,0,1,1,0,0,0,0
174660,2021,Slovenia,Germany,0,0,0,0,5/6/2021,0,0,0,0,0,0,0,0,0,0,0,0,0,0,0,0,0,0,0,0
174660,2021,Netherlands,Germany,0,0,0,0,4/6/2021,0,0,0,0,0,0,0,0,0,0,0,0,0,0,0,0,0,0,0,0
174660,2021,Germany,Argentina,0,0,0,0,3/6/2021,0,0,0,0,0,0,0,0,0,0,0,0,0,0,0,0,0,0,0,0
174660,2021,Germany,Bulgaria,0,0,0,0,30/05/2021,0,0,0,0,0,0,0,0,0,0,0,0,0,0,0,0,0,0,0,0
162082,2021,Italy,Germany,0,1,1,2,23/06/2021,0,0,0,0,2,3,4,9,0,0,0,0,0,0,0,0,0,1,1,2
162082,2021,Brazil,Germany,0,3,5,8,22/06/2021,0,0,0,0,10,6,8,24,2,2,0,4,0,0,0,0,1,1,1,3
162082,2021,Germany,Russia,0,0,0,0,21/06/2021,0,0,0,0,0,1,1,2,0,0,0,0,0,0,0,0,1,0,0,1
162082,2021,Canada,Germany,3,2,8,13,16/06/2021,0,0,0,0,12,5,7,24,1,3,2,6,0,0,0,0,1,1,0,2
162082,2021,Japan,Germany,0,6,5,11,15/06/2021,0,0,1,1,13,1,10,24,2,3,1,6,1,0,0,1,0,1,0,1
162082,2021,Iran,Germany,2,8,9,19,11/6/2021,0,0,2,2,11,6,8,25,2,0,1,3,0,0,0,0,5,1,0,6
162082,2021,Germany,USA,1,6,3,10,10/6/2021,0,0,1,1,8,7,10,25,1,2,2,5,0,0,0,0,2,1,0,3
162082,2021,Serbia,Germany,1,4,5,10,9/6/2021,0,0,1,1,13,4,8,25,1,2,4,7,1,0,0,1,1,0,1,2
162082,2021,Slovenia,Germany,1,4,13,18,5/6/2021,0,0,0,0,10,3,17,30,1,4,2,7,0,0,0,0,3,2,3,8
162082,2021,Netherlands,Germany,1,2,9,12,4/6/2021,0,0,0,0,17,4,16,37,2,1,4,7,0,0,0,0,1,0,1,2
162082,2021,Germany,Argentina,1,3,9,13,3/6/2021,0,0,0,0,13,4,10,27,0,3,3,6,0,0,0,0,1,1,0,2
162082,2021,Germany,France,1,3,7,11,29/05/2021,0,0,0,0,7,2,4,13,1,1,0,2,0,0,0,0,3,0,0,3
162082,2021,Germany,Australia,1,5,8,14,28/05/2021,0,0,0,0,12,3,4,19,1,2,0,3,0,0,0,0,5,2,0,7
152349,2021,Italy,Germany,0,3,6,9,23/06/2021,0,0,0,0,13,2,1,16,3,5,2,10,0,0,0,0,4,0,0,4
152349,2021,Brazil,Germany,0,3,9,12,22/06/2021,0,0,1,1,6,1,2,9,0,2,3,5,0,0,0,0,0,0,0,0
152349,2021,Germany,Russia,0,2,6,8,21/06/2021,0,0,1,1,10,1,2,13,1,4,5,10,0,0,2,2,2,0,0,2
152349,2021,Germany,Poland,0,0,0,0,17/06/2021,0,0,0,0,0,0,0,0,0,0,0,0,0,0,0,0,0,0,0,0
152349,2021,Canada,Germany,0,4,7,11,16/06/2021,0,1,0,1,7,1,5,13,0,4,1,5,0,0,0,0,0,0,0,0
152349,2021,Japan,Germany,0,4,4,8,15/06/2021,0,0,0,0,3,1,3,7,2,3,0,5,1,0,0,1,0,0,0,0
152349,2021,Iran,Germany,0,3,4,7,11/6/2021,0,0,0,0,5,1,1,7,4,5,4,13,0,1,0,1,2,1,0,3
152349,2021,Germany,USA,1,4,5,10,10/6/2021,0,0,0,0,1,0,2,3,1,2,2,5,0,0,0,0,4,0,1,5
152349,2021,Serbia,Germany,0,5,6,11,9/6/2021,0,0,0,0,4,3,1,8,3,3,9,15,0,0,1,1,3,0,0,3
152349,2021,Slovenia,Germany,2,4,5,11,5/6/2021,0,0,0,0,4,0,4,8,4,3,9,16,1,0,1,2,2,0,0,2
152349,2021,Germany,Argentina,0,3,7,10,3/6/2021,0,0,0,0,13,0,4,17,2,6,6,14,0,0,0,0,4,0,0,4
152349,2021,Germany,Bulgaria,0,2,2,4,30/05/2021,0,0,0,0,5,3,2,10,6,2,6,14,0,0,2,2,0,0,1,1
152349,2021,Germany,France,0,3,7,10,29/05/2021,0,0,0,0,7,2,3,12,2,2,1,5,0,0,1,1,1,0,0,1
152349,2021,Germany,Australia,1,3,3,7,28/05/2021,0,0,0,0,5,0,2,7,0,2,5,7,0,0,0,0,3,0,0,3
152352,2021,Germany,Poland,0,0,0,0,17/06/2021,0,0,0,0,0,0,1,1,0,0,1,1,0,0,0,0,0,0,0,0
152352,2021,Iran,Germany,0,0,0,0,11/6/2021,0,0,1,1,0,0,0,0,0,0,1,1,0,0,0,0,0,0,0,0
152352,2021,Germany,USA,0,0,0,0,10/6/2021,0,0,0,0,0,0,2,2,0,0,0,0,0,0,0,0,0,1,0,1
152352,2021,Serbia,Germany,0,0,0,0,9/6/2021,0,0,0,0,0,0,0,0,0,2,0,2,0,0,0,0,0,1,0,1
152352,2021,Slovenia,Germany,0,0,0,0,5/6/2021,0,0,0,0,0,0,0,0,0,0,0,0,0,0,0,0,0,0,0,0
136751,2021,Iran,Argentina,2,4,10,16,23/06/2021,0,0,2,2,12,2,9,23,1,5,2,8,4,1,10,15,3,0,0,3
136751,2021,Iran,Poland,0,0,0,0,22/06/2021,0,0,0,0,0,0,0,0,0,0,0,0,0,0,0,0,0,0,0,0
136751,2021,France,Iran,0,3,5,8,21/06/2021,0,0,4,4,5,2,8,15,2,2,0,4,6,1,10,17,2,1,0,3
136751,2021,Iran,Slovenia,1,3,14,18,17/06/2021,0,0,3,3,10,2,10,22,1,1,2,4,8,0,14,22,1,7,1,9
136751,2021,Iran,Brazil,0,4,9,13,16/06/2021,0,0,5,5,10,3,6,19,1,3,0,4,19,2,9,30,2,1,0,3
136751,2021,Iran,Australia,1,3,11,15,15/06/2021,0,0,2,2,8,6,8,22,0,1,0,1,20,1,16,37,5,5,0,10
136751,2021,Iran,Germany,0,6,10,16,11/6/2021,0,0,3,3,7,7,4,18,1,1,1,3,12,3,12,27,8,4,1,13
136751,2021,Serbia,Iran,0,0,0,0,10/6/2021,0,0,0,0,0,0,0,0,0,0,0,0,0,0,0,0,0,0,0,0
136751,2021,Iran,USA,0,1,11,12,9/6/2021,0,0,5,5,6,3,12,21,0,2,1,3,7,1,15,23,5,1,1,7
136751,2021,Iran,Italy,2,3,11,16,4/6/2021,0,0,3,3,6,3,11,20,0,2,0,2,5,3,10,18,5,1,0,6
136751,2021,Iran,Canada,0,3,13,16,3/6/2021,0,0,0,0,11,5,7,23,1,5,0,6,7,1,16,24,10,3,0,13
136751,2021,Iran,Russia,0,0,0,0,29/05/2021,0,0,0,0,0,0,0,0,0,0,0,0,0,0,0,0,0,0,0,0
136751,2021,Japan,Iran,0,2,9,11,28/05/2021,0,0,2,2,7,5,9,21,4,0,0,4,19,0,18,37,0,0,0,0
150817,2021,Iran,Argentina,0,0,0,0,23/06/2021,0,0,0,0,0,0,0,0,0,0,0,0,0,0,0,0,0,0,0,0
150817,2021,Iran,Poland,0,0,2,2,22/06/2021,0,0,1,1,0,0,0,0,1,0,0,1,0,0,0,0,0,0,0,0
150817,2021,Iran,Slovenia,0,0,0,0,17/06/2021,0,0,0,0,0,0,0,0,0,0,0,0,0,0,0,0,0,0,0,0
150817,2021,Iran,Brazil,0,2,0,2,16/06/2021,0,0,0,0,0,1,0,1,1,1,0,2,0,0,0,0,0,0,0,0
150817,2021,Iran,Australia,0,0,0,0,15/06/2021,0,0,0,0,0,0,0,0,0,0,0,0,0,0,0,0,0,0,0,0
150817,2021,Iran,Germany,0,1,1,2,11/6/2021,0,0,0,0,0,0,0,0,0,0,1,1,0,0,0,0,0,0,0,0
150817,2021,Serbia,Iran,1,2,13,16,10/6/2021,0,0,1,1,7,1,1,9,3,2,2,7,0,0,0,0,1,0,1,2
150817,2021,Iran,USA,0,0,0,0,9/6/2021,0,0,0,0,0,0,0,0,0,0,0,0,0,0,0,0,0,0,0,0
150817,2021,Bulgaria,Iran,0,1,14,15,5/6/2021,0,0,1,1,1,1,0,2,4,6,3,13,0,0,1,1,3,1,1,5
150817,2021,Iran,Italy,0,0,3,3,4/6/2021,0,0,0,0,0,0,0,0,0,0,0,0,0,0,0,0,0,0,0,0
150817,2021,Japan,Iran,0,0,0,0,28/05/2021,0,0,0,0,0,0,0,0,0,0,0,0,0,0,0,0,0,0,0,0
117478,2021,Iran,Argentina,0,1,6,7,23/06/2021,18,1,31,50,1,0,0,1,0,2,2,4,0,0,0,0,1,0,0,1
117478,2021,Iran,Poland,0,0,0,0,22/06/2021,3,0,9,12,0,0,0,0,0,0,0,0,0,0,0,0,3,0,0,3
117478,2021,France,Iran,0,0,2,2,21/06/2021,8,1,11,20,0,0,1,1,0,1,0,1,0,0,0,0,1,0,0,1
117478,2021,Iran,Slovenia,0,0,14,14,17/06/2021,19,2,61,82,1,0,1,2,0,2,0,2,0,1,0,1,4,5,0,9
117478,2021,Iran,Brazil,0,0,8,8,16/06/2021,10,0,47,57,0,0,4,4,0,0,0,0,0,0,1,1,2,2,0,4
117478,2021,Iran,Australia,1,2,17,20,15/06/2021,19,0,91,110,1,0,1,2,0,1,0,1,0,0,1,1,8,4,1,13
117478,2021,Iran,Germany,1,2,15,18,11/6/2021,34,2,47,83,2,0,0,2,0,1,3,4,0,0,1,1,7,0,0,7
117478,2021,Serbia,Iran,0,0,2,2,10/6/2021,5,1,4,10,0,0,0,0,0,0,0,0,0,0,0,0,0,0,1,1
117478,2021,Iran,USA,0,1,10,11,9/6/2021,12,3,61,76,2,0,3,5,0,1,5,6,0,0,1,1,2,2,0,4
117478,2021,Bulgaria,Iran,0,0,3,3,5/6/2021,3,0,13,16,0,0,0,0,0,0,1,1,0,0,1,1,4,1,0,5
117478,2021,Iran,Italy,0,2,12,14,4/6/2021,20,0,89,109,0,0,2,2,0,2,2,4,0,0,0,0,7,4,0,11
117478,2021,Iran,Canada,0,1,10,11,3/6/2021,35,1,49,85,1,0,0,1,0,1,1,2,0,0,0,0,6,3,1,10
117478,2021,Netherlands,Iran,0,0,0,0,30/05/2021,6,0,0,6,0,0,0,0,0,0,0,0,0,0,0,0,0,0,0,0
118827,2021,Iran,Argentina,0,4,10,14,23/06/2021,0,1,1,2,7,1,1,9,3,8,3,14,0,0,1,1,2,1,1,4
118827,2021,Iran,Poland,0,0,0,0,22/06/2021,0,0,0,0,0,0,0,0,0,0,0,0,0,0,0,0,0,0,0,0
118827,2021,France,Iran,0,1,5,6,21/06/2021,0,0,2,2,2,1,1,4,2,6,1,9,1,0,0,1,0,0,0,0
118827,2021,Iran,Slovenia,1,3,10,14,17/06/2021,0,0,1,1,4,2,2,8,5,4,0,9,0,1,2,3,1,1,0,2
118827,2021,Iran,Brazil,1,4,5,10,16/06/2021,0,0,2,2,4,3,6,13,2,5,1,8,0,0,0,0,1,0,0,1
118827,2021,Iran,Australia,1,2,9,12,15/06/2021,0,0,4,4,8,6,7,21,5,6,1,12,0,0,3,3,0,2,0,2
118827,2021,Iran,Germany,0,7,7,14,11/6/2021,0,0,1,1,9,3,4,16,1,5,5,11,2,0,1,3,3,0,0,3
118827,2021,Iran,USA,0,0,11,11,9/6/2021,0,0,2,2,5,0,5,10,2,2,3,7,0,0,1,1,2,1,4,7
118827,2021,Bulgaria,Iran,3,3,8,14,5/6/2021,0,0,1,1,4,1,4,9,3,5,6,14,0,0,1,1,6,0,1,7
118827,2021,Iran,Italy,0,0,0,0,4/6/2021,0,0,0,0,0,0,0,0,0,0,0,0,0,0,0,0,0,0,0,0
118827,2021,Iran,Canada,1,5,7,13,3/6/2021,0,0,3,3,9,1,2,12,6,7,6,19,0,0,1,1,0,1,2,3
118827,2021,Netherlands,Iran,0,4,5,9,30/05/2021,0,0,0,0,9,0,1,10,1,2,2,5,0,0,0,0,0,0,1,1
118827,2021,Iran,Russia,0,0,0,0,29/05/2021,0,0,0,0,0,0,0,0,0,0,0,0,0,0,0,0,0,0,0,0
118827,2021,Japan,Iran,0,2,5,7,28/05/2021,0,0,0,0,5,0,4,9,0,0,0,0,1,0,0,1,1,0,0,1
162173,2021,Iran,Argentina,0,0,0,0,23/06/2021,0,0,0,0,0,0,0,0,0,0,0,0,0,0,0,0,0,0,0,0
162173,2021,Iran,Australia,0,0,0,0,15/06/2021,0,0,0,0,0,0,0,0,0,0,0,0,0,0,0,0,0,0,0,0
162173,2021,Iran,Germany,0,0,0,0,11/6/2021,0,0,0,0,0,0,0,0,0,0,0,0,0,0,0,0,0,0,0,0
162173,2021,Serbia,Iran,0,0,0,0,10/6/2021,0,0,0,0,0,0,0,0,0,0,0,0,0,1,6,7,1,0,0,1
162173,2021,Iran,USA,0,0,0,0,9/6/2021,0,0,0,0,0,0,0,0,0,0,0,0,0,0,0,0,0,1,0,1
162173,2021,Bulgaria,Iran,0,0,2,2,5/6/2021,0,0,0,0,0,0,3,3,0,0,3,3,0,0,1,1,0,0,0,0
162173,2021,Iran,Italy,0,0,2,2,4/6/2021,0,1,0,1,0,0,3,3,0,2,0,2,1,1,6,8,2,0,0,2
162173,2021,Iran,Canada,0,0,0,0,3/6/2021,0,0,0,0,0,0,0,0,0,0,0,0,0,0,0,0,0,0,0,0
162173,2021,Netherlands,Iran,0,0,0,0,30/05/2021,0,0,0,0,0,0,0,0,0,0,0,0,0,0,1,1,0,1,0,1
162173,2021,Iran,Russia,0,0,1,1,29/05/2021,0,0,0,0,0,0,1,1,0,0,0,0,1,1,1,3,1,0,0,1
162173,2021,Japan,Iran,0,1,11,12,28/05/2021,1,0,1,2,2,1,6,9,0,0,0,0,6,2,10,18,1,0,0,1
163176,2021,Iran,Argentina,0,0,0,0,23/06/2021,0,0,4,4,0,0,0,0,0,0,0,0,8,0,8,16,8,3,1,12
163176,2021,Iran,Poland,0,0,0,0,22/06/2021,0,0,0,0,0,0,0,0,0,0,0,0,0,0,0,0,0,0,0,0
163176,2021,France,Iran,0,0,0,0,21/06/2021,0,0,0,0,0,0,0,0,0,0,0,0,0,0,0,0,0,0,0,0
163176,2021,Iran,Slovenia,0,0,0,0,17/06/2021,0,0,0,0,0,0,0,0,0,0,0,0,0,0,0,0,0,0,0,0
163176,2021,Iran,Brazil,0,0,0,0,16/06/2021,0,0,0,0,0,0,0,0,0,0,0,0,0,0,0,0,0,0,0,0
163176,2021,Iran,Australia,0,0,0,0,15/06/2021,0,0,1,1,0,0,0,0,0,0,0,0,5,0,10,15,3,2,0,5
163176,2021,Iran,Germany,0,0,0,0,11/6/2021,0,0,0,0,0,0,0,0,0,0,0,0,0,0,0,0,0,0,0,0
163176,2021,Serbia,Iran,0,0,0,0,10/6/2021,0,0,13,13,0,0,0,0,0,0,0,0,9,0,10,19,3,3,2,8
163176,2021,Bulgaria,Iran,0,0,0,0,5/6/2021,0,0,2,2,0,0,0,0,0,0,0,0,4,2,11,17,6,4,2,12
163176,2021,Iran,Italy,0,0,0,0,4/6/2021,0,0,0,0,0,0,0,0,0,0,0,0,0,0,0,0,0,0,0,0
163176,2021,Iran,Canada,0,0,0,0,3/6/2021,0,0,4,4,0,0,0,0,0,0,0,0,8,0,8,16,1,3,1,5
163176,2021,Netherlands,Iran,0,0,0,0,30/05/2021,0,0,0,0,0,0,0,0,0,0,0,0,0,0,0,0,0,0,0,0
163176,2021,Japan,Iran,0,0,0,0,28/05/2021,0,0,4,4,0,0,0,0,0,0,0,0,4,0,4,8,3,0,0,3
142078,2021,Iran,Argentina,1,0,18,19,23/06/2021,1,1,0,2,5,2,1,8,3,3,2,8,0,0,1,1,1,2,0,3
142078,2021,Iran,Poland,0,2,6,8,22/06/2021,0,1,0,1,1,1,5,7,0,4,4,8,1,0,0,1,0,0,0,0
142078,2021,France,Iran,0,0,0,0,21/06/2021,0,0,0,0,0,0,0,0,0,0,0,0,0,0,0,0,0,0,0,0
142078,2021,Iran,Slovenia,1,0,17,18,17/06/2021,0,0,2,2,5,1,4,10,3,5,0,8,0,0,0,0,1,1,0,2
142078,2021,Iran,Brazil,0,0,0,0,16/06/2021,0,0,0,0,0,0,0,0,0,0,0,0,0,0,0,0,0,0,0,0
142078,2021,Iran,Australia,0,0,13,13,15/06/2021,0,0,0,0,3,0,1,4,1,2,1,4,0,0,0,0,0,1,0,1
142078,2021,Iran,Germany,0,2,12,14,11/6/2021,0,0,4,4,5,2,2,9,0,3,2,5,1,0,0,1,2,0,0,2
142078,2021,Serbia,Iran,0,0,0,0,10/6/2021,0,0,0,0,0,0,0,0,0,0,0,0,0,0,0,0,0,0,0,0
142078,2021,Iran,USA,0,2,10,12,9/6/2021,0,0,0,0,6,1,1,8,2,2,2,6,0,0,0,0,4,0,0,4
142078,2021,Bulgaria,Iran,0,0,0,0,5/6/2021,0,0,0,0,0,0,0,0,0,0,0,0,0,0,0,0,0,0,0,0
142078,2021,Iran,Italy,2,1,16,19,4/6/2021,0,0,1,1,3,1,6,10,3,4,2,9,1,0,0,1,1,5,0,6
142078,2021,Iran,Canada,0,0,15,15,3/6/2021,0,0,3,3,8,0,2,10,4,5,3,12,0,0,0,0,2,1,1,4
142078,2021,Netherlands,Iran,0,0,0,0,30/05/2021,0,0,0,0,0,0,0,0,0,0,0,0,0,0,0,0,0,0,0,0
142078,2021,Iran,Russia,1,3,9,13,29/05/2021,0,0,0,0,5,1,4,10,1,4,7,12,2,0,1,3,2,1,0,3
142078,2021,Japan,Iran,0,0,0,0,28/05/2021,0,0,0,0,0,0,0,0,0,0,0,0,0,0,0,0,0,0,0,0
124584,2021,Iran,Argentina,0,4,5,9,23/06/2021,0,0,3,3,12,5,2,19,1,1,2,4,1,0,3,4,1,2,2,5
124584,2021,Iran,Poland,0,0,5,5,22/06/2021,1,0,7,8,1,1,2,4,0,1,1,2,0,0,0,0,0,0,0,0
124584,2021,France,Iran,0,1,3,4,21/06/2021,0,0,1,1,5,3,1,9,2,2,1,5,0,0,1,1,0,0,0,0
124584,2021,Iran,Russia,0,0,0,0,29/05/2021,0,0,0,0,0,0,0,0,0,0,0,0,0,0,0,0,0,0,0,0
124584,2021,Japan,Iran,0,3,5,8,28/05/2021,0,0,2,2,15,4,7,26,0,0,0,0,0,0,0,0,0,0,1,1
164188,2021,Iran,Argentina,1,1,10,12,23/06/2021,0,0,2,2,7,3,6,16,0,0,1,1,0,0,1,1,2,3,2,7
164188,2021,France,Iran,1,0,9,10,21/06/2021,0,0,2,2,9,5,5,19,0,3,0,3,0,0,0,0,1,0,0,1
164188,2021,Iran,Slovenia,1,3,7,11,17/06/2021,0,0,1,1,14,3,12,29,1,5,0,6,0,0,0,0,5,3,0,8
164188,2021,Iran,Brazil,1,6,7,14,16/06/2021,0,0,0,0,9,4,15,28,0,3,0,3,0,0,0,0,3,0,0,3
164188,2021,Iran,Australia,0,1,5,6,15/06/2021,0,0,1,1,9,5,9,23,2,1,1,4,0,0,1,1,1,1,0,2
164188,2021,Iran,Germany,2,6,9,17,11/6/2021,0,0,1,1,23,3,12,38,2,2,1,5,0,0,0,0,5,3,0,8
164188,2021,Serbia,Iran,0,0,2,2,10/6/2021,0,0,0,0,4,0,2,6,0,2,1,3,0,0,0,0,0,0,1,1
164188,2021,Iran,USA,5,3,10,18,9/6/2021,0,0,1,1,12,4,11,27,2,2,4,8,0,0,1,1,7,1,2,10
164188,2021,Bulgaria,Iran,0,0,2,2,5/6/2021,0,0,1,1,2,1,5,8,0,0,0,0,0,0,0,0,0,0,0,0
164188,2021,Iran,Italy,3,4,11,18,4/6/2021,0,0,0,0,20,4,29,53,1,6,0,7,0,0,1,1,4,4,0,8
164188,2021,Iran,Canada,0,4,10,14,3/6/2021,0,0,1,1,15,6,11,32,2,2,1,5,0,1,0,1,7,2,1,10
164188,2021,Netherlands,Iran,1,6,10,17,30/05/2021,0,0,0,0,10,5,10,25,0,1,0,1,0,0,1,1,3,1,2,6
164188,2021,Iran,Russia,0,4,12,16,29/05/2021,0,0,0,0,18,4,14,36,0,2,2,4,0,0,0,0,3,1,2,6
164188,2021,Japan,Iran,0,1,1,2,28/05/2021,0,0,0,0,0,0,0,0,0,0,0,0,0,0,0,0,0,0,0,0
152742,2021,Iran,Argentina,0,1,1,2,23/06/2021,0,0,1,1,1,0,4,5,0,2,0,2,0,0,2,2,0,0,0,0
152742,2021,Iran,Poland,0,2,7,9,22/06/2021,0,1,0,1,10,3,10,23,1,1,1,3,5,5,21,31,8,0,0,8
152742,2021,France,Iran,0,0,0,0,21/06/2021,0,0,0,0,0,0,0,0,0,0,0,0,0,0,0,0,0,0,0,0
152742,2021,Iran,Slovenia,0,0,0,0,17/06/2021,0,0,0,0,0,0,0,0,0,0,0,0,0,0,0,0,0,0,0,0
152742,2021,Iran,Brazil,0,0,0,0,16/06/2021,0,0,0,0,0,0,0,0,0,0,0,0,0,0,0,0,0,0,0,0
152742,2021,Iran,Germany,0,0,0,0,11/6/2021,0,0,0,0,0,0,0,0,0,0,0,0,0,0,0,0,0,0,0,0
152742,2021,Serbia,Iran,3,4,11,18,10/6/2021,0,0,1,1,10,5,7,22,1,4,3,8,7,2,27,36,6,1,2,9
152742,2021,Iran,USA,0,0,0,0,9/6/2021,0,0,0,0,0,0,0,0,0,0,0,0,0,0,0,0,0,0,0,0
152742,2021,Bulgaria,Iran,0,0,0,0,5/6/2021,0,0,0,0,0,0,0,0,0,0,0,0,0,0,0,0,0,0,0,0
152742,2021,Netherlands,Iran,0,0,0,0,30/05/2021,0,0,0,0,0,0,0,0,0,0,0,0,0,0,0,0,0,0,0,0
152742,2021,Iran,Russia,0,0,0,0,29/05/2021,0,0,0,0,0,0,0,0,0,0,0,0,0,0,0,0,0,0,0,0
152743,2021,Iran,Poland,0,2,5,7,22/06/2021,0,0,3,3,3,0,3,6,1,5,1,7,0,0,2,2,2,0,0,2
152743,2021,France,Iran,0,2,7,9,21/06/2021,0,0,0,0,1,3,1,5,1,2,3,6,0,0,0,0,1,1,0,2
152743,2021,Iran,Slovenia,0,0,0,0,17/06/2021,0,0,0,0,0,0,0,0,0,0,0,0,0,0,0,0,0,0,0,0
152743,2021,Iran,Brazil,0,1,5,6,16/06/2021,0,0,0,0,4,0,1,5,1,2,0,3,0,0,0,0,1,0,0,1
152743,2021,Iran,Australia,0,2,4,6,15/06/2021,0,0,0,0,2,1,2,5,2,0,0,2,0,1,1,2,0,0,0,0
152743,2021,Bulgaria,Iran,0,0,0,0,5/6/2021,0,0,0,0,0,0,0,0,0,0,0,0,0,0,0,0,0,0,0,0
152743,2021,Iran,Italy,0,0,16,16,4/6/2021,0,0,1,1,5,1,2,8,5,4,3,12,0,0,1,1,1,1,0,2
152743,2021,Iran,Canada,0,0,0,0,3/6/2021,0,0,0,0,0,0,0,0,0,0,0,0,0,0,0,0,0,0,0,0
152743,2021,Netherlands,Iran,1,5,7,13,30/05/2021,0,0,0,0,3,0,2,5,4,5,3,12,0,0,1,1,1,0,1,2
152743,2021,Iran,Russia,0,1,0,1,29/05/2021,0,0,0,0,1,0,0,1,0,3,0,3,0,0,0,0,0,0,0,0
152743,2021,Japan,Iran,0,2,4,6,28/05/2021,0,0,0,0,6,0,3,9,2,0,0,2,0,0,0,0,0,0,0,0
162557,2021,Iran,Argentina,0,2,17,19,23/06/2021,0,1,0,1,13,8,7,28,0,4,2,6,9,2,22,33,5,4,2,11
162557,2021,Iran,Poland,0,0,0,0,22/06/2021,0,0,0,0,0,0,0,0,0,0,0,0,0,0,0,0,0,0,0,0
162557,2021,France,Iran,0,2,8,10,21/06/2021,0,0,3,3,12,1,9,22,0,2,1,3,8,2,5,15,2,0,0,2
162557,2021,Iran,Slovenia,0,3,13,16,17/06/2021,0,0,0,0,15,4,6,25,2,2,0,4,10,1,17,28,5,4,0,9
162557,2021,Iran,Brazil,2,3,8,13,16/06/2021,0,0,1,1,12,4,10,26,1,2,0,3,8,0,13,21,3,0,0,3
162557,2021,Iran,Australia,1,6,15,22,15/06/2021,0,0,1,1,9,3,8,20,2,4,1,7,4,2,11,17,5,2,0,7
162557,2021,Iran,Germany,0,5,9,14,11/6/2021,0,0,1,1,12,6,3,21,3,3,1,7,6,1,16,23,3,2,0,5
162557,2021,Serbia,Iran,0,0,0,0,10/6/2021,0,0,0,0,0,0,0,0,0,0,0,0,0,0,0,0,0,0,0,0
162557,2021,Iran,USA,0,3,6,9,9/6/2021,0,0,3,3,13,5,1,19,1,1,1,3,5,0,12,17,3,0,1,4
162557,2021,Bulgaria,Iran,0,3,11,14,5/6/2021,0,0,1,1,9,1,3,13,0,1,3,4,3,1,10,14,6,0,1,7
162557,2021,Iran,Italy,0,0,7,7,4/6/2021,0,0,1,1,9,1,5,15,0,2,0,2,6,0,11,17,1,2,0,3
162557,2021,Iran,Canada,4,5,10,19,3/6/2021,0,0,1,1,9,2,5,16,1,2,2,5,10,1,23,34,3,1,0,4
162557,2021,Netherlands,Iran,1,1,10,12,30/05/2021,0,0,0,0,8,1,3,12,3,2,0,5,2,2,10,14,4,1,1,6
162557,2021,Iran,Russia,0,4,8,12,29/05/2021,0,0,0,0,11,6,6,23,1,2,2,5,5,0,15,20,6,0,0,6
162557,2021,Japan,Iran,0,2,3,5,28/05/2021,0,0,0,0,6,2,2,10,0,0,0,0,1,0,3,4,0,0,0,0
119750,2021,Iran,Germany,0,0,1,1,11/6/2021,1,0,3,4,0,0,0,0,0,0,0,0,0,0,0,0,0,0,0,0
119750,2021,Serbia,Iran,0,2,12,14,10/6/2021,23,1,56,80,0,0,3,3,1,2,1,4,0,0,0,0,6,5,0,11
119750,2021,Iran,USA,0,0,0,0,9/6/2021,0,0,0,0,0,0,0,0,0,0,0,0,0,0,0,0,0,0,0,0
119750,2021,Bulgaria,Iran,0,0,10,10,5/6/2021,12,0,41,53,1,0,0,1,0,2,1,3,0,0,0,0,1,1,1,3
119750,2021,Iran,Italy,0,0,0,0,4/6/2021,0,0,2,2,0,0,0,0,0,0,0,0,0,0,0,0,0,0,0,0
119750,2021,Iran,Canada,0,0,0,0,3/6/2021,0,0,0,0,0,0,0,0,0,0,0,0,0,0,0,0,0,0,0,0
119750,2021,Netherlands,Iran,1,0,9,10,30/05/2021,15,0,47,62,1,0,1,2,0,0,0,0,0,0,0,0,7,5,0,12
119750,2021,Iran,Russia,0,2,7,9,29/05/2021,29,0,0,29,1,0,1,2,0,1,1,2,0,0,1,1,9,1,1,11
119750,2021,Japan,Iran,1,2,8,11,28/05/2021,8,1,66,75,0,0,0,0,2,0,0,2,0,0,0,0,0,0,0,0
181182,2021,Iran,Argentina,0,0,0,0,23/06/2021,0,0,3,3,0,0,0,0,0,0,0,0,5,0,10,15,2,4,1,7
181182,2021,Iran,Poland,0,0,0,0,22/06/2021,0,1,11,12,0,0,0,0,0,0,0,0,5,0,11,16,8,2,1,11
181182,2021,France,Iran,0,0,0,0,21/06/2021,0,0,4,4,0,0,0,0,0,0,0,0,14,0,9,23,7,1,1,9
181182,2021,Iran,Slovenia,0,0,0,0,17/06/2021,0,0,6,6,0,0,0,0,0,0,0,0,11,0,10,21,5,5,0,10
181182,2021,Iran,Brazil,0,0,0,0,16/06/2021,0,0,7,7,0,0,0,0,0,0,0,0,13,1,14,28,18,4,0,22
181182,2021,Iran,Australia,0,0,0,0,15/06/2021,0,0,3,3,0,0,0,0,0,0,0,0,5,1,7,13,5,4,0,9
181182,2021,Iran,Germany,0,0,0,0,11/6/2021,0,0,7,7,0,0,0,0,0,0,0,0,9,2,13,24,11,5,0,16
181182,2021,Serbia,Iran,0,0,0,0,10/6/2021,0,0,0,0,0,0,0,0,0,0,0,0,0,0,0,0,0,0,0,0
181182,2021,Iran,USA,0,0,0,0,9/6/2021,0,0,5,5,0,0,0,0,0,0,0,0,8,0,6,14,13,2,1,16
181182,2021,Bulgaria,Iran,0,0,0,0,5/6/2021,0,0,0,0,0,0,0,0,0,0,0,0,0,0,0,0,0,0,0,0
181182,2021,Iran,Italy,0,0,0,0,4/6/2021,0,0,7,7,0,0,0,0,0,0,0,0,8,2,8,18,11,6,1,18
181182,2021,Iran,Canada,0,0,0,0,3/6/2021,0,0,0,0,0,0,0,0,0,0,0,0,0,0,0,0,0,0,0,0
181182,2021,Netherlands,Iran,0,0,0,0,30/05/2021,0,0,4,4,0,0,0,0,0,0,0,0,10,0,10,20,5,4,1,10
181182,2021,Iran,Russia,0,0,0,0,29/05/2021,0,0,0,0,0,0,0,0,0,0,0,0,13,1,16,30,12,2,0,14
181182,2021,Japan,Iran,0,0,0,0,28/05/2021,0,0,0,0,0,0,0,0,0,0,0,0,0,0,0,0,0,0,0,0
152752,2021,Iran,Poland,0,4,6,10,22/06/2021,0,0,0,0,6,7,7,20,1,2,1,4,1,1,14,16,5,1,1,7
152752,2021,France,Iran,0,1,6,7,21/06/2021,0,0,0,0,1,0,1,2,0,0,0,0,0,2,1,3,0,0,0,0
152752,2021,Iran,Slovenia,0,0,1,1,17/06/2021,0,0,0,0,0,0,0,0,0,0,0,0,0,0,0,0,0,0,0,0
152752,2021,Iran,Brazil,1,2,9,12,16/06/2021,0,0,0,0,1,1,3,5,0,1,0,1,0,0,1,1,0,1,0,1
152752,2021,Iran,Australia,0,0,1,1,15/06/2021,0,0,0,0,0,0,0,0,0,0,0,0,0,0,0,0,0,1,0,1
152752,2021,Iran,Germany,2,2,3,7,11/6/2021,0,0,0,0,2,0,0,2,0,0,0,0,0,0,2,2,1,0,0,1
152752,2021,Serbia,Iran,2,5,7,14,10/6/2021,0,0,1,1,14,3,8,25,1,2,2,5,15,5,7,27,4,3,1,8
152752,2021,Iran,USA,0,0,0,0,9/6/2021,0,0,0,0,0,0,0,0,0,0,0,0,0,0,0,0,0,0,0,0
152752,2021,Bulgaria,Iran,1,2,10,13,5/6/2021,0,0,0,0,9,4,8,21,1,3,5,9,3,1,16,20,2,1,0,3
152752,2021,Iran,Italy,0,3,1,4,4/6/2021,0,0,1,1,5,1,6,12,1,2,1,4,3,2,10,15,2,2,0,4
152752,2021,Iran,Canada,1,2,5,8,3/6/2021,0,0,1,1,0,0,0,0,0,0,0,0,0,0,0,0,0,0,0,0
152752,2021,Netherlands,Iran,3,3,9,15,30/05/2021,0,0,0,0,10,2,2,14,1,1,1,3,7,3,11,21,3,1,1,5
152752,2021,Iran,Russia,2,2,11,15,29/05/2021,0,1,0,1,12,3,10,25,0,6,3,9,6,2,10,18,1,2,0,3
152752,2021,Japan,Iran,0,1,3,4,28/05/2021,0,0,0,0,0,0,0,0,0,0,0,0,0,0,0,0,0,0,0,0
168551,2021,Iran,Argentina,0,0,0,0,23/06/2021,0,0,1,1,0,0,0,0,0,0,1,1,0,0,0,0,0,0,0,0
168551,2021,Iran,Poland,2,3,6,11,22/06/2021,0,0,0,0,6,7,8,21,0,2,1,3,0,0,0,0,2,0,0,2
168551,2021,France,Iran,0,0,0,0,21/06/2021,0,0,0,0,0,0,0,0,0,0,0,0,0,0,0,0,0,0,0,0
168551,2021,Iran,Slovenia,0,1,1,2,17/06/2021,0,0,0,0,2,2,0,4,0,1,0,1,0,0,0,0,0,0,0,0
168551,2021,Iran,Brazil,0,1,2,3,16/06/2021,0,0,1,1,8,3,4,15,0,0,0,0,0,0,0,0,2,0,0,2
168551,2021,Iran,Australia,1,2,10,13,15/06/2021,0,0,0,0,14,5,8,27,1,2,1,4,0,0,0,0,0,1,0,1
168551,2021,Iran,Germany,0,0,0,0,11/6/2021,0,0,0,0,0,0,0,0,0,0,1,1,0,0,0,0,0,0,0,0
168551,2021,Serbia,Iran,1,2,11,14,10/6/2021,0,0,0,0,15,7,13,35,0,6,2,8,0,0,0,0,2,1,0,3
168551,2021,Iran,USA,0,0,0,0,9/6/2021,0,0,0,0,0,0,1,1,0,0,0,0,0,0,0,0,0,0,0,0
168551,2021,Bulgaria,Iran,1,5,3,9,5/6/2021,0,0,2,2,15,3,3,21,1,4,0,5,0,0,0,0,1,0,1,2
168551,2021,Iran,Italy,0,0,1,1,4/6/2021,0,0,0,0,2,0,1,3,0,0,0,0,0,0,0,0,0,0,0,0
168551,2021,Iran,Canada,0,0,0,0,3/6/2021,0,0,0,0,2,0,0,2,0,0,0,0,0,0,0,0,0,0,0,0
168551,2021,Netherlands,Iran,0,1,1,2,30/05/2021,0,0,0,0,3,1,1,5,0,0,1,1,0,0,0,0,1,0,0,1
168551,2021,Iran,Russia,0,0,0,0,29/05/2021,0,0,0,0,1,0,0,1,0,1,1,2,0,0,0,0,0,0,0,0
152755,2021,Iran,Argentina,1,2,4,7,23/06/2021,13,0,29,42,1,0,1,2,1,0,0,1,0,0,1,1,2,0,0,2
152755,2021,Iran,Poland,1,2,3,6,22/06/2021,9,0,42,51,0,0,1,1,1,0,2,3,0,0,0,0,6,1,1,8
152755,2021,France,Iran,1,1,5,7,21/06/2021,7,2,31,40,0,0,0,0,1,1,0,2,0,0,0,0,1,1,0,2
152755,2021,Iran,Slovenia,0,0,1,1,17/06/2021,0,0,2,2,0,0,0,0,0,0,0,0,0,0,0,0,0,1,0,1
152755,2021,Iran,Brazil,0,1,3,4,16/06/2021,8,0,29,37,0,1,1,2,1,0,0,1,0,0,0,0,0,1,0,1
152755,2021,Iran,Australia,0,0,0,0,15/06/2021,0,0,1,1,0,0,0,0,0,0,0,0,0,0,0,0,0,0,0,0
152422,2021,Russia,Italy,0,0,0,0,22/06/2021,0,0,0,0,0,0,0,0,0,0,0,0,0,0,0,0,0,0,0,0
152422,2021,Brazil,Italy,0,0,0,0,21/06/2021,0,0,0,0,0,0,0,0,0,0,0,0,0,0,0,0,0,0,0,0
152422,2021,France,Italy,0,0,0,0,17/06/2021,0,0,0,0,0,0,0,0,0,0,0,0,0,0,0,0,0,0,0,0
152422,2021,Netherlands,Italy,0,0,0,0,16/06/2021,0,0,0,0,0,0,0,0,0,0,0,0,0,0,0,0,0,0,0,0
152422,2021,Italy,USA,0,2,3,5,15/06/2021,0,0,0,0,5,1,5,11,0,0,1,1,1,2,7,10,2,2,0,4
152422,2021,Australia,Italy,0,0,0,0,11/6/2021,0,0,0,0,0,0,0,0,0,0,0,0,0,0,0,0,0,0,0,0
152422,2021,Japan,Italy,0,0,1,1,10/6/2021,0,0,1,1,0,0,3,3,0,0,0,0,0,1,1,2,1,0,0,1
152422,2021,Argentina,Italy,0,0,0,0,9/6/2021,0,0,0,0,0,0,0,0,0,0,0,0,0,0,0,0,0,0,0,0
152422,2021,Canada,Italy,0,0,0,0,5/6/2021,0,0,0,0,0,0,0,0,0,0,0,0,0,0,0,0,0,0,0,0
152422,2021,Iran,Italy,0,0,0,0,4/6/2021,0,0,0,0,0,0,0,0,0,0,0,0,0,0,0,0,0,0,0,0
152422,2021,Serbia,Italy,0,0,0,0,30/05/2021,0,0,0,0,0,0,0,0,0,0,0,0,0,1,0,1,0,0,0,0
152422,2021,Italy,Slovenia,0,0,0,0,29/05/2021,0,0,0,0,0,0,0,0,0,0,0,0,0,0,0,0,0,0,0,0
150436,2021,Italy,Germany,0,0,0,0,23/06/2021,0,0,12,12,0,0,0,0,0,0,0,0,5,3,15,23,12,4,1,17
150436,2021,Russia,Italy,0,0,0,0,22/06/2021,0,0,11,11,0,0,0,0,0,0,0,0,6,3,12,21,10,3,2,15
150436,2021,Brazil,Italy,0,0,0,0,21/06/2021,0,0,6,6,0,0,0,0,0,0,0,0,6,1,24,31,13,6,4,23
150436,2021,France,Italy,0,0,0,0,17/06/2021,0,0,7,7,0,0,0,0,0,0,0,0,14,0,8,22,10,2,0,12
150436,2021,Netherlands,Italy,0,0,0,0,16/06/2021,0,0,9,9,0,0,0,0,0,0,0,0,6,1,17,24,7,3,4,14
150436,2021,Italy,USA,0,0,0,0,15/06/2021,0,0,9,9,0,0,0,0,0,0,0,0,4,2,8,14,6,2,2,10
150436,2021,Australia,Italy,0,0,0,0,11/6/2021,0,0,4,4,0,0,0,0,0,0,0,0,7,0,7,14,13,3,0,16
150436,2021,Japan,Italy,0,0,0,0,10/6/2021,0,0,7,7,0,0,0,0,0,0,0,0,7,2,14,23,18,2,4,24
150436,2021,Argentina,Italy,0,0,0,0,9/6/2021,0,0,9,9,0,0,0,0,0,0,0,0,10,1,9,20,8,5,1,14
150436,2021,Canada,Italy,0,0,0,0,5/6/2021,0,0,5,5,0,0,0,0,0,0,0,0,0,3,10,13,1,1,2,4
150436,2021,Iran,Italy,0,0,0,0,4/6/2021,0,0,8,8,0,0,0,0,0,0,0,0,11,1,6,18,16,6,0,22
150436,2021,Italy,Bulgaria,0,0,0,0,3/6/2021,0,0,9,9,0,0,0,0,0,0,0,0,8,1,13,22,20,4,1,25
150436,2021,Serbia,Italy,0,0,0,0,30/05/2021,0,0,8,8,0,0,0,0,0,0,0,0,8,1,15,24,14,5,2,21
150436,2021,Italy,Slovenia,0,0,0,0,29/05/2021,0,0,7,7,0,0,0,0,0,0,0,0,7,4,6,17,6,0,1,7
150436,2021,Poland,Italy,0,0,0,0,28/05/2021,0,0,0,0,0,0,0,0,0,0,0,0,6,4,15,25,7,2,1,10
152370,2021,Italy,Germany,0,2,10,12,23/06/2021,21,2,44,67,1,0,2,3,1,3,8,12,0,0,0,0,8,1,1,10
152370,2021,Russia,Italy,0,0,1,1,22/06/2021,3,0,6,9,0,0,0,0,0,0,0,0,0,0,0,0,1,1,0,2
152370,2021,Brazil,Italy,0,2,9,11,21/06/2021,23,2,65,90,0,0,0,0,1,2,3,6,0,0,0,0,5,5,1,11
152370,2021,France,Italy,0,0,0,0,17/06/2021,0,0,0,0,0,0,0,0,0,0,0,0,0,0,0,0,0,0,0,0
152370,2021,Netherlands,Italy,0,2,10,12,16/06/2021,14,1,60,75,1,0,1,2,1,3,2,6,0,0,0,0,6,1,2,9
152370,2021,Italy,USA,0,1,4,5,15/06/2021,15,0,34,49,0,1,0,1,0,2,0,2,0,0,1,1,5,4,1,10
152370,2021,Australia,Italy,0,2,8,10,11/6/2021,25,0,45,70,1,0,0,1,0,4,2,6,0,0,0,0,2,0,0,2
152370,2021,Japan,Italy,0,0,0,0,10/6/2021,3,0,10,13,0,0,0,0,0,1,1,2,0,0,0,0,0,0,0,0
152370,2021,Argentina,Italy,0,1,13,14,9/6/2021,14,0,64,78,2,0,0,2,1,5,2,8,0,0,0,0,2,2,2,6
152370,2021,Canada,Italy,0,0,0,0,5/6/2021,1,0,2,3,0,0,0,0,0,0,0,0,0,0,0,0,1,1,0,2
152370,2021,Iran,Italy,2,3,12,17,4/6/2021,24,2,81,107,0,1,3,4,0,3,2,5,0,0,1,1,8,3,1,12
152370,2021,Italy,Bulgaria,1,2,15,18,3/6/2021,25,0,74,99,0,0,2,2,0,1,2,3,0,0,0,0,6,2,1,9
152370,2021,Serbia,Italy,0,3,7,10,30/05/2021,15,0,93,108,0,0,0,0,1,2,1,4,0,0,0,0,8,3,1,12
152370,2021,Italy,Slovenia,2,0,10,12,29/05/2021,23,0,42,65,1,0,0,1,0,1,0,1,0,0,1,1,0,0,0,0
152370,2021,Poland,Italy,0,1,7,8,28/05/2021,22,0,1,23,1,1,0,2,1,1,2,4,0,0,1,1,5,1,3,9
171191,2021,Italy,Germany,2,4,15,21,23/06/2021,0,0,4,4,17,5,13,35,3,2,2,7,5,0,15,20,13,2,1,16
171191,2021,Russia,Italy,0,1,1,2,22/06/2021,0,0,1,1,4,0,1,5,0,0,1,1,2,0,6,8,4,0,0,4
171191,2021,Brazil,Italy,0,2,11,13,21/06/2021,0,0,2,2,18,2,12,32,2,2,4,8,4,2,14,20,5,1,1,7
171191,2021,France,Italy,0,2,18,20,17/06/2021,0,0,4,4,14,1,10,25,1,2,0,3,10,1,13,24,6,2,0,8
171191,2021,Netherlands,Italy,5,2,18,25,16/06/2021,0,0,2,2,14,3,11,28,1,3,3,7,8,2,22,32,9,2,0,11
171191,2021,Italy,USA,0,0,0,0,15/06/2021,0,0,0,0,0,0,0,0,0,0,0,0,2,0,0,2,2,0,0,2
171191,2021,Australia,Italy,2,3,9,14,11/6/2021,0,0,1,1,9,4,7,20,2,0,2,4,6,0,7,13,7,1,0,8
171191,2021,Japan,Italy,0,1,2,3,10/6/2021,0,0,1,1,7,1,3,11,1,0,0,1,1,1,14,16,2,2,1,5
171191,2021,Argentina,Italy,0,3,5,8,9/6/2021,0,0,2,2,14,0,11,25,4,1,1,6,8,0,17,25,2,1,0,3
171191,2021,Canada,Italy,0,0,1,1,5/6/2021,0,0,0,0,2,0,2,4,0,0,0,0,0,0,2,2,0,1,0,1
171191,2021,Iran,Italy,1,3,6,10,4/6/2021,0,0,2,2,13,4,7,24,0,0,0,0,4,3,13,20,4,0,0,4
171191,2021,Italy,Bulgaria,0,2,19,21,3/6/2021,0,0,1,1,18,0,14,32,3,5,0,8,6,0,23,29,9,4,1,14
171191,2021,Serbia,Italy,0,3,15,18,30/05/2021,0,0,0,0,9,4,17,30,2,0,4,6,5,1,14,20,6,2,1,9
171191,2021,Italy,Slovenia,0,3,4,7,29/05/2021,0,0,2,2,6,2,4,12,0,0,0,0,4,2,10,16,1,0,0,1
171191,2021,Poland,Italy,0,2,9,11,28/05/2021,0,0,0,0,7,1,13,21,0,0,1,1,2,3,15,20,2,0,1,3
137823,2021,Italy,Germany,0,5,5,10,23/06/2021,0,0,3,3,10,3,11,24,2,5,5,12,0,0,0,0,13,1,2,16
137823,2021,Russia,Italy,1,3,3,7,22/06/2021,0,0,1,1,5,2,7,14,1,3,1,5,0,0,0,0,1,2,0,3
137823,2021,Brazil,Italy,1,1,7,9,21/06/2021,0,0,1,1,4,4,5,13,0,4,3,7,0,0,0,0,2,2,0,4
137823,2021,France,Italy,1,3,12,16,17/06/2021,0,1,2,3,19,5,7,31,1,2,5,8,0,0,0,0,1,6,0,7
137823,2021,Netherlands,Italy,0,0,0,0,16/06/2021,0,0,0,0,0,0,0,0,0,0,0,0,0,0,0,0,0,0,0,0
137823,2021,Japan,Italy,1,3,12,16,10/6/2021,0,0,3,3,15,4,12,31,0,2,3,5,1,0,0,1,7,1,2,10
137823,2021,Argentina,Italy,2,3,5,10,9/6/2021,0,0,0,0,6,5,8,19,0,4,1,5,0,0,0,0,5,2,0,7
137823,2021,Canada,Italy,2,5,13,20,5/6/2021,0,0,4,4,17,3,13,33,0,2,2,4,0,0,0,0,6,3,1,10
137823,2021,Iran,Italy,3,6,7,16,4/6/2021,0,0,4,4,16,5,15,36,1,2,1,4,0,0,0,0,3,4,1,8
137823,2021,Italy,Bulgaria,0,0,2,2,3/6/2021,0,0,1,1,0,0,0,0,0,0,0,0,0,0,0,0,0,0,0,0
137823,2021,Serbia,Italy,0,1,0,1,30/05/2021,0,0,0,0,0,1,1,2,0,0,2,2,0,0,0,0,0,0,0,0
137823,2021,Italy,Slovenia,1,2,7,10,29/05/2021,0,1,1,2,6,1,9,16,0,0,1,1,0,0,0,0,1,0,0,1
137823,2021,Poland,Italy,0,5,4,9,28/05/2021,0,0,0,0,10,5,8,23,0,1,1,2,0,0,0,0,7,3,5,15
143692,2021,Italy,Germany,0,0,4,4,23/06/2021,9,0,25,34,0,0,1,1,0,0,2,2,0,0,0,0,2,0,0,2
143692,2021,Russia,Italy,1,1,12,14,22/06/2021,18,2,64,84,0,2,2,4,1,0,1,2,0,0,1,1,3,3,1,7
143692,2021,Brazil,Italy,0,0,2,2,21/06/2021,5,0,14,19,1,0,0,1,0,1,0,1,0,0,0,0,0,0,0,0
143692,2021,France,Italy,1,2,12,15,17/06/2021,20,0,85,105,1,0,0,1,4,1,3,8,0,0,0,0,4,3,0,7
143692,2021,Netherlands,Italy,0,0,3,3,16/06/2021,3,0,10,13,1,0,0,1,0,0,0,0,0,0,0,0,0,0,0,0
143692,2021,Italy,USA,0,0,3,3,15/06/2021,2,0,10,12,0,0,1,1,0,0,2,2,0,0,0,0,0,0,0,0
143692,2021,Australia,Italy,0,0,0,0,11/6/2021,0,0,0,0,0,0,0,0,0,0,0,0,0,0,0,0,0,0,0,0
143692,2021,Japan,Italy,0,0,12,12,10/6/2021,29,1,74,104,2,0,1,3,2,1,3,6,0,0,0,0,7,2,2,11
143692,2021,Argentina,Italy,0,0,0,0,9/6/2021,0,0,0,0,0,1,0,1,0,0,0,0,0,0,0,0,0,0,0,0
143692,2021,Canada,Italy,0,1,10,11,5/6/2021,10,1,75,86,0,1,3,4,3,1,4,8,0,0,0,0,11,3,0,14
143692,2021,Iran,Italy,0,0,2,2,4/6/2021,3,0,5,8,0,0,0,0,0,0,0,0,0,0,0,0,0,0,0,0
143692,2021,Italy,Bulgaria,0,0,0,0,3/6/2021,1,0,4,5,0,0,0,0,0,0,0,0,0,0,0,0,0,0,0,0
143692,2021,Serbia,Italy,0,0,1,1,30/05/2021,2,0,2,4,0,0,0,0,0,1,1,2,0,0,0,0,1,1,0,2
143692,2021,Italy,Slovenia,0,0,0,0,29/05/2021,1,0,1,2,0,0,0,0,0,0,0,0,0,0,0,0,0,0,0,0
143692,2021,Poland,Italy,0,0,0,0,28/05/2021,1,0,0,1,0,0,0,0,0,0,0,0,0,0,0,0,1,1,0,2
162518,2021,Italy,Germany,1,3,2,6,23/06/2021,0,0,0,0,2,3,4,9,1,0,0,1,0,0,0,0,2,0,0,2
162518,2021,Russia,Italy,2,2,5,9,22/06/2021,0,0,1,1,8,2,1,11,0,0,0,0,0,0,0,0,0,4,0,4
162518,2021,Brazil,Italy,1,3,5,9,21/06/2021,0,0,2,2,11,1,5,17,0,4,1,5,0,0,0,0,5,1,0,6
162518,2021,France,Italy,0,0,1,1,17/06/2021,0,0,0,0,0,0,0,0,0,0,0,0,0,0,0,0,1,0,0,1
162518,2021,Netherlands,Italy,1,3,8,12,16/06/2021,0,0,0,0,13,4,7,24,3,9,6,18,0,0,0,0,4,0,0,4
162518,2021,Italy,USA,2,3,5,10,15/06/2021,0,0,0,0,5,3,9,17,0,2,7,9,0,1,1,2,5,1,0,6
162518,2021,Australia,Italy,1,2,11,14,11/6/2021,0,0,0,0,11,1,6,18,1,3,2,6,0,0,0,0,4,4,2,10
162518,2021,Japan,Italy,0,1,3,4,10/6/2021,0,0,0,0,0,1,4,5,0,4,1,5,0,0,0,0,0,1,0,1
162518,2021,Argentina,Italy,0,1,2,3,9/6/2021,0,0,0,0,2,0,2,4,0,0,0,0,0,0,0,0,0,0,0,0
162518,2021,Canada,Italy,0,0,0,0,5/6/2021,0,0,0,0,0,0,0,0,0,0,0,0,0,0,0,0,0,0,0,0
162518,2021,Iran,Italy,0,0,1,1,4/6/2021,0,0,0,0,1,1,3,5,0,1,0,1,0,0,0,0,0,1,0,1
162518,2021,Italy,Bulgaria,0,2,12,14,3/6/2021,0,0,2,2,18,3,9,30,0,3,1,4,0,0,1,1,6,4,0,10
162518,2021,Serbia,Italy,1,3,12,16,30/05/2021,0,0,0,0,21,4,14,39,0,5,1,6,0,0,0,0,3,5,0,8
162518,2021,Italy,Slovenia,0,1,0,1,29/05/2021,0,0,0,0,0,0,0,0,0,0,0,0,0,0,0,0,0,0,0,0
162518,2021,Poland,Italy,0,0,0,0,28/05/2021,0,0,0,0,0,0,1,1,0,0,0,0,0,0,0,0,0,0,0,0
152492,2021,Italy,Germany,1,1,1,3,23/06/2021,0,0,0,0,3,0,2,5,0,0,1,1,3,0,7,10,0,1,0,1
152492,2021,Russia,Italy,0,0,2,2,22/06/2021,0,0,1,1,6,0,2,8,0,2,1,3,0,0,8,8,1,0,0,1
152492,2021,Brazil,Italy,0,0,0,0,21/06/2021,0,0,0,0,0,0,0,0,0,0,0,0,0,0,0,0,0,0,0,0
152492,2021,France,Italy,0,0,0,0,17/06/2021,0,0,0,0,0,0,0,0,0,0,0,0,0,0,0,0,0,0,0,0
152492,2021,Netherlands,Italy,0,0,0,0,16/06/2021,0,0,0,0,0,0,0,0,0,0,0,0,0,0,0,0,0,0,0,0
152492,2021,Italy,USA,0,0,3,3,15/06/2021,0,0,1,1,4,3,1,8,1,0,0,1,3,2,4,9,1,0,0,1
152492,2021,Australia,Italy,0,4,7,11,11/6/2021,0,0,2,2,6,1,8,15,0,1,1,2,1,0,18,19,5,3,0,8
152492,2021,Japan,Italy,0,1,0,1,10/6/2021,0,0,0,0,0,0,0,0,0,0,0,0,0,0,0,0,0,0,0,0
152492,2021,Argentina,Italy,0,0,0,0,9/6/2021,0,0,0,0,0,0,0,0,0,0,0,0,0,0,0,0,0,0,0,0
152492,2021,Canada,Italy,0,0,0,0,5/6/2021,0,0,0,0,0,0,0,0,0,0,0,0,0,0,0,0,0,0,0,0
152492,2021,Iran,Italy,0,1,12,13,4/6/2021,0,1,1,2,10,5,14,29,0,5,1,6,11,2,14,27,7,5,0,12
152492,2021,Italy,Bulgaria,1,2,10,13,3/6/2021,0,0,0,0,15,7,7,29,1,1,2,4,5,1,17,23,0,2,1,3
152492,2021,Serbia,Italy,0,0,0,0,30/05/2021,0,0,0,0,0,0,0,0,0,0,0,0,0,0,0,0,0,0,0,0
152492,2021,Italy,Slovenia,0,0,2,2,29/05/2021,0,0,0,0,1,2,1,4,0,0,0,0,0,0,1,1,0,0,0,0
152492,2021,Poland,Italy,0,0,0,0,28/05/2021,0,0,0,0,0,0,0,0,0,0,0,0,0,0,0,0,0,0,0,0
150435,2021,Italy,Germany,0,2,8,10,23/06/2021,0,0,0,0,1,0,0,1,0,0,0,0,0,0,0,0,0,0,0,0
150435,2021,Russia,Italy,0,1,4,5,22/06/2021,0,0,0,0,2,0,0,2,0,1,2,3,0,0,0,0,1,0,0,1
150435,2021,Brazil,Italy,0,1,12,13,21/06/2021,0,0,0,0,2,0,3,5,2,5,3,10,0,0,1,1,3,1,1,5
150435,2021,France,Italy,0,3,6,9,17/06/2021,0,0,1,1,2,1,0,3,0,0,1,1,1,0,1,2,1,1,0,2
150435,2021,Italy,USA,0,2,1,3,15/06/2021,0,0,0,0,0,0,0,0,0,0,0,0,0,0,0,0,0,1,0,1
150435,2021,Australia,Italy,0,1,1,2,11/6/2021,0,0,0,0,0,0,0,0,0,0,0,0,0,0,0,0,0,0,0,0
150435,2021,Japan,Italy,0,2,14,16,10/6/2021,0,0,3,3,5,0,7,12,2,7,8,17,0,0,1,1,5,1,3,9
150435,2021,Argentina,Italy,2,4,7,13,9/6/2021,0,0,0,0,1,1,4,6,4,0,1,5,0,0,0,0,1,2,0,3
150435,2021,Italy,Bulgaria,1,2,3,6,3/6/2021,0,0,0,0,0,1,1,2,0,0,0,0,0,0,0,0,0,0,0,0
150435,2021,Serbia,Italy,0,0,0,0,30/05/2021,0,0,0,0,0,0,0,0,0,0,0,0,0,0,0,0,0,0,0,0
150435,2021,Italy,Slovenia,0,2,1,3,29/05/2021,0,0,0,0,2,0,1,3,0,0,0,0,0,0,0,0,0,0,0,0
163028,2021,Italy,Germany,0,0,21,21,23/06/2021,0,0,3,3,3,0,1,4,3,5,2,10,0,0,0,0,0,2,0,2
163028,2021,Russia,Italy,0,0,14,14,22/06/2021,0,0,1,1,6,1,2,9,6,4,3,13,0,0,0,0,8,2,0,10
163028,2021,Brazil,Italy,0,1,3,4,21/06/2021,0,0,0,0,1,0,2,3,0,2,4,6,0,0,0,0,2,1,0,3
163028,2021,France,Italy,1,1,19,21,17/06/2021,0,0,0,0,8,0,2,10,4,6,0,10,0,0,0,0,2,0,0,2
163028,2021,Netherlands,Italy,2,1,18,21,16/06/2021,0,0,1,1,4,0,3,7,0,5,3,8,1,0,0,1,4,0,0,4
163028,2021,Italy,USA,1,1,10,12,15/06/2021,0,0,1,1,5,0,5,10,0,5,1,6,0,0,1,1,4,1,0,5
163028,2021,Australia,Italy,0,0,0,0,11/6/2021,0,0,0,0,0,0,0,0,0,0,0,0,0,0,0,0,0,0,0,0
163028,2021,Japan,Italy,0,1,7,8,10/6/2021,0,0,1,1,2,1,4,7,3,4,2,9,0,0,0,0,2,0,2,4
163028,2021,Argentina,Italy,1,1,11,13,9/6/2021,0,0,0,0,2,0,4,6,4,1,3,8,0,0,0,0,1,0,0,1
163028,2021,Canada,Italy,1,1,24,26,5/6/2021,0,0,0,0,1,0,2,3,5,5,6,16,0,0,1,1,2,0,0,2
163028,2021,Iran,Italy,1,1,12,14,4/6/2021,0,0,0,0,8,1,3,12,0,3,2,5,0,0,0,0,1,3,0,4
163028,2021,Italy,Bulgaria,2,2,8,12,3/6/2021,0,0,0,0,7,1,1,9,2,7,6,15,0,0,0,0,0,1,0,1
163028,2021,Italy,Slovenia,0,1,3,4,29/05/2021,0,0,0,0,1,2,2,5,0,0,0,0,0,0,1,1,0,0,0,0
163028,2021,Poland,Italy,0,1,7,8,28/05/2021,0,0,0,0,1,0,1,2,1,2,4,7,0,0,0,0,0,0,0,0
181128,2021,Italy,Germany,0,0,0,0,23/06/2021,0,0,0,0,0,0,0,0,0,0,0,0,0,0,0,0,0,0,0,0
181128,2021,Italy,USA,0,0,0,0,15/06/2021,0,0,0,0,0,0,0,0,0,0,0,0,0,0,0,0,0,0,0,0
181128,2021,Poland,Italy,0,0,0,0,28/05/2021,0,0,0,0,0,0,0,0,0,0,0,0,0,0,0,0,0,0,0,0
163033,2021,Italy,Germany,0,0,0,0,23/06/2021,0,0,0,0,0,0,0,0,0,0,0,0,0,1,0,1,0,0,0,0
163033,2021,Russia,Italy,0,2,5,7,22/06/2021,0,0,1,1,10,6,9,25,1,1,0,2,6,0,21,27,6,0,0,6
163033,2021,Brazil,Italy,0,2,9,11,21/06/2021,0,0,1,1,16,5,17,38,1,5,2,8,5,2,23,30,6,0,1,7
163033,2021,France,Italy,1,2,7,10,17/06/2021,0,0,0,0,11,6,12,29,0,1,0,1,14,0,9,23,2,3,0,5
163033,2021,Netherlands,Italy,0,3,9,12,16/06/2021,0,0,3,3,16,4,11,31,4,1,0,5,5,2,9,16,5,2,0,7
163033,2021,Italy,USA,0,1,4,5,15/06/2021,0,0,2,2,1,3,6,10,0,2,0,2,1,1,7,9,1,0,0,1
163033,2021,Australia,Italy,0,0,0,0,11/6/2021,0,0,0,0,0,0,0,0,0,0,0,0,0,0,0,0,0,0,0,0
163033,2021,Japan,Italy,0,1,11,12,10/6/2021,0,0,1,1,16,2,16,34,0,4,3,7,5,0,19,24,4,1,2,7
163033,2021,Argentina,Italy,1,2,12,15,9/6/2021,0,0,0,0,11,4,13,28,2,1,0,3,4,0,6,10,5,4,2,11
163033,2021,Canada,Italy,0,2,12,14,5/6/2021,0,0,2,2,16,4,12,32,3,2,3,8,15,2,21,38,5,5,4,14
163033,2021,Iran,Italy,0,1,9,10,4/6/2021,0,0,1,1,8,2,4,14,1,2,0,3,11,1,8,20,4,1,0,5
163033,2021,Italy,Bulgaria,1,0,4,5,3/6/2021,0,0,1,1,0,1,1,2,0,0,0,0,3,0,4,7,1,3,0,4
163033,2021,Serbia,Italy,0,2,13,15,30/05/2021,0,0,0,0,9,5,18,32,1,2,4,7,9,1,18,28,8,3,0,11
163033,2021,Italy,Slovenia,0,1,1,2,29/05/2021,0,0,0,0,2,1,3,6,0,0,0,0,1,1,4,6,0,0,0,0
163033,2021,Poland,Italy,0,1,2,3,28/05/2021,0,0,0,0,1,0,0,1,0,1,0,1,1,0,4,5,1,0,1,2
163447,2021,Italy,Germany,1,4,6,11,23/06/2021,0,0,0,0,12,5,13,30,1,1,1,3,4,1,15,20,4,1,0,5
163447,2021,Russia,Italy,4,5,23,32,22/06/2021,0,0,3,3,10,7,12,29,0,2,0,2,5,2,10,17,6,2,0,8
163447,2021,Brazil,Italy,1,2,1,4,21/06/2021,0,0,0,0,2,0,2,4,0,0,0,0,1,0,1,2,0,0,0,0
163447,2021,France,Italy,1,2,3,6,17/06/2021,0,0,0,0,7,1,6,14,0,0,1,1,1,2,7,10,1,0,0,1
163447,2021,Netherlands,Italy,0,0,0,0,16/06/2021,0,0,0,0,0,0,0,0,0,0,0,0,0,0,0,0,0,0,0,0
163447,2021,Italy,USA,0,1,3,4,15/06/2021,0,0,0,0,5,3,7,15,0,0,0,0,4,0,6,10,2,1,0,3
163447,2021,Australia,Italy,0,0,0,0,11/6/2021,0,0,0,0,0,0,0,0,0,0,0,0,0,0,0,0,0,0,0,0
163447,2021,Japan,Italy,2,3,10,15,10/6/2021,0,0,0,0,9,4,10,23,4,6,3,13,2,2,23,27,3,3,3,9
163447,2021,Argentina,Italy,0,0,0,0,9/6/2021,0,0,0,0,0,0,0,0,0,0,0,0,0,0,0,0,0,0,0,0
163447,2021,Canada,Italy,2,4,17,23,5/6/2021,0,0,3,3,10,7,11,28,2,3,4,9,4,2,13,19,5,2,1,8
163447,2021,Iran,Italy,0,1,0,1,4/6/2021,0,0,0,0,0,0,0,0,0,0,0,0,0,0,0,0,0,0,0,0
163447,2021,Italy,Bulgaria,0,0,0,0,3/6/2021,0,0,0,0,0,0,0,0,0,0,0,0,0,0,0,0,0,0,0,0
163447,2021,Serbia,Italy,0,0,0,0,30/05/2021,0,0,0,0,0,0,0,0,0,0,0,0,0,0,0,0,0,0,0,0
163447,2021,Italy,Slovenia,0,1,5,6,29/05/2021,0,0,1,1,4,4,12,20,1,0,0,1,9,1,7,17,0,0,0,0
163447,2021,Poland,Italy,0,3,5,8,28/05/2021,0,0,0,0,9,5,13,27,2,2,4,8,2,1,4,7,3,1,0,4
174074,2021,Italy,Germany,0,1,10,11,23/06/2021,0,0,0,0,9,1,3,13,4,6,4,14,0,0,4,4,2,0,0,2
174074,2021,Russia,Italy,0,0,7,7,22/06/2021,0,0,0,0,6,0,0,6,1,1,1,3,0,0,1,1,1,0,0,1
174074,2021,Brazil,Italy,0,1,18,19,21/06/2021,0,0,0,0,6,1,4,11,3,6,7,16,0,0,3,3,3,0,0,3
174074,2021,France,Italy,1,0,8,9,17/06/2021,0,1,0,1,2,2,3,7,1,2,1,4,1,0,2,3,3,1,0,4
174074,2021,Netherlands,Italy,0,1,10,11,16/06/2021,0,0,2,2,3,2,4,9,3,3,8,14,0,0,0,0,1,0,0,1
174074,2021,Italy,USA,0,0,5,5,15/06/2021,0,0,0,0,4,1,1,6,0,1,1,2,0,1,0,1,1,0,0,1
174074,2021,Australia,Italy,0,0,12,12,11/6/2021,0,0,0,0,5,1,2,8,1,0,3,4,0,0,0,0,0,1,0,1
174074,2021,Japan,Italy,0,1,7,8,10/6/2021,0,0,0,0,3,1,2,6,0,3,4,7,0,0,0,0,0,0,1,1
174074,2021,Argentina,Italy,0,0,3,3,9/6/2021,0,0,0,0,0,0,0,0,1,1,0,2,1,0,0,1,0,0,0,0
174074,2021,Canada,Italy,0,1,12,13,5/6/2021,0,0,3,3,3,0,1,4,5,6,4,15,0,0,0,0,0,1,0,1
174074,2021,Iran,Italy,0,0,2,2,4/6/2021,0,0,0,0,0,0,2,2,0,0,0,0,0,0,0,0,0,0,0,0
174074,2021,Italy,Bulgaria,0,0,0,0,3/6/2021,0,0,0,0,0,0,0,0,0,0,0,0,0,0,0,0,0,0,0,0
174074,2021,Serbia,Italy,0,0,13,13,30/05/2021,0,0,0,0,6,0,6,12,2,5,2,9,1,0,0,1,2,1,0,3
174074,2021,Poland,Italy,0,0,1,1,28/05/2021,0,0,0,0,0,0,0,0,0,0,1,1,0,0,0,0,0,0,0,0
163025,2021,Italy,Germany,0,0,0,0,23/06/2021,0,0,0,0,0,0,0,0,0,0,0,0,0,0,0,0,0,0,0,0
163025,2021,Russia,Italy,0,0,0,0,22/06/2021,0,0,0,0,0,0,0,0,0,0,0,0,0,0,0,0,0,0,0,0
163025,2021,Brazil,Italy,0,0,0,0,21/06/2021,0,0,0,0,0,0,0,0,0,0,0,0,0,0,0,0,0,0,0,0
163025,2021,France,Italy,0,0,0,0,17/06/2021,0,0,0,0,0,0,0,0,0,0,0,0,0,0,0,0,0,0,0,0
163025,2021,Netherlands,Italy,0,0,0,0,16/06/2021,0,0,0,0,0,0,0,0,0,0,0,0,0,0,0,0,0,0,0,0
163025,2021,Italy,USA,0,0,0,0,15/06/2021,0,0,0,0,0,0,0,0,0,0,0,0,0,0,0,0,0,0,0,0
163025,2021,Australia,Italy,0,0,0,0,11/6/2021,0,0,0,0,0,0,0,0,0,0,0,0,0,0,0,0,0,0,0,0
163025,2021,Japan,Italy,0,0,0,0,10/6/2021,0,0,0,0,0,0,0,0,0,0,0,0,0,0,0,0,0,0,0,0
163025,2021,Argentina,Italy,0,0,0,0,9/6/2021,0,0,0,0,0,0,0,0,0,0,0,0,0,0,0,0,0,0,0,0
163025,2021,Canada,Italy,0,0,0,0,5/6/2021,0,0,4,4,0,0,0,0,0,0,0,0,4,1,8,13,5,4,1,10
163025,2021,Iran,Italy,0,0,0,0,4/6/2021,0,0,0,0,0,0,0,0,0,0,0,0,0,0,0,0,0,0,0,0
163025,2021,Italy,Bulgaria,0,0,0,0,3/6/2021,0,0,0,0,0,0,0,0,0,0,0,0,0,0,0,0,0,0,0,0
163025,2021,Serbia,Italy,0,0,0,0,30/05/2021,0,0,0,0,0,0,0,0,0,0,0,0,0,0,0,0,0,0,0,0
163025,2021,Italy,Slovenia,0,0,0,0,29/05/2021,0,0,0,0,0,0,0,0,0,0,0,0,0,0,0,0,0,0,0,0
163025,2021,Poland,Italy,0,0,0,0,28/05/2021,0,0,0,0,0,0,0,0,0,0,0,0,0,1,1,2,0,0,0,0
118511,2021,USA,Japan,0,1,0,1,23/06/2021,0,0,0,0,0,0,1,1,0,0,0,0,0,0,0,0,0,0,0,0
118511,2021,Japan,Slovenia,0,1,9,10,22/06/2021,0,0,0,0,12,10,7,29,0,2,0,2,0,0,1,1,1,1,0,2
118511,2021,Japan,Bulgaria,0,1,2,3,21/06/2021,0,0,0,0,1,0,1,2,0,0,0,0,0,0,1,1,0,0,0,0
118511,2021,Japan,Canada,0,2,4,6,17/06/2021,0,0,0,0,10,2,12,24,1,2,2,5,0,0,1,1,5,0,0,5
118511,2021,Japan,Germany,0,1,8,9,15/06/2021,0,0,0,0,11,3,7,21,0,0,2,2,0,0,0,0,1,1,1,3
118511,2021,Japan,Argentina,0,0,3,3,11/6/2021,0,0,0,0,5,0,3,8,0,0,1,1,0,0,0,0,1,1,1,3
118511,2021,Japan,Italy,1,0,2,3,10/6/2021,0,0,1,1,3,2,6,11,1,1,3,5,0,0,0,0,1,0,1,2
118511,2021,Japan,Australia,1,1,16,18,9/6/2021,0,0,1,1,15,4,12,31,1,2,3,6,0,0,0,0,4,2,0,6
118511,2021,France,Japan,1,2,12,15,5/6/2021,1,0,0,1,16,7,13,36,1,5,3,9,0,0,0,0,2,2,1,5
118511,2021,Brazil,Japan,0,1,7,8,4/6/2021,0,0,0,0,8,4,2,14,0,1,0,1,0,0,1,1,1,1,0,2
118511,2021,Japan,Serbia,0,0,7,7,3/6/2021,0,1,1,2,12,3,6,21,1,2,0,3,2,0,1,3,0,3,1,4
118511,2021,Netherlands,Japan,0,0,9,9,29/05/2021,0,0,0,0,7,4,1,12,0,1,1,2,0,1,1,2,0,0,1,1
118511,2021,Japan,Iran,0,0,9,9,28/05/2021,0,0,1,1,3,1,4,8,0,0,0,0,0,0,0,0,0,0,0,0
142565,2021,USA,Japan,0,2,6,8,23/06/2021,0,0,0,0,2,1,6,9,1,3,1,5,1,0,0,1,1,1,0,2
142565,2021,Japan,Slovenia,0,0,0,0,22/06/2021,0,0,0,0,0,0,0,0,0,0,0,0,0,0,0,0,0,0,0,0
142565,2021,Japan,Bulgaria,0,0,6,6,21/06/2021,0,0,0,0,6,1,3,10,2,7,1,10,0,0,1,1,2,1,0,3
142565,2021,Japan,Canada,0,0,9,9,17/06/2021,0,0,0,0,4,0,2,6,0,4,7,11,3,0,0,3,4,1,0,5
142565,2021,Japan,Germany,0,2,7,9,15/06/2021,0,0,0,0,6,1,3,10,2,3,0,5,2,0,0,2,1,0,0,1
142565,2021,Japan,Argentina,0,0,0,0,11/6/2021,0,0,0,0,0,0,0,0,0,0,0,0,0,0,0,0,0,0,0,0
142565,2021,Japan,Italy,0,0,12,12,10/6/2021,0,0,2,2,2,1,4,7,1,4,0,5,2,0,1,3,2,2,0,4
142565,2021,Japan,Australia,0,2,8,10,9/6/2021,0,0,0,0,7,3,6,16,2,4,4,10,0,0,2,2,1,2,0,3
142565,2021,France,Japan,2,4,14,20,5/6/2021,0,0,0,0,8,0,5,13,2,2,0,4,0,0,1,1,1,4,1,6
142565,2021,Japan,Serbia,0,2,12,14,3/6/2021,0,0,1,1,4,0,3,7,3,4,0,7,0,0,0,0,1,0,0,1
142565,2021,Russia,Japan,0,1,0,1,30/05/2021,0,0,0,0,0,0,0,0,0,0,0,0,0,0,0,0,0,0,0,0
142565,2021,Netherlands,Japan,2,1,17,20,29/05/2021,0,0,0,0,6,1,7,14,0,1,1,2,0,0,0,0,2,0,0,2
142565,2021,Japan,Iran,0,1,10,11,28/05/2021,0,0,0,0,4,0,3,7,0,0,1,1,0,0,0,0,1,0,0,1
162104,2021,USA,Japan,0,1,5,6,23/06/2021,9,0,40,49,0,0,0,0,0,0,0,0,0,0,0,0,2,2,0,4
162104,2021,Japan,Argentina,0,0,0,0,11/6/2021,0,0,0,0,0,0,0,0,0,0,0,0,0,0,0,0,0,0,0,0
162104,2021,Japan,Italy,0,1,15,16,10/6/2021,41,1,59,101,1,0,0,1,0,2,0,2,0,0,0,0,5,1,2,8
162104,2021,Japan,Australia,0,2,18,20,9/6/2021,36,0,58,94,0,0,0,0,1,4,0,5,0,0,0,0,7,1,1,9
162104,2021,France,Japan,0,1,10,11,5/6/2021,24,1,68,93,0,0,1,1,0,2,2,4,0,0,1,1,3,3,0,6
162104,2021,Brazil,Japan,0,0,4,4,4/6/2021,16,0,25,41,0,0,0,0,0,0,0,0,0,0,0,0,4,2,1,7
162104,2021,Japan,Serbia,1,0,9,10,3/6/2021,13,0,32,45,1,0,0,1,1,0,0,1,0,0,0,0,4,2,0,6
162104,2021,Netherlands,Japan,0,0,3,3,29/05/2021,8,0,51,59,0,0,0,0,0,0,2,2,0,0,0,0,1,1,0,2
162104,2021,Japan,Iran,0,0,10,10,28/05/2021,3,0,71,74,0,0,1,1,0,0,0,0,0,0,0,0,0,0,1,1
142575,2021,Japan,Poland,0,2,1,3,16/06/2021,0,0,0,0,3,2,4,9,0,0,1,1,0,0,0,0,2,0,1,3
142575,2021,Japan,Argentina,0,4,5,9,11/6/2021,0,0,2,2,15,2,15,32,0,2,3,5,0,0,0,0,8,3,2,13
142575,2021,Japan,Australia,0,0,2,2,9/6/2021,0,0,1,1,2,2,5,9,0,1,4,5,0,0,0,0,2,0,1,3
142575,2021,Brazil,Japan,0,0,0,0,4/6/2021,0,0,0,0,0,0,0,0,0,0,0,0,0,0,0,0,0,0,0,0
142575,2021,Japan,Serbia,1,3,3,7,3/6/2021,0,1,0,1,8,6,5,19,0,2,2,4,0,0,0,0,1,1,1,3
142575,2021,Russia,Japan,1,5,5,11,30/05/2021,0,0,0,0,21,2,6,29,3,0,2,5,0,0,0,0,3,5,2,10
114415,2021,Japan,Slovenia,0,1,0,1,22/06/2021,0,0,0,0,2,1,1,4,0,1,0,1,3,0,5,8,1,0,0,1
114415,2021,Japan,Bulgaria,0,0,0,0,21/06/2021,0,0,0,0,0,0,0,0,0,0,0,0,0,0,0,0,0,0,0,0
114415,2021,Japan,Canada,0,0,0,0,17/06/2021,0,0,0,0,0,0,0,0,0,0,0,0,0,0,0,0,0,0,0,0
114415,2021,Japan,Poland,0,2,0,2,16/06/2021,0,0,1,1,3,2,6,11,0,1,0,1,1,1,5,7,3,0,0,3
114415,2021,Japan,Germany,0,0,0,0,15/06/2021,0,0,0,0,0,0,0,0,0,0,0,0,0,0,0,0,0,0,0,0
114415,2021,Japan,Argentina,0,1,11,12,11/6/2021,0,0,4,4,12,10,10,32,0,2,2,4,6,2,17,25,7,1,0,8
114415,2021,Japan,Italy,0,0,0,0,10/6/2021,0,0,0,0,0,0,0,0,0,0,0,0,0,0,0,0,0,0,0,0
114415,2021,Japan,Australia,0,0,0,0,9/6/2021,0,0,0,0,0,0,0,0,0,0,0,0,0,0,0,0,0,0,0,0
114415,2021,France,Japan,0,0,0,0,5/6/2021,0,0,0,0,0,0,0,0,0,0,0,0,0,0,0,0,0,0,0,0
114415,2021,Brazil,Japan,0,1,2,3,4/6/2021,0,0,0,0,2,2,3,7,0,0,2,2,2,0,6,8,3,0,0,3
114415,2021,Japan,Serbia,0,0,0,0,3/6/2021,0,0,0,0,0,0,0,0,0,0,0,0,0,0,0,0,0,0,0,0
114415,2021,Russia,Japan,0,2,6,8,30/05/2021,0,0,0,0,14,5,9,28,0,2,0,2,6,1,12,19,5,0,2,7
114415,2021,Netherlands,Japan,0,0,0,0,29/05/2021,0,0,0,0,0,0,0,0,0,0,0,0,0,0,0,0,0,0,0,0
114415,2021,Japan,Iran,0,0,0,0,28/05/2021,0,0,0,0,0,0,0,0,0,0,0,0,0,0,0,0,0,0,0,0
146409,2021,USA,Japan,0,0,9,9,23/06/2021,0,0,0,0,5,1,5,11,0,1,0,1,0,0,0,0,2,1,0,3
146409,2021,Japan,Slovenia,0,0,7,7,22/06/2021,0,0,2,2,0,1,2,3,2,2,1,5,1,0,0,1,1,1,0,2
146409,2021,Japan,Bulgaria,1,0,15,16,21/06/2021,0,0,0,0,5,1,2,8,0,3,1,4,0,0,0,0,3,2,0,5
146409,2021,Japan,Canada,0,1,10,11,17/06/2021,0,0,0,0,5,1,2,8,0,6,3,9,1,0,3,4,3,0,0,3
146409,2021,Japan,Poland,0,0,2,2,16/06/2021,0,0,1,1,2,0,2,4,0,1,3,4,0,0,1,1,2,1,0,3
146409,2021,Japan,Germany,1,0,9,10,15/06/2021,0,0,2,2,2,1,2,5,1,0,0,1,0,0,0,0,0,1,0,1
146409,2021,Japan,Argentina,0,1,10,11,11/6/2021,0,0,1,1,9,1,3,13,2,8,1,11,0,0,2,2,1,0,0,1
146409,2021,Japan,Italy,0,0,8,8,10/6/2021,0,0,1,1,3,0,3,6,1,0,2,3,2,0,1,3,2,0,1,3
146409,2021,Japan,Australia,0,0,0,0,9/6/2021,0,0,0,0,0,0,0,0,0,0,0,0,0,0,0,0,0,0,0,0
146409,2021,France,Japan,0,2,9,11,5/6/2021,0,0,1,1,2,1,1,4,0,2,1,3,0,0,0,0,0,0,0,0
146409,2021,Brazil,Japan,1,0,10,11,4/6/2021,0,0,2,2,4,0,4,8,2,3,1,6,0,0,3,3,0,0,1,1
146409,2021,Japan,Serbia,0,2,8,10,3/6/2021,0,0,0,0,6,0,2,8,1,2,0,3,0,0,0,0,2,1,0,3
146409,2021,Russia,Japan,0,0,0,0,30/05/2021,0,0,0,0,0,0,0,0,0,0,0,0,0,0,0,0,0,0,0,0
146409,2021,Netherlands,Japan,0,0,2,2,29/05/2021,0,0,0,0,0,0,1,1,0,0,0,0,0,0,0,0,0,0,0,0
146409,2021,Japan,Iran,0,0,11,11,28/05/2021,0,1,0,1,2,1,5,8,3,2,0,5,0,0,0,0,0,0,0,0
163519,2021,USA,Japan,0,1,8,9,23/06/2021,0,0,0,0,9,5,10,24,1,0,1,2,0,0,0,0,1,0,0,1
163519,2021,Japan,Slovenia,0,1,2,3,22/06/2021,0,0,1,1,5,0,4,9,1,1,1,3,0,0,0,0,0,1,0,1
163519,2021,Japan,Bulgaria,0,3,5,8,21/06/2021,0,0,0,0,20,4,5,29,3,4,2,9,0,0,0,0,4,2,0,6
163519,2021,Japan,Canada,0,1,2,3,17/06/2021,0,0,1,1,0,1,1,2,0,0,0,0,0,0,0,0,2,2,0,4
163519,2021,Japan,Poland,0,2,1,3,16/06/2021,0,0,0,0,2,3,1,6,0,0,0,0,0,0,0,0,2,0,0,2
133009,2021,USA,Japan,0,0,4,4,23/06/2021,3,0,23,26,0,0,0,0,0,0,0,0,0,0,0,0,1,2,0,3
133009,2021,Japan,Slovenia,0,1,1,2,22/06/2021,6,0,25,31,1,0,0,1,0,0,1,1,0,0,0,0,1,2,0,3
133009,2021,Japan,Bulgaria,1,0,6,7,21/06/2021,16,0,50,66,0,0,0,0,0,3,2,5,0,0,0,0,5,1,1,7
133009,2021,Japan,Canada,1,2,11,14,17/06/2021,18,1,57,76,0,0,0,0,0,3,3,6,0,0,1,1,5,1,1,7
133009,2021,Japan,Poland,0,0,2,2,16/06/2021,8,0,11,19,0,0,0,0,0,0,0,0,0,0,1,1,1,0,0,1
133009,2021,Japan,Germany,0,1,15,16,15/06/2021,19,0,47,66,0,0,3,3,1,1,0,2,0,0,0,0,6,3,0,9
133009,2021,Japan,Argentina,1,4,14,19,11/6/2021,37,1,78,116,0,1,0,1,0,3,1,4,0,0,2,2,14,5,1,20
133009,2021,Japan,Italy,0,0,0,0,10/6/2021,5,0,16,21,0,0,0,0,0,0,0,0,0,0,0,0,4,0,0,4
133009,2021,Japan,Australia,0,0,1,1,9/6/2021,5,0,8,13,0,0,0,0,0,0,0,0,0,0,0,0,2,2,0,4
133009,2021,France,Japan,0,0,2,2,5/6/2021,3,0,14,17,0,0,0,0,0,1,0,1,0,0,1,1,0,1,0,1
133009,2021,Japan,Serbia,0,0,5,5,3/6/2021,9,1,41,51,0,0,2,2,0,0,0,0,0,0,0,0,1,1,0,2
133009,2021,Russia,Japan,1,0,11,12,30/05/2021,15,0,64,79,0,0,0,0,0,1,2,3,0,0,1,1,6,2,1,9
133009,2021,Netherlands,Japan,0,3,10,13,29/05/2021,21,0,28,49,0,0,0,0,1,1,1,3,0,0,0,0,1,1,1,3
133009,2021,Japan,Iran,0,1,2,3,28/05/2021,1,0,14,15,0,0,0,0,0,0,0,0,0,0,0,0,0,0,0,0
142570,2021,USA,Japan,0,0,0,0,23/06/2021,0,0,0,0,0,0,0,0,0,0,0,0,0,0,0,0,0,0,0,0
142570,2021,Japan,Slovenia,0,0,3,3,22/06/2021,14,2,32,48,0,0,0,0,0,1,0,1,0,0,0,0,3,1,0,4
142570,2021,Japan,Bulgaria,0,0,0,0,21/06/2021,1,0,6,7,0,0,0,0,0,0,0,0,0,0,0,0,0,0,0,0
142570,2021,Japan,Canada,0,0,0,0,17/06/2021,0,0,0,0,0,0,0,0,0,0,0,0,0,0,0,0,0,0,0,0
142570,2021,Japan,Poland,0,2,5,7,16/06/2021,20,1,29,50,0,0,0,0,0,1,4,5,0,0,0,0,3,2,1,6
142570,2021,Japan,Germany,0,0,0,0,15/06/2021,0,0,0,0,0,0,0,0,0,0,0,0,0,0,0,0,0,0,0,0
142570,2021,Brazil,Japan,0,1,1,2,4/6/2021,8,0,14,22,0,0,0,0,0,1,0,1,0,0,0,0,2,1,0,3
142570,2021,Russia,Japan,0,1,11,12,30/05/2021,17,0,37,54,0,1,0,1,0,2,1,3,0,0,0,0,2,1,1,4
142568,2021,USA,Japan,1,4,8,13,23/06/2021,0,0,2,2,12,3,11,26,1,1,0,2,6,0,8,14,3,3,0,6
142568,2021,Japan,Slovenia,0,0,3,3,22/06/2021,0,0,0,0,1,1,3,5,0,0,0,0,4,0,1,5,1,0,0,1
142568,2021,Japan,Bulgaria,0,1,13,14,21/06/2021,0,0,8,8,11,2,5,18,1,2,6,9,8,0,10,18,10,0,1,11
142568,2021,Japan,Canada,0,3,7,10,17/06/2021,0,0,6,6,11,3,12,26,1,4,2,7,5,1,13,19,5,4,2,11
142568,2021,Japan,Poland,0,0,0,0,16/06/2021,0,0,0,0,0,0,0,0,0,0,0,0,0,0,0,0,0,0,0,0
142568,2021,Japan,Germany,3,4,12,19,15/06/2021,0,0,3,3,17,1,5,23,0,2,0,2,8,1,9,18,5,5,0,10
142568,2021,Japan,Argentina,0,0,0,0,11/6/2021,0,0,0,0,0,0,0,0,0,0,0,0,0,0,0,0,0,0,0,0
142568,2021,Japan,Italy,0,4,12,16,10/6/2021,0,0,3,3,19,6,16,41,2,8,4,14,12,1,20,33,12,4,2,18
142568,2021,Japan,Australia,2,3,15,20,9/6/2021,1,0,6,7,20,2,9,31,0,4,6,10,11,0,17,28,12,1,1,14
142568,2021,France,Japan,2,4,14,20,5/6/2021,1,0,4,5,22,1,10,33,1,2,1,4,16,3,9,28,1,2,1,4
142568,2021,Brazil,Japan,0,2,5,7,4/6/2021,0,0,3,3,6,0,5,11,1,3,1,5,5,0,13,18,4,1,0,5
142568,2021,Russia,Japan,0,0,0,0,30/05/2021,0,0,0,0,0,0,0,0,0,0,0,0,0,0,0,0,0,0,0,0
142568,2021,Netherlands,Japan,0,4,15,19,29/05/2021,0,0,0,0,15,2,8,25,2,4,1,7,12,0,13,25,4,1,0,5
142568,2021,Japan,Iran,1,3,8,12,28/05/2021,0,0,0,0,15,7,9,31,2,0,0,2,8,1,4,13,0,0,0,0
146410,2021,USA,Japan,0,0,2,2,23/06/2021,0,0,1,1,0,0,0,0,0,0,0,0,0,0,0,0,0,0,0,0
146410,2021,Japan,Slovenia,1,0,11,12,22/06/2021,0,0,0,0,1,2,4,7,0,4,1,5,0,0,0,0,3,2,0,5
146410,2021,Japan,Bulgaria,0,0,0,0,21/06/2021,0,0,0,0,0,0,0,0,0,0,0,0,0,0,0,0,0,0,0,0
146410,2021,Japan,Canada,0,0,0,0,17/06/2021,0,0,0,0,0,0,0,0,0,0,0,0,0,0,0,0,0,0,0,0
146410,2021,Japan,Poland,0,1,7,8,16/06/2021,0,0,1,1,3,0,2,5,0,1,3,4,0,1,0,1,1,2,0,3
146410,2021,Japan,Germany,0,0,0,0,15/06/2021,0,0,0,0,0,0,0,0,0,0,0,0,0,0,0,0,0,0,0,0
146410,2021,Japan,Argentina,0,2,15,17,11/6/2021,0,0,0,0,2,0,3,5,0,6,3,9,1,0,0,1,4,1,1,6
146410,2021,Japan,Italy,1,2,16,19,10/6/2021,0,0,0,0,9,0,2,11,0,3,16,19,1,0,1,2,7,0,1,8
146410,2021,Japan,Australia,1,2,12,15,9/6/2021,0,0,0,0,7,1,2,10,3,3,3,9,2,0,0,2,3,0,0,3
146410,2021,France,Japan,0,0,1,1,5/6/2021,0,0,0,0,0,0,0,0,0,0,0,0,0,0,0,0,0,1,0,1
146410,2021,Brazil,Japan,0,1,7,8,4/6/2021,0,0,0,0,0,1,5,6,3,1,7,11,0,0,1,1,1,1,0,2
146410,2021,Japan,Serbia,0,0,0,0,3/6/2021,0,0,0,0,0,0,0,0,0,0,0,0,0,0,0,0,0,0,0,0
146410,2021,Russia,Japan,1,1,17,19,30/05/2021,0,0,0,0,8,2,0,10,2,5,2,9,0,1,0,1,6,1,0,7
146410,2021,Netherlands,Japan,0,0,0,0,29/05/2021,0,0,0,0,0,0,0,0,0,0,0,0,0,0,0,0,0,0,0,0
146410,2021,Japan,Iran,0,0,0,0,28/05/2021,0,0,0,0,0,0,0,0,0,0,0,0,0,0,0,0,0,0,0,0
142561,2021,Japan,Poland,0,4,0,4,16/06/2021,0,0,0,0,4,0,1,5,0,4,1,5,0,0,0,0,0,0,0,0
142561,2021,Japan,Germany,0,0,0,0,15/06/2021,0,0,0,0,0,0,0,0,0,0,0,0,0,0,0,0,0,0,0,0
142561,2021,Japan,Argentina,0,1,2,3,11/6/2021,0,0,1,1,1,1,3,5,0,0,0,0,0,0,0,0,0,0,0,0
142561,2021,Japan,Italy,0,2,0,2,10/6/2021,0,0,0,0,2,0,1,3,0,2,1,3,0,0,0,0,0,0,1,1
142561,2021,France,Japan,0,2,4,6,5/6/2021,0,0,2,2,3,1,2,6,2,3,0,5,0,0,0,0,0,1,0,1
142561,2021,Brazil,Japan,0,0,0,0,4/6/2021,0,0,0,0,0,0,0,0,0,0,0,0,0,0,0,0,0,0,0,0
142561,2021,Japan,Serbia,0,0,3,3,3/6/2021,0,0,0,0,1,0,2,3,0,1,0,1,0,0,1,1,0,1,0,1
142561,2021,Russia,Japan,0,4,8,12,30/05/2021,0,0,0,0,8,2,4,14,2,0,2,4,0,0,1,1,1,1,0,2
142561,2021,Netherlands,Japan,0,5,6,11,29/05/2021,0,0,0,0,6,0,1,7,2,1,0,3,0,0,0,0,0,0,0,0
142561,2021,Japan,Iran,0,0,0,0,28/05/2021,0,0,0,0,0,0,0,0,0,0,0,0,0,0,0,0,0,0,0,0
153365,2021,USA,Japan,0,0,0,0,23/06/2021,0,0,0,0,0,0,0,0,0,0,0,0,0,0,0,0,0,0,0,0
153365,2021,Japan,Slovenia,1,1,7,9,22/06/2021,0,0,3,3,11,3,2,16,1,0,0,1,8,2,13,23,2,1,0,3
153365,2021,Japan,Bulgaria,0,0,0,0,21/06/2021,0,0,0,0,0,0,0,0,0,1,0,1,0,0,1,1,0,0,0,0
153365,2021,Japan,Canada,0,0,3,3,17/06/2021,0,0,2,2,4,1,3,8,0,2,0,2,0,2,5,7,0,2,0,2
153365,2021,Japan,Poland,0,4,9,13,16/06/2021,0,0,4,4,10,3,3,16,0,0,0,0,3,2,16,21,4,2,1,7
153365,2021,Japan,Germany,0,0,0,0,15/06/2021,0,0,0,0,0,1,0,1,1,0,0,1,0,0,0,0,0,0,0,0
153365,2021,Japan,Italy,0,0,0,0,10/6/2021,0,0,0,0,0,1,0,1,0,0,0,0,1,0,0,1,0,0,0,0
153365,2021,Japan,Australia,0,1,3,4,9/6/2021,0,0,1,1,2,1,3,6,0,1,1,2,3,0,2,5,3,2,0,5
153365,2021,France,Japan,0,2,7,9,5/6/2021,0,0,0,0,8,4,4,16,0,0,2,2,6,1,13,20,0,2,0,2
153365,2021,Brazil,Japan,0,4,6,10,4/6/2021,0,0,2,2,9,2,10,21,0,2,1,3,3,1,11,15,3,2,1,6
153365,2021,Japan,Serbia,0,1,14,15,3/6/2021,0,0,4,4,12,6,8,26,0,1,0,1,14,0,7,21,5,4,0,9
153365,2021,Russia,Japan,0,2,17,19,30/05/2021,0,0,0,0,17,4,13,34,0,1,1,2,10,4,19,33,8,12,0,20
153365,2021,Netherlands,Japan,0,1,0,1,29/05/2021,0,0,0,0,0,0,1,1,0,0,1,1,0,0,0,0,0,0,0,0
153365,2021,Japan,Iran,0,0,0,0,28/05/2021,0,0,0,0,0,0,0,0,0,0,0,0,0,0,0,0,0,0,0,0
163516,2021,USA,Japan,0,0,0,0,23/06/2021,0,0,0,0,0,0,0,0,0,0,0,0,0,0,0,0,0,0,0,0
163516,2021,Japan,Slovenia,0,2,7,9,22/06/2021,0,0,0,0,5,1,8,14,0,1,0,1,2,1,13,16,4,2,0,6
163516,2021,Japan,Bulgaria,0,0,0,0,21/06/2021,0,0,0,0,0,0,0,0,0,0,0,0,0,0,0,0,0,0,0,0
163516,2021,Japan,Canada,0,0,1,1,17/06/2021,0,0,0,0,2,0,0,2,0,0,0,0,0,0,0,0,1,0,0,1
163516,2021,Japan,Poland,0,2,6,8,16/06/2021,0,0,0,0,7,4,12,23,0,2,1,3,1,0,7,8,1,1,0,2
163516,2021,Japan,Germany,0,0,0,0,15/06/2021,0,0,0,0,0,0,0,0,0,0,0,0,0,0,0,0,0,0,0,0
163516,2021,Japan,Argentina,0,2,12,14,11/6/2021,0,0,5,5,10,6,24,40,4,0,0,4,8,2,12,22,7,2,2,11
163516,2021,Japan,Italy,1,3,9,13,10/6/2021,0,0,4,4,15,3,16,34,1,1,8,10,0,0,3,3,6,3,0,9
163516,2021,Japan,Australia,0,0,0,0,9/6/2021,0,0,0,0,0,0,0,0,0,0,1,1,0,0,0,0,0,0,0,0
163516,2021,France,Japan,0,0,2,2,5/6/2021,0,0,0,0,0,1,2,3,0,0,0,0,0,0,0,0,1,0,0,1
163516,2021,Brazil,Japan,1,1,3,5,4/6/2021,0,0,0,0,2,0,5,7,0,0,0,0,0,0,2,2,0,1,0,1
163516,2021,Japan,Serbia,0,0,4,4,3/6/2021,0,0,0,0,4,2,7,13,1,1,0,2,5,0,11,16,1,2,0,3
163516,2021,Russia,Japan,0,2,11,13,30/05/2021,0,0,0,0,6,5,14,25,0,4,1,5,2,1,3,6,3,4,0,7
163516,2021,Netherlands,Japan,0,2,6,8,29/05/2021,0,0,0,0,7,1,4,12,0,2,0,2,0,0,0,0,1,0,0,1
163516,2021,Japan,Iran,0,0,5,5,28/05/2021,0,0,1,1,8,0,5,13,0,1,0,1,0,0,0,0,0,0,0,0
172893,2021,USA,Japan,0,0,0,0,23/06/2021,0,0,3,3,0,0,0,0,0,0,0,0,8,1,11,20,11,5,0,16
172893,2021,Japan,Slovenia,0,0,0,0,22/06/2021,0,0,2,2,0,0,0,0,0,0,0,0,0,1,2,3,0,2,0,2
172893,2021,Japan,Bulgaria,0,0,0,0,21/06/2021,0,0,2,2,0,0,0,0,0,0,0,0,6,0,8,14,10,2,2,14
172893,2021,Japan,Canada,0,0,0,0,17/06/2021,0,0,4,4,0,0,0,0,0,0,0,0,2,2,6,10,6,3,1,10
172893,2021,Japan,Poland,0,0,0,0,16/06/2021,0,0,0,0,0,0,0,0,0,0,0,0,0,0,0,0,0,0,0,0
172893,2021,Japan,Germany,0,0,0,0,15/06/2021,0,0,5,5,0,0,0,0,0,0,0,0,7,0,2,9,8,1,0,9
172893,2021,Japan,Argentina,0,0,0,0,11/6/2021,0,0,0,0,0,0,0,0,0,0,0,0,1,0,0,1,0,0,0,0
172893,2021,Japan,Italy,0,0,0,0,10/6/2021,0,0,8,8,0,0,0,0,0,0,0,0,5,1,11,17,15,6,1,22
172893,2021,Japan,Australia,0,0,0,0,9/6/2021,0,0,2,2,0,0,0,0,0,0,0,0,16,0,12,28,15,5,3,23
172893,2021,France,Japan,0,0,0,0,5/6/2021,0,0,2,2,0,0,0,0,0,0,0,0,12,2,8,22,8,3,0,11
172893,2021,Brazil,Japan,0,0,0,0,4/6/2021,0,0,1,1,0,0,0,0,0,0,0,0,3,1,2,6,1,1,0,2
172893,2021,Japan,Serbia,0,0,0,0,3/6/2021,0,0,3,3,0,0,0,0,0,0,0,0,7,1,8,16,11,5,0,16
172893,2021,Russia,Japan,0,0,0,0,30/05/2021,0,0,0,0,0,0,0,0,0,0,0,0,0,0,0,0,0,0,0,0
172893,2021,Netherlands,Japan,0,0,0,0,29/05/2021,0,0,0,0,0,0,0,0,0,0,0,0,13,3,10,26,7,3,2,12
172893,2021,Japan,Iran,0,0,0,0,28/05/2021,0,0,2,2,0,0,0,0,0,0,0,0,9,0,9,18,8,0,0,8
178762,2021,USA,Japan,1,4,9,14,23/06/2021,0,0,3,3,7,2,8,17,0,2,1,3,9,1,10,20,2,3,1,6
178762,2021,Japan,Slovenia,0,0,0,0,22/06/2021,0,0,0,0,0,0,0,0,0,0,0,0,0,0,0,0,0,0,0,0
178762,2021,Japan,Bulgaria,1,2,16,19,21/06/2021,0,0,1,1,7,4,7,18,0,0,1,1,1,2,10,13,4,2,0,6
178762,2021,Japan,Canada,0,1,6,7,17/06/2021,0,0,1,1,6,4,2,12,0,3,0,3,1,2,15,18,6,0,0,6
178762,2021,Japan,Poland,0,0,0,0,16/06/2021,0,0,0,0,0,0,0,0,0,0,0,0,0,0,0,0,0,0,0,0
178762,2021,Japan,Germany,0,2,9,11,15/06/2021,0,0,1,1,10,2,8,20,0,1,1,2,8,1,6,15,8,5,0,13
178762,2021,Japan,Argentina,0,0,0,0,11/6/2021,0,0,0,0,0,0,0,0,0,0,0,0,0,0,0,0,0,0,0,0
178762,2021,Japan,Italy,3,2,14,19,10/6/2021,0,0,4,4,16,4,12,32,0,3,1,4,8,1,11,20,11,2,3,16
178762,2021,Japan,Australia,1,2,6,9,9/6/2021,1,0,5,6,11,6,6,23,1,3,0,4,6,1,7,14,4,0,1,5
178762,2021,France,Japan,0,2,7,9,5/6/2021,0,0,4,4,4,3,3,10,1,3,1,5,9,0,8,17,4,4,0,8
178762,2021,Brazil,Japan,0,0,0,0,4/6/2021,0,0,0,0,0,0,0,0,0,0,0,0,0,0,0,0,0,0,0,0
178762,2021,Japan,Serbia,0,3,6,9,3/6/2021,0,0,5,5,6,3,6,15,0,0,0,0,9,0,11,20,3,4,0,7
178762,2021,Russia,Japan,0,3,4,7,30/05/2021,0,0,0,0,1,0,1,2,0,0,0,0,0,0,5,5,2,0,0,2
178762,2021,Netherlands,Japan,0,6,17,23,29/05/2021,0,0,0,0,25,3,10,38,1,1,0,2,13,0,11,24,3,2,0,5
178762,2021,Japan,Iran,1,2,11,14,28/05/2021,0,0,0,0,13,4,9,26,2,0,1,3,8,0,11,19,1,0,0,1
180990,2021,USA,Japan,0,0,0,0,23/06/2021,0,0,0,0,0,0,0,0,0,0,0,0,0,0,0,0,0,0,0,0
180990,2021,Japan,Slovenia,0,0,0,0,22/06/2021,0,0,3,3,0,0,0,0,0,0,0,0,6,1,4,11,4,1,0,5
180990,2021,Japan,Bulgaria,0,0,0,0,21/06/2021,0,0,0,0,0,0,0,0,0,0,0,0,0,0,0,0,0,0,0,0
180990,2021,Japan,Canada,0,0,0,0,17/06/2021,0,0,0,0,0,0,0,0,0,0,0,0,0,0,0,0,0,0,0,0
180990,2021,Japan,Poland,0,0,0,0,16/06/2021,0,0,5,5,0,0,0,0,0,0,0,0,9,2,10,21,11,3,3,17
180990,2021,Japan,Germany,0,0,0,0,15/06/2021,0,0,0,0,0,0,0,0,0,0,0,0,0,0,0,0,0,0,0,0
180990,2021,Japan,Argentina,0,0,0,0,11/6/2021,0,0,8,8,0,0,0,0,0,0,0,0,9,2,26,37,12,7,1,20
180990,2021,Japan,Italy,0,0,0,0,10/6/2021,0,0,0,0,0,0,0,0,0,0,0,0,0,0,0,0,0,0,0,0
180990,2021,Japan,Australia,0,0,0,0,9/6/2021,0,0,0,0,0,0,0,0,0,0,0,0,0,0,0,0,0,0,0,0
180990,2021,France,Japan,0,0,0,0,5/6/2021,0,0,0,0,0,0,0,0,0,0,0,0,0,0,0,0,0,0,0,0
180990,2021,Brazil,Japan,0,0,0,0,4/6/2021,0,0,1,1,0,0,0,0,0,0,0,0,1,5,4,10,3,2,1,6
180990,2021,Japan,Serbia,0,0,0,0,3/6/2021,0,0,0,0,0,0,0,0,0,0,0,0,0,0,0,0,0,0,0,0
180990,2021,Russia,Japan,0,0,0,0,30/05/2021,0,0,4,4,0,0,0,0,0,0,0,0,9,0,22,31,16,7,1,24
180990,2021,Netherlands,Japan,0,0,0,0,29/05/2021,0,0,0,0,0,0,0,0,0,0,0,0,0,0,0,0,0,0,0,0
180990,2021,Japan,Iran,0,0,0,0,28/05/2021,0,0,0,0,0,0,0,0,0,0,0,0,0,0,0,0,0,0,0,0
141546,2021,Australia,Netherlands,0,0,2,2,23/06/2021,0,0,2,2,0,0,0,0,0,0,0,0,0,0,0,0,0,2,0,2
141546,2021,Serbia,Netherlands,0,1,13,14,22/06/2021,18,0,60,78,1,0,2,3,4,3,0,7,0,0,0,0,4,2,0,6
141546,2021,Canada,Netherlands,0,0,2,2,21/06/2021,15,0,25,40,0,0,1,1,0,1,0,1,0,0,0,0,3,0,0,3
141546,2021,Netherlands,USA,2,0,17,19,17/06/2021,21,0,73,94,1,0,0,1,0,2,3,5,0,0,0,0,11,1,1,13
141546,2021,Netherlands,Italy,0,1,6,7,16/06/2021,14,0,38,52,0,0,0,0,0,1,1,2,0,0,0,0,5,2,2,9
141546,2021,Netherlands,Bulgaria,0,0,0,0,11/6/2021,2,0,4,6,0,0,0,0,0,0,0,0,0,0,0,0,0,0,0,0
141546,2021,Poland,Netherlands,0,1,1,2,10/6/2021,1,0,14,15,0,0,2,2,0,0,0,0,0,0,0,0,1,2,0,3
141546,2021,Netherlands,Argentina,0,0,9,9,5/6/2021,13,0,59,72,1,0,0,1,0,1,1,2,0,0,0,0,1,3,0,4
141546,2021,Netherlands,Germany,0,0,20,20,4/6/2021,28,0,82,110,0,0,1,1,0,4,1,5,0,0,0,0,8,1,1,10
141546,2021,Netherlands,Slovenia,0,0,6,6,3/6/2021,7,0,45,52,0,0,1,1,1,3,0,4,0,1,1,2,4,1,0,5
137345,2021,Australia,Netherlands,0,0,0,0,23/06/2021,0,0,0,0,0,0,0,0,0,0,0,0,0,0,0,0,0,0,0,0
137345,2021,Serbia,Netherlands,2,4,13,19,22/06/2021,0,0,5,5,15,3,7,25,0,4,1,5,5,1,16,22,4,4,0,8
137345,2021,Canada,Netherlands,0,2,5,7,21/06/2021,0,0,1,1,8,5,10,23,0,3,1,4,2,2,3,7,5,3,1,9
137345,2021,Netherlands,USA,0,4,7,11,17/06/2021,0,0,1,1,17,7,16,40,1,4,1,6,11,4,23,38,8,5,0,13
137345,2021,Netherlands,Italy,0,3,3,6,16/06/2021,0,0,4,4,11,2,11,24,1,2,3,6,1,2,10,13,0,1,0,1
137345,2021,Netherlands,France,0,0,0,0,15/06/2021,0,0,0,0,0,1,1,2,0,0,0,0,0,0,3,3,0,0,0,0
137345,2021,Netherlands,Brazil,0,0,0,0,9/6/2021,0,0,0,0,0,0,0,0,0,0,0,0,0,0,0,0,0,0,0,0
137345,2021,Netherlands,Argentina,0,1,3,4,5/6/2021,0,0,0,0,4,1,4,9,0,1,0,1,4,0,5,9,0,0,0,0
137345,2021,Netherlands,Germany,1,5,8,14,4/6/2021,0,0,2,2,24,4,8,36,1,3,0,4,5,2,12,19,5,1,0,6
137345,2021,Netherlands,Japan,0,3,7,10,29/05/2021,0,0,0,0,17,3,6,26,1,1,1,3,8,1,14,23,2,3,0,5
137345,2021,Netherlands,Russia,0,1,1,2,28/05/2021,0,0,0,0,3,0,1,4,1,0,1,2,0,0,3,3,1,0,1,2
169921,2021,Australia,Netherlands,0,0,0,0,23/06/2021,0,0,0,0,0,0,0,0,0,0,0,0,0,0,0,0,0,0,0,0
169921,2021,Serbia,Netherlands,1,1,10,12,22/06/2021,0,0,1,1,7,0,3,10,2,4,4,10,0,0,0,0,2,2,2,6
169921,2021,Netherlands,USA,0,2,8,10,17/06/2021,0,0,1,1,2,0,4,6,0,4,5,9,0,1,0,1,2,0,0,2
169921,2021,Netherlands,Italy,0,0,0,0,16/06/2021,0,0,0,0,0,0,0,0,0,0,0,0,0,0,0,0,0,0,0,0
169921,2021,Netherlands,Bulgaria,0,1,6,7,11/6/2021,0,0,0,0,3,0,0,3,0,3,4,7,0,0,1,1,1,2,0,3
169921,2021,Poland,Netherlands,0,0,0,0,10/6/2021,0,0,0,0,0,0,0,0,0,0,0,0,0,0,0,0,0,0,0,0
169921,2021,Netherlands,Brazil,0,1,5,6,9/6/2021,0,0,0,0,4,0,2,6,2,3,3,8,0,0,0,0,1,0,1,2
169921,2021,Netherlands,Germany,0,0,0,0,4/6/2021,0,0,0,0,0,0,0,0,0,0,0,0,0,0,0,0,0,0,0,0
169921,2021,Netherlands,Slovenia,0,2,1,3,3/6/2021,0,0,0,0,1,0,2,3,0,3,0,3,0,0,0,0,0,0,0,0
169921,2021,Netherlands,Japan,0,0,0,0,29/05/2021,0,0,0,0,0,0,0,0,0,0,0,0,0,0,0,0,0,0,0,0
169921,2021,Netherlands,Russia,0,2,11,13,28/05/2021,0,0,0,0,1,0,3,4,2,9,6,17,0,0,0,0,3,1,0,4
156591,2021,Australia,Netherlands,0,0,0,0,23/06/2021,0,0,5,5,0,0,0,0,0,0,0,0,8,0,5,13,6,1,0,7
156591,2021,Serbia,Netherlands,0,0,0,0,22/06/2021,0,0,3,3,0,0,0,0,0,0,0,0,11,6,15,32,13,5,0,18
156591,2021,Canada,Netherlands,0,0,0,0,21/06/2021,0,0,2,2,0,0,0,0,0,0,0,0,0,0,8,8,2,1,0,3
156591,2021,Netherlands,USA,0,0,0,0,17/06/2021,0,0,0,0,0,0,0,0,0,0,0,0,0,0,0,0,0,0,0,0
156591,2021,Netherlands,Italy,0,0,0,0,16/06/2021,0,0,10,10,0,0,0,0,0,0,0,0,9,2,12,23,13,7,3,23
156591,2021,Netherlands,France,0,0,0,0,15/06/2021,0,0,0,0,0,0,0,0,0,0,0,0,0,0,0,0,0,0,0,0
156591,2021,Netherlands,Bulgaria,0,0,0,0,11/6/2021,0,0,4,4,0,0,0,0,0,0,0,0,11,4,16,31,12,3,1,16
156591,2021,Poland,Netherlands,0,0,0,0,10/6/2021,0,0,0,0,0,0,0,0,0,0,0,0,0,0,0,0,0,0,0,0
156591,2021,Netherlands,Brazil,0,0,0,0,9/6/2021,0,0,6,6,0,0,0,0,0,0,0,0,4,1,12,17,9,2,0,11
156591,2021,Netherlands,Argentina,0,0,0,0,5/6/2021,0,0,4,4,0,0,0,0,0,0,0,0,5,0,9,14,5,2,1,8
156591,2021,Netherlands,Germany,0,0,0,0,4/6/2021,0,0,5,5,0,0,0,0,0,0,0,0,21,2,15,38,10,6,0,16
156591,2021,Netherlands,Slovenia,0,0,0,0,3/6/2021,0,0,10,10,0,0,0,0,0,0,0,0,7,4,11,22,5,1,0,6
156591,2021,Netherlands,Iran,0,0,0,0,30/05/2021,0,0,0,0,0,0,0,0,0,0,0,0,0,0,0,0,0,0,0,0
156591,2021,Netherlands,Japan,0,0,0,0,29/05/2021,0,0,3,3,0,0,0,0,0,0,0,0,10,0,19,29,6,4,0,10
156591,2021,Netherlands,Russia,0,0,0,0,28/05/2021,0,0,3,3,0,0,0,0,0,0,0,0,8,5,21,34,9,4,0,13
131980,2021,Netherlands,Argentina,0,1,5,6,5/6/2021,0,0,0,0,0,2,4,6,0,0,1,1,5,1,6,12,1,5,0,6
131980,2021,Netherlands,Germany,0,1,5,6,4/6/2021,0,0,0,0,0,0,0,0,0,0,0,0,1,0,0,1,1,0,0,1
131980,2021,Netherlands,Slovenia,0,0,1,1,3/6/2021,0,0,0,0,0,1,1,2,0,0,0,0,0,0,2,2,0,0,0,0
131980,2021,Netherlands,Iran,0,2,7,9,30/05/2021,0,0,0,0,2,2,7,11,0,2,2,4,4,3,15,22,5,4,0,9
131980,2021,Netherlands,Japan,0,1,6,7,29/05/2021,0,0,0,0,1,0,1,2,0,0,0,0,3,0,5,8,2,1,0,3
131980,2021,Netherlands,Russia,0,0,1,1,28/05/2021,0,0,0,0,0,0,0,0,0,0,0,0,0,0,0,0,0,2,0,2
156678,2021,Australia,Netherlands,0,0,1,1,23/06/2021,0,0,0,0,2,1,1,4,0,1,0,1,0,0,0,0,0,0,0,0
156678,2021,Serbia,Netherlands,1,0,4,5,22/06/2021,0,0,1,1,1,0,1,2,0,1,1,2,0,0,0,0,2,1,0,3
156678,2021,Canada,Netherlands,0,0,9,9,21/06/2021,0,0,0,0,1,1,1,3,0,4,2,6,0,0,1,1,3,1,0,4
156678,2021,Netherlands,USA,0,0,1,1,17/06/2021,0,0,0,0,0,0,0,0,0,0,0,0,0,0,0,0,0,0,0,0
156678,2021,Netherlands,Italy,0,0,16,16,16/06/2021,0,0,2,2,11,2,3,16,3,5,4,12,0,0,1,1,3,2,0,5
156678,2021,Netherlands,France,0,0,0,0,15/06/2021,0,0,0,0,0,0,0,0,0,1,0,1,0,0,0,0,0,0,0,0
156678,2021,Netherlands,Bulgaria,0,2,11,13,11/6/2021,0,0,0,0,12,0,1,13,1,6,1,8,0,0,1,1,3,0,0,3
156678,2021,Poland,Netherlands,0,2,4,6,10/6/2021,0,0,0,0,1,2,2,5,1,2,0,3,0,0,0,0,1,0,0,1
156678,2021,Netherlands,Brazil,0,0,1,1,9/6/2021,0,0,0,0,0,0,0,0,0,0,0,0,0,0,1,1,0,0,0,0
156678,2021,Netherlands,Argentina,0,3,6,9,5/6/2021,0,0,0,0,5,2,5,12,2,3,0,5,0,0,0,0,2,0,0,2
156678,2021,Netherlands,Slovenia,0,3,4,7,3/6/2021,0,0,1,1,2,0,6,8,0,2,4,6,0,0,1,1,2,0,0,2
156678,2021,Netherlands,Iran,0,0,0,0,30/05/2021,0,0,0,0,0,0,0,0,0,0,0,0,0,0,0,0,0,0,0,0
156678,2021,Netherlands,Japan,1,2,16,19,29/05/2021,0,0,0,0,11,2,3,16,2,3,1,6,1,0,1,2,2,2,0,4
176493,2021,Serbia,Netherlands,0,0,0,0,22/06/2021,0,0,0,0,1,0,0,1,0,0,0,0,0,0,0,0,0,0,0,0
176493,2021,Canada,Netherlands,0,1,2,3,21/06/2021,0,0,0,0,0,0,0,0,0,0,0,0,1,0,1,2,1,0,0,1
176493,2021,Netherlands,USA,0,0,0,0,17/06/2021,0,0,0,0,0,0,0,0,0,0,0,0,0,0,0,0,0,0,0,0
176493,2021,Netherlands,France,0,2,17,19,15/06/2021,0,0,0,0,3,1,3,7,0,2,6,8,0,0,3,3,0,1,2,3
176493,2021,Netherlands,Bulgaria,0,0,0,0,11/6/2021,0,0,0,0,0,0,0,0,0,0,0,0,0,0,0,0,0,0,0,0
176493,2021,Poland,Netherlands,1,1,1,3,10/6/2021,0,0,1,1,0,0,1,1,1,1,1,3,0,0,0,0,1,0,0,1
176493,2021,Netherlands,Brazil,0,0,0,0,9/6/2021,0,0,0,0,0,0,0,0,0,0,0,0,0,0,0,0,0,0,0,0
176493,2021,Netherlands,Argentina,0,0,6,6,5/6/2021,0,0,0,0,3,0,4,7,3,0,3,6,0,0,0,0,0,0,0,0
176493,2021,Netherlands,Germany,0,0,0,0,4/6/2021,0,0,0,0,0,0,0,0,0,0,0,0,0,0,0,0,0,0,0,0
176493,2021,Netherlands,Slovenia,0,0,0,0,3/6/2021,0,0,0,0,0,0,0,0,0,0,0,0,0,0,0,0,0,0,0,0
176493,2021,Netherlands,Iran,0,3,8,11,30/05/2021,0,0,0,0,5,1,4,10,0,2,3,5,0,0,0,0,1,0,0,1
176493,2021,Netherlands,Russia,0,1,0,1,28/05/2021,0,0,0,0,0,0,0,0,0,0,0,0,0,0,0,0,0,0,0,0
170436,2021,Australia,Netherlands,3,3,15,21,23/06/2021,0,0,2,2,12,2,4,18,0,2,0,2,10,1,8,19,3,2,0,5
170436,2021,Serbia,Netherlands,0,2,8,10,22/06/2021,0,1,1,2,8,3,8,19,1,1,0,2,9,2,11,22,2,2,1,5
170436,2021,Canada,Netherlands,0,2,8,10,21/06/2021,0,0,3,3,7,6,14,27,0,2,0,2,8,1,12,21,2,1,1,4
170436,2021,Netherlands,Italy,2,3,14,19,16/06/2021,0,0,2,2,8,4,10,22,1,1,2,4,11,3,18,32,5,4,1,10
170436,2021,Netherlands,France,0,1,16,17,15/06/2021,0,1,5,6,13,5,17,35,1,2,6,9,3,3,30,36,7,0,2,9
170436,2021,Netherlands,Bulgaria,1,6,10,17,11/6/2021,0,0,5,5,12,4,9,25,0,2,1,3,4,1,25,30,4,3,1,8
170436,2021,Poland,Netherlands,0,3,3,6,10/6/2021,0,0,3,3,3,2,11,16,0,1,2,3,4,2,17,23,4,2,1,7
170436,2021,Netherlands,Brazil,0,3,9,12,9/6/2021,0,0,1,1,12,4,12,28,1,3,0,4,4,2,17,23,4,2,1,7
170436,2021,Netherlands,Argentina,2,2,4,8,5/6/2021,0,0,1,1,5,2,12,19,1,0,0,1,10,1,10,21,4,2,0,6
170436,2021,Netherlands,Germany,1,3,15,19,4/6/2021,0,0,3,3,12,6,10,28,0,3,1,4,7,1,10,18,7,0,0,7
170436,2021,Netherlands,Slovenia,0,3,4,7,3/6/2021,0,0,0,0,4,1,4,9,0,1,0,1,2,0,11,13,0,1,0,1
170436,2021,Netherlands,Iran,2,3,14,19,30/05/2021,0,0,0,0,8,5,9,22,0,5,1,6,3,0,12,15,3,2,0,5
170436,2021,Netherlands,Japan,0,1,0,1,29/05/2021,0,0,0,0,2,1,2,5,0,0,0,0,0,0,0,0,0,0,0,0
170436,2021,Netherlands,Russia,0,2,12,14,28/05/2021,0,0,1,1,12,1,10,23,1,4,0,5,4,2,14,20,2,1,1,4
176460,2021,Australia,Netherlands,0,0,0,0,23/06/2021,0,0,0,0,0,0,0,0,0,0,0,0,0,0,0,0,0,0,0,0
176460,2021,Serbia,Netherlands,0,0,0,0,22/06/2021,0,0,0,0,0,0,0,0,0,0,0,0,0,0,0,0,0,0,0,0
176460,2021,Canada,Netherlands,0,0,0,0,21/06/2021,0,0,1,1,0,0,0,0,0,0,0,0,1,2,4,7,2,5,0,7
176460,2021,Netherlands,USA,0,0,0,0,17/06/2021,0,0,6,6,0,0,0,0,0,0,0,0,5,4,21,30,5,5,0,10
176460,2021,Netherlands,Italy,0,0,0,0,16/06/2021,0,0,0,0,0,0,0,0,0,0,0,0,0,0,0,0,0,0,0,0
176460,2021,Netherlands,France,0,0,0,0,15/06/2021,0,0,4,4,0,0,0,0,0,0,0,0,3,1,14,18,11,2,2,15
176460,2021,Netherlands,Bulgaria,0,0,0,0,11/6/2021,0,0,0,0,0,0,0,0,0,0,0,0,0,0,0,0,0,0,0,0
176460,2021,Poland,Netherlands,0,0,0,0,10/6/2021,0,0,5,5,0,0,0,0,0,0,0,0,3,3,10,16,9,4,1,14
176460,2021,Netherlands,Brazil,0,0,0,0,9/6/2021,0,0,0,0,0,0,0,0,0,0,0,0,0,0,0,0,0,0,0,0
176460,2021,Netherlands,Argentina,0,0,0,0,5/6/2021,0,0,0,0,0,0,0,0,0,0,0,0,0,0,0,0,0,0,0,0
176460,2021,Netherlands,Germany,0,0,0,0,4/6/2021,0,0,0,0,0,0,0,0,0,0,0,0,0,0,0,0,0,0,0,0
176460,2021,Netherlands,Slovenia,0,0,0,0,3/6/2021,0,0,0,0,0,0,0,0,0,0,0,0,0,0,0,0,0,0,0,0
176460,2021,Netherlands,Iran,0,0,0,0,30/05/2021,0,0,1,1,0,0,0,0,0,0,0,0,5,3,10,18,14,2,0,16
176460,2021,Netherlands,Japan,0,0,0,0,29/05/2021,0,0,0,0,0,0,0,0,0,0,0,0,0,0,0,0,0,0,0,0
176460,2021,Netherlands,Russia,0,0,0,0,28/05/2021,0,0,0,0,0,0,0,0,0,0,0,0,0,0,0,0,1,0,0,1
137498,2021,Australia,Netherlands,4,4,4,12,23/06/2021,0,0,1,1,12,5,11,28,1,1,0,2,0,0,0,0,0,1,0,1
137498,2021,Netherlands,Italy,2,5,10,17,16/06/2021,0,0,0,0,20,10,11,41,2,4,5,11,2,0,0,2,9,2,0,11
137498,2021,Netherlands,France,4,6,12,22,15/06/2021,0,0,1,1,37,8,12,57,2,10,4,16,0,0,0,0,8,5,1,14
137498,2021,Netherlands,Bulgaria,4,7,11,22,11/6/2021,0,0,3,3,25,7,6,38,0,1,3,4,0,1,0,1,4,2,1,7
137498,2021,Poland,Netherlands,0,1,2,3,10/6/2021,0,0,0,0,5,1,5,11,0,0,0,0,0,0,0,0,1,0,0,1
137498,2021,Netherlands,Brazil,3,5,7,15,9/6/2021,0,0,2,2,15,8,8,31,2,2,0,4,1,0,0,1,3,3,0,6
137498,2021,Netherlands,Argentina,4,3,8,15,5/6/2021,0,0,1,1,17,6,7,30,1,3,1,5,0,0,0,0,3,4,0,7
137498,2021,Netherlands,Germany,5,8,10,23,4/6/2021,0,1,3,4,18,4,20,42,1,3,4,8,0,0,0,0,14,3,0,17
137498,2021,Netherlands,Slovenia,1,3,7,11,3/6/2021,0,0,1,1,14,7,9,30,0,2,1,3,0,0,0,0,5,1,0,6
137498,2021,Netherlands,Iran,1,1,4,6,30/05/2021,0,0,0,0,9,4,4,17,1,3,0,4,0,0,0,0,3,0,0,3
137498,2021,Netherlands,Japan,2,7,7,16,29/05/2021,0,0,0,0,23,9,14,46,0,3,2,5,0,0,0,0,1,0,0,1
137498,2021,Netherlands,Russia,6,5,12,23,28/05/2021,0,0,1,1,23,8,6,37,0,1,1,2,0,1,1,2,6,0,1,7
164837,2021,Serbia,Netherlands,0,0,0,0,22/06/2021,0,0,0,0,0,0,0,0,0,0,0,0,0,0,0,0,0,0,0,0
164837,2021,Canada,Netherlands,0,0,0,0,21/06/2021,0,0,0,0,0,0,0,0,0,0,0,0,0,0,0,0,0,0,0,0
164837,2021,Netherlands,USA,0,0,1,1,17/06/2021,0,0,4,4,0,0,0,0,0,0,0,0,0,1,0,1,0,0,0,0
164837,2021,Netherlands,France,0,0,0,0,15/06/2021,2,0,4,6,0,0,0,0,0,0,0,0,0,0,0,0,0,0,0,0
164837,2021,Poland,Netherlands,0,0,5,5,10/6/2021,8,1,36,45,1,0,0,1,0,2,0,2,0,0,1,1,3,1,1,5
164837,2021,Netherlands,Brazil,0,0,0,0,9/6/2021,1,0,1,2,0,0,0,0,0,0,0,0,0,0,0,0,0,0,0,0
164837,2021,Netherlands,Argentina,0,0,0,0,5/6/2021,2,0,12,14,0,0,0,0,0,1,0,1,0,0,1,1,0,0,0,0
164837,2021,Netherlands,Germany,0,0,0,0,4/6/2021,0,0,0,0,0,0,0,0,0,0,0,0,0,0,0,0,0,0,0,0
164837,2021,Netherlands,Slovenia,0,0,1,1,3/6/2021,0,1,7,8,0,0,0,0,0,0,0,0,0,0,0,0,1,0,0,1
164837,2021,Netherlands,Iran,0,1,4,5,30/05/2021,15,0,62,77,0,1,0,1,1,0,1,2,0,0,0,0,2,2,0,4
164837,2021,Netherlands,Japan,0,0,0,0,29/05/2021,2,0,2,4,0,0,0,0,0,1,0,1,0,0,0,0,0,0,0,0
164837,2021,Netherlands,Russia,0,0,0,0,28/05/2021,1,0,3,4,0,0,0,0,0,0,0,0,0,0,0,0,0,0,0,0
137337,2021,Australia,Netherlands,1,2,8,11,23/06/2021,0,0,0,0,5,1,1,7,4,3,1,8,0,0,0,0,2,0,2,4
137337,2021,Canada,Netherlands,0,0,4,4,21/06/2021,0,0,0,0,5,2,1,8,1,1,1,3,0,0,1,1,1,0,0,1
137337,2021,Netherlands,USA,0,1,8,9,17/06/2021,0,0,0,0,6,0,3,9,1,3,1,5,0,1,0,1,3,0,0,3
137337,2021,Netherlands,Italy,0,0,0,0,16/06/2021,0,0,0,0,0,0,0,0,0,0,0,0,0,0,0,0,0,0,0,0
137337,2021,Netherlands,France,0,0,9,9,15/06/2021,0,0,1,1,5,0,4,9,0,6,4,10,0,0,0,0,1,2,2,5
137337,2021,Netherlands,Bulgaria,0,1,3,4,11/6/2021,0,0,0,0,1,0,1,2,0,1,1,2,0,0,0,0,1,0,0,1
137337,2021,Poland,Netherlands,0,0,0,0,10/6/2021,0,0,0,0,0,0,0,0,0,0,0,0,0,0,0,0,0,0,0,0
137337,2021,Netherlands,Brazil,0,0,11,11,9/6/2021,0,0,0,0,4,0,2,6,2,5,2,9,0,0,1,1,2,0,0,2
137337,2021,Netherlands,Argentina,0,0,1,1,5/6/2021,0,0,0,0,0,0,0,0,0,0,0,0,0,0,0,0,0,0,0,0
137337,2021,Netherlands,Germany,1,2,9,12,4/6/2021,0,0,0,0,11,1,1,13,4,9,8,21,1,0,5,6,1,0,0,1
137337,2021,Netherlands,Iran,0,1,6,7,30/05/2021,0,0,0,0,4,1,1,6,1,4,0,5,1,1,0,2,1,2,0,3
137337,2021,Netherlands,Japan,0,1,1,2,29/05/2021,0,0,0,0,2,0,1,3,1,0,0,1,1,0,1,2,0,0,0,0
137337,2021,Netherlands,Russia,0,1,8,9,28/05/2021,0,0,0,0,6,0,1,7,2,5,4,11,0,0,0,0,1,0,0,1
121992,2021,Australia,Netherlands,0,2,6,8,23/06/2021,0,0,2,2,8,2,2,12,1,0,0,1,10,0,7,17,2,1,0,3
121992,2021,Serbia,Netherlands,1,4,3,8,22/06/2021,0,0,2,2,3,2,2,7,1,2,0,3,2,1,7,10,0,0,0,0
121992,2021,Canada,Netherlands,0,2,2,4,21/06/2021,0,0,1,1,4,0,5,9,1,0,0,1,7,0,10,17,4,1,1,6
121992,2021,Netherlands,USA,1,6,8,15,17/06/2021,0,0,9,9,10,2,13,25,1,1,1,3,1,0,9,10,11,0,0,11
121992,2021,Netherlands,Italy,0,2,3,5,16/06/2021,0,0,2,2,2,1,5,8,0,1,3,4,3,1,8,12,4,0,0,4
121992,2021,Netherlands,France,1,5,10,16,15/06/2021,0,0,4,4,6,3,7,16,2,3,3,8,13,1,16,30,13,4,1,18
121992,2021,Netherlands,Bulgaria,4,5,10,19,11/6/2021,0,0,1,1,11,4,9,24,2,2,2,6,4,1,13,18,6,1,1,8
121992,2021,Poland,Netherlands,0,4,1,5,10/6/2021,0,0,3,3,5,1,3,9,0,1,0,1,4,1,4,9,3,1,0,4
121992,2021,Netherlands,Brazil,0,3,5,8,9/6/2021,0,0,3,3,4,2,6,12,0,4,3,7,16,0,12,28,4,1,1,6
121992,2021,Netherlands,Argentina,0,1,4,5,5/6/2021,0,0,1,1,0,3,7,10,0,0,0,0,5,0,3,8,1,0,0,1
121992,2021,Netherlands,Germany,0,0,0,0,4/6/2021,0,0,0,0,0,0,0,0,0,0,0,0,0,0,0,0,2,0,0,2
121992,2021,Netherlands,Slovenia,2,2,5,9,3/6/2021,0,0,4,4,4,3,3,10,1,1,3,5,9,0,7,16,2,0,0,2
121992,2021,Netherlands,Iran,0,0,0,0,30/05/2021,0,0,0,0,0,0,0,0,0,0,0,0,0,0,0,0,0,0,0,0
121992,2021,Netherlands,Japan,0,2,12,14,29/05/2021,0,0,0,0,1,2,6,9,1,3,1,5,9,0,12,21,4,0,0,4
162642,2021,Australia,Netherlands,0,1,6,7,23/06/2021,18,0,43,61,0,0,0,0,2,3,2,7,0,0,2,2,3,1,1,5
162642,2021,Serbia,Netherlands,0,0,1,1,22/06/2021,6,0,6,12,0,0,0,0,0,0,1,1,0,0,0,0,0,0,0,0
162642,2021,Canada,Netherlands,0,0,2,2,21/06/2021,8,1,24,33,0,1,0,1,0,1,0,1,0,0,0,0,2,0,0,2
162642,2021,Netherlands,USA,0,0,0,0,17/06/2021,0,0,0,0,0,0,0,0,0,0,0,0,0,0,0,0,0,0,0,0
162642,2021,Netherlands,Italy,0,2,2,4,16/06/2021,10,0,38,48,0,0,0,0,0,1,0,1,0,0,0,0,3,2,0,5
162642,2021,Netherlands,France,0,1,12,13,15/06/2021,39,1,70,110,0,0,1,1,1,2,3,6,0,1,2,3,4,1,1,6
162642,2021,Netherlands,Bulgaria,0,2,10,12,11/6/2021,27,0,62,89,0,0,1,1,1,4,2,7,0,0,2,2,4,6,0,10
162642,2021,Netherlands,Brazil,1,1,10,12,9/6/2021,18,0,52,70,2,0,0,2,0,0,1,1,0,0,0,0,3,3,0,6
162642,2021,Netherlands,Iran,0,0,2,2,30/05/2021,6,0,0,6,0,0,0,0,0,0,0,0,0,0,0,0,0,0,0,0
162642,2021,Netherlands,Japan,0,3,12,15,29/05/2021,28,3,76,107,0,0,2,2,0,2,0,2,0,0,0,0,7,3,1,11
162642,2021,Netherlands,Russia,0,3,10,13,28/05/2021,26,0,53,79,0,0,0,0,0,1,2,3,0,0,0,0,2,0,2,4
162095,2021,Australia,Netherlands,0,0,0,0,23/06/2021,0,0,0,0,0,0,0,0,0,0,0,0,0,0,0,0,0,0,0,0
162095,2021,Serbia,Netherlands,0,0,0,0,22/06/2021,0,0,0,0,1,0,0,1,1,0,0,1,0,0,0,0,0,0,0,0
162095,2021,Canada,Netherlands,0,1,0,1,21/06/2021,0,0,0,0,0,0,0,0,0,0,0,0,0,0,0,0,0,0,0,0
162095,2021,Netherlands,USA,0,0,0,0,17/06/2021,0,0,0,0,0,0,1,1,0,2,0,2,0,0,1,1,0,0,0,0
162095,2021,Netherlands,Italy,0,0,0,0,16/06/2021,0,0,0,0,0,0,0,0,0,0,0,0,0,0,0,0,0,0,0,0
162095,2021,Netherlands,France,0,0,0,0,15/06/2021,0,0,0,0,0,0,0,0,0,0,0,0,0,0,0,0,0,0,0,0
162095,2021,Netherlands,Bulgaria,0,0,0,0,11/6/2021,0,0,0,0,0,0,0,0,0,0,0,0,0,0,0,0,0,0,0,0
162095,2021,Poland,Netherlands,0,1,1,2,10/6/2021,0,0,0,0,2,4,6,12,0,0,0,0,0,2,8,10,3,0,0,3
162095,2021,Netherlands,Brazil,0,0,0,0,9/6/2021,0,0,0,0,0,0,0,0,0,0,0,0,0,0,0,0,0,0,0,0
162095,2021,Netherlands,Slovenia,0,0,2,2,3/6/2021,0,0,0,0,2,2,3,7,1,0,1,2,1,1,3,5,1,1,0,2
162095,2021,Netherlands,Iran,0,0,0,0,30/05/2021,0,0,0,0,0,0,0,0,0,0,0,0,0,0,0,0,0,0,0,0
162095,2021,Netherlands,Russia,0,3,8,11,28/05/2021,0,0,0,0,4,5,4,13,0,1,1,2,3,2,10,15,8,1,0,9
150703,2021,Australia,Netherlands,0,3,7,10,23/06/2021,0,0,0,0,3,0,1,4,0,0,2,2,0,0,2,2,1,0,1,2
150703,2021,Serbia,Netherlands,1,3,18,22,22/06/2021,0,0,0,0,3,1,2,6,1,6,5,12,1,1,0,2,1,0,0,1
150703,2021,Canada,Netherlands,0,1,3,4,21/06/2021,0,0,0,0,1,0,0,1,0,0,0,0,0,0,0,0,0,0,0,0
150703,2021,Netherlands,USA,0,2,5,7,17/06/2021,0,0,0,0,0,0,0,0,0,0,1,1,0,0,1,1,1,2,0,3
150703,2021,Netherlands,Italy,1,0,11,12,16/06/2021,0,0,0,0,3,1,3,7,0,7,3,10,0,0,0,0,1,2,2,5
150703,2021,Netherlands,France,2,0,10,12,15/06/2021,0,0,0,0,0,0,0,0,0,0,1,1,0,0,0,0,0,0,0,0
150703,2021,Netherlands,Bulgaria,1,0,8,9,11/6/2021,0,0,0,0,0,0,2,2,1,1,3,5,0,0,0,0,0,0,0,0
150703,2021,Poland,Netherlands,0,1,8,9,10/6/2021,0,0,2,2,2,1,1,4,1,1,0,2,0,0,0,0,3,0,0,3
150703,2021,Netherlands,Argentina,0,0,0,0,5/6/2021,0,0,0,0,0,0,0,0,0,0,0,0,0,0,0,0,0,0,0,0
150703,2021,Netherlands,Germany,1,2,12,15,4/6/2021,0,0,2,2,1,1,2,4,1,5,4,10,0,0,1,1,2,0,0,2
150703,2021,Netherlands,Slovenia,0,0,3,3,3/6/2021,0,0,0,0,1,1,1,3,1,2,1,4,0,0,2,2,1,0,0,1
150703,2021,Netherlands,Iran,0,0,2,2,30/05/2021,0,0,0,0,0,0,0,0,0,0,0,0,0,0,0,0,1,0,0,1
150703,2021,Netherlands,Japan,1,1,10,12,29/05/2021,0,0,0,0,2,0,1,3,1,0,0,1,1,1,0,2,0,0,0,0
150703,2021,Netherlands,Russia,0,0,0,0,28/05/2021,0,0,0,0,0,0,0,0,0,0,0,0,0,0,0,0,0,0,0,0
169923,2021,Australia,Netherlands,0,1,0,1,23/06/2021,0,0,0,0,0,0,0,0,0,0,0,0,0,0,0,0,0,0,0,0
169923,2021,Serbia,Netherlands,0,3,11,14,22/06/2021,0,0,2,2,20,5,7,32,1,4,4,9,0,1,1,2,4,3,4,11
169923,2021,Canada,Netherlands,0,0,5,5,21/06/2021,0,0,2,2,3,2,7,12,1,0,0,1,0,0,1,1,1,0,0,1
169923,2021,Netherlands,USA,4,1,17,22,17/06/2021,0,0,2,2,15,4,17,36,0,4,2,6,1,1,2,4,4,2,0,6
169923,2021,Netherlands,Italy,0,0,3,3,16/06/2021,0,0,0,0,0,0,1,1,0,0,0,0,0,0,1,1,0,0,0,0
169923,2021,Netherlands,France,0,0,0,0,15/06/2021,0,0,0,0,0,2,0,2,0,1,0,1,0,0,0,0,0,0,0,0
169923,2021,Netherlands,Bulgaria,0,0,1,1,11/6/2021,0,0,0,0,2,1,0,3,0,0,0,0,0,0,0,0,0,1,0,1
169923,2021,Poland,Netherlands,1,2,5,8,10/6/2021,0,0,1,1,3,4,7,14,0,3,1,4,0,0,0,0,1,0,0,1
169923,2021,Netherlands,Brazil,0,1,1,2,9/6/2021,0,0,0,0,0,0,1,1,0,0,1,1,0,0,0,0,0,0,0,0
169923,2021,Netherlands,Argentina,0,0,0,0,5/6/2021,0,0,0,0,0,1,0,1,0,0,0,0,0,0,0,0,0,0,0,0
169923,2021,Netherlands,Germany,0,1,0,1,4/6/2021,0,0,0,0,0,0,0,0,0,0,0,0,0,0,0,0,0,0,0,0
169923,2021,Netherlands,Slovenia,0,0,2,2,3/6/2021,0,0,1,1,0,1,1,2,0,1,0,1,0,0,0,0,0,0,0,0
169923,2021,Netherlands,Iran,2,2,6,10,30/05/2021,0,0,0,0,7,1,8,16,0,2,0,2,0,0,1,1,1,0,0,1
169923,2021,Netherlands,Japan,0,0,2,2,29/05/2021,0,0,0,0,1,1,2,4,0,2,0,2,0,0,0,0,0,0,0,0
169923,2021,Netherlands,Russia,0,0,0,0,28/05/2021,0,0,0,0,0,0,1,1,0,0,0,0,0,0,0,0,0,0,0,0
120245,2021,Brazil,Poland,0,1,8,9,27/06/2021,0,0,0,0,2,0,1,3,1,5,1,7,0,0,0,0,0,1,0,1
120245,2021,Poland,Slovenia,1,1,7,9,26/06/2021,0,0,1,1,3,0,0,3,3,2,2,7,0,0,0,0,0,0,0,0
120245,2021,France,Poland,0,2,17,19,23/06/2021,0,0,0,0,5,1,1,7,4,5,4,13,0,0,1,1,3,0,0,3
120245,2021,Iran,Poland,2,1,7,10,22/06/2021,0,0,0,0,4,1,3,8,2,5,7,14,0,0,0,0,1,0,0,1
120245,2021,Poland,Argentina,0,0,0,0,21/06/2021,0,0,0,0,0,0,0,0,0,0,0,0,0,0,0,0,0,0,0,0
120245,2021,Germany,Poland,0,2,6,8,17/06/2021,0,0,0,0,5,0,3,8,2,5,3,10,0,0,0,0,5,0,0,5
120245,2021,Canada,Poland,0,1,9,10,15/06/2021,0,0,0,0,7,0,1,8,1,3,7,11,0,0,0,0,1,0,1,2
120245,2021,Poland,Brazil,0,2,1,3,11/6/2021,0,0,0,0,1,0,2,3,3,2,0,5,0,0,0,0,0,0,0,0
120245,2021,Poland,Netherlands,0,0,0,0,10/6/2021,0,0,0,0,0,0,0,0,0,0,0,0,0,0,0,0,0,0,0,0
120245,2021,Poland,Bulgaria,0,0,0,0,9/6/2021,0,0,0,0,0,0,0,0,0,0,0,0,0,0,0,0,0,0,0,0
120245,2021,Russia,Poland,0,0,3,3,5/6/2021,0,0,0,0,3,1,1,5,3,6,4,13,0,0,0,0,1,0,0,1
120245,2021,Australia,Poland,0,2,5,7,3/6/2021,0,0,0,0,2,0,1,3,2,1,1,4,0,0,0,0,1,0,0,1
156531,2021,France,Poland,0,0,0,0,23/06/2021,0,0,0,0,0,0,0,0,0,2,0,2,0,0,0,0,1,0,0,1
156531,2021,Iran,Poland,0,0,3,3,22/06/2021,0,0,1,1,1,3,2,6,2,2,2,6,0,0,0,0,2,0,0,2
156531,2021,Japan,Poland,2,4,6,12,16/06/2021,0,0,0,0,10,0,6,16,2,3,3,8,0,0,0,0,1,0,1,2
156531,2021,Canada,Poland,0,0,0,0,15/06/2021,0,0,0,0,0,0,0,0,0,0,0,0,0,0,0,0,0,0,0,0
156531,2021,Poland,Brazil,0,1,1,2,11/6/2021,0,0,0,0,1,1,1,3,0,0,0,0,0,0,1,1,0,0,0,0
156531,2021,Poland,Netherlands,3,2,7,12,10/6/2021,0,0,1,1,5,5,9,19,1,2,6,9,0,0,0,0,4,0,0,4
156531,2021,Poland,Bulgaria,0,0,0,0,9/6/2021,0,0,0,0,0,0,0,0,0,0,0,0,0,0,0,0,0,0,0,0
156531,2021,Russia,Poland,1,4,8,13,5/6/2021,0,0,4,4,9,2,8,19,2,4,5,11,0,1,0,1,3,0,0,3
156531,2021,Poland,USA,0,0,0,0,4/6/2021,0,0,0,0,0,0,0,0,0,0,1,1,0,0,0,0,0,0,0,0
156531,2021,Poland,Slovenia,0,0,1,1,30/05/2021,0,0,1,1,0,1,2,3,0,3,0,3,0,0,0,0,0,0,0,0
156531,2021,Poland,Italy,3,3,14,20,28/05/2021,0,0,0,0,11,1,13,25,0,2,3,5,0,0,0,0,5,0,1,6
153389,2021,Iran,Poland,0,0,0,0,22/06/2021,0,0,0,0,0,0,0,0,0,0,0,0,0,0,0,0,0,0,0,0
153389,2021,Japan,Poland,0,0,1,1,16/06/2021,4,0,3,7,1,0,0,1,0,0,0,0,0,0,0,0,0,0,0,0
153389,2021,Canada,Poland,0,0,0,0,15/06/2021,0,0,0,0,0,0,0,0,0,0,0,0,0,0,0,0,0,0,0,0
162105,2021,Brazil,Poland,0,0,1,1,27/06/2021,0,0,0,0,0,0,1,1,0,0,0,0,0,0,0,0,0,0,0,0
162105,2021,Poland,Slovenia,0,1,1,2,26/06/2021,0,0,1,1,0,0,0,0,0,0,1,1,0,0,0,0,0,0,1,1
162105,2021,Iran,Poland,0,0,7,7,22/06/2021,0,0,0,0,5,3,2,10,1,1,3,5,0,0,0,0,2,0,2,4
162105,2021,Poland,Argentina,0,0,1,1,21/06/2021,0,0,0,0,1,0,0,1,1,0,0,1,0,0,0,0,0,0,0,0
162105,2021,Germany,Poland,0,0,0,0,17/06/2021,0,0,0,0,0,0,0,0,0,0,0,0,0,0,0,0,0,0,0,0
162105,2021,Japan,Poland,0,0,0,0,16/06/2021,0,0,0,0,0,0,0,0,0,0,0,0,0,0,0,0,0,0,0,0
162105,2021,Poland,Brazil,0,3,7,10,11/6/2021,0,0,0,0,7,1,10,18,2,0,1,3,1,0,1,2,0,1,0,1
162105,2021,Poland,Bulgaria,1,1,10,12,9/6/2021,0,0,0,0,10,2,11,23,1,3,0,4,0,0,0,0,1,1,0,2
162105,2021,Russia,Poland,0,0,1,1,5/6/2021,0,0,0,0,0,0,0,0,0,1,0,1,0,0,0,0,0,0,0,0
162105,2021,Australia,Poland,1,0,8,9,3/6/2021,0,0,0,0,10,2,6,18,6,3,1,10,0,0,0,0,3,1,0,4
162105,2021,Poland,Slovenia,0,4,10,14,30/05/2021,0,0,0,0,15,8,12,35,2,5,2,9,0,0,0,0,4,1,0,5
162105,2021,Poland,Serbia,0,0,1,1,29/05/2021,0,0,0,0,0,0,0,0,0,1,0,1,0,0,0,0,0,0,0,0
115806,2021,Brazil,Poland,0,4,6,10,27/06/2021,0,0,5,5,15,3,8,26,2,1,2,5,0,0,0,0,5,1,0,6
115806,2021,Poland,Slovenia,0,2,8,10,26/06/2021,0,0,1,1,14,3,6,23,3,3,0,6,0,0,0,0,4,1,1,6
115806,2021,France,Poland,0,7,7,14,23/06/2021,0,0,5,5,14,7,8,29,1,6,3,10,0,0,0,0,6,3,1,10
115806,2021,Poland,Argentina,2,4,7,13,21/06/2021,0,0,2,2,9,1,10,20,1,1,5,7,0,0,0,0,3,4,1,8
115806,2021,Germany,Poland,0,1,10,11,17/06/2021,0,0,0,0,14,3,9,26,2,2,2,6,0,0,1,1,4,0,1,5
115806,2021,Canada,Poland,0,4,5,9,15/06/2021,0,0,1,1,13,2,9,24,2,1,5,8,1,0,0,1,3,1,1,5
115806,2021,Poland,Netherlands,0,0,0,0,10/6/2021,0,0,0,0,0,0,0,0,0,0,0,0,0,0,0,0,0,0,0,0
115806,2021,Poland,USA,0,3,8,11,4/6/2021,0,0,0,0,8,5,6,19,0,2,4,6,1,0,1,2,8,1,1,10
115806,2021,Australia,Poland,0,0,0,0,3/6/2021,0,0,0,0,0,0,0,0,0,0,0,0,0,0,0,0,0,0,0,0
115806,2021,Poland,Serbia,0,3,8,11,29/05/2021,0,0,0,0,10,3,11,24,2,5,2,9,0,0,2,2,4,1,1,6
115806,2021,Poland,Italy,0,0,0,0,28/05/2021,0,0,0,0,0,0,0,0,0,0,0,0,0,0,0,0,0,0,0,0
119646,2021,Brazil,Poland,1,3,8,12,27/06/2021,0,0,1,1,5,4,15,24,2,1,1,4,5,2,15,22,5,3,0,8
119646,2021,Poland,Slovenia,2,2,13,17,26/06/2021,0,0,1,1,11,3,7,21,0,2,1,3,6,2,14,22,3,2,1,6
119646,2021,France,Poland,3,7,9,19,23/06/2021,0,0,2,2,12,3,11,26,3,2,0,5,12,1,15,28,3,2,1,6
119646,2021,Iran,Poland,0,0,0,0,22/06/2021,0,0,0,0,0,0,0,0,0,0,0,0,0,0,0,0,0,0,0,0
119646,2021,Germany,Poland,1,6,5,12,17/06/2021,0,0,2,2,11,1,9,21,1,2,2,5,4,1,12,17,2,1,0,3
119646,2021,Japan,Poland,0,0,0,0,16/06/2021,0,0,0,0,0,0,0,0,0,0,0,0,0,0,0,0,0,0,0,0
119646,2021,Canada,Poland,3,2,9,14,15/06/2021,0,0,1,1,11,1,10,22,1,3,0,4,2,2,10,14,5,4,2,11
119646,2021,Poland,Brazil,0,0,0,0,11/6/2021,0,0,0,0,0,1,0,1,0,1,0,1,0,0,0,0,0,0,0,0
119646,2021,Poland,Bulgaria,2,6,6,14,9/6/2021,0,0,3,3,7,0,6,13,0,0,1,1,3,0,8,11,4,2,0,6
119646,2021,Russia,Poland,7,5,6,18,5/6/2021,0,0,3,3,16,3,13,32,2,3,1,6,4,1,14,19,4,1,0,5
119646,2021,Poland,USA,0,0,1,1,4/6/2021,0,0,0,0,0,0,0,0,0,0,0,0,0,0,0,0,0,0,0,0
119646,2021,Poland,Serbia,13,5,12,30,29/05/2021,0,0,0,0,13,2,2,17,0,1,0,1,10,2,21,33,7,1,0,8
119646,2021,Poland,Italy,0,0,0,0,28/05/2021,0,0,0,0,0,0,0,0,0,0,0,0,0,0,0,0,0,0,0,0
135322,2021,Brazil,Poland,0,0,0,0,27/06/2021,0,0,0,0,0,0,0,0,0,0,0,0,0,0,0,0,0,0,0,0
135322,2021,Poland,Slovenia,0,0,0,0,26/06/2021,0,0,0,0,0,0,0,0,0,0,0,0,0,0,0,0,0,0,0,0
135322,2021,France,Poland,0,0,0,0,23/06/2021,0,0,7,7,0,0,0,0,0,0,0,0,6,2,12,20,9,4,0,13
135322,2021,Iran,Poland,0,0,0,0,22/06/2021,0,0,2,2,0,0,0,0,0,0,0,0,5,0,10,15,7,1,2,10
135322,2021,Poland,Argentina,0,0,0,0,21/06/2021,0,0,0,0,0,0,0,0,0,0,0,0,0,0,0,0,0,0,0,0
135322,2021,Poland,Brazil,0,0,0,0,11/6/2021,0,0,0,0,0,0,0,0,0,0,0,0,9,1,12,22,6,5,1,12
135322,2021,Poland,Netherlands,0,0,0,0,10/6/2021,0,0,0,0,0,0,0,0,0,0,0,0,0,0,0,0,0,0,0,0
135322,2021,Poland,Bulgaria,0,0,0,0,9/6/2021,0,0,3,3,0,0,0,0,0,0,0,0,2,1,9,12,6,1,0,7
135322,2021,Russia,Poland,0,0,0,0,5/6/2021,0,0,0,0,0,0,0,0,0,0,0,0,0,0,0,0,0,0,0,0
135322,2021,Poland,USA,0,0,0,0,4/6/2021,0,0,2,2,0,0,0,0,0,0,0,0,5,0,9,14,6,5,1,12
135322,2021,Australia,Poland,0,0,0,0,3/6/2021,0,0,0,0,0,0,0,0,0,0,0,0,0,0,0,0,0,0,0,0
135322,2021,Poland,Slovenia,0,0,0,0,30/05/2021,0,1,3,4,0,0,0,0,0,0,0,0,11,1,11,23,9,3,1,13
135322,2021,Poland,Serbia,0,0,0,0,29/05/2021,0,0,0,0,0,0,0,0,0,0,0,0,1,1,2,4,2,0,0,2
135322,2021,Poland,Italy,0,0,0,0,28/05/2021,0,0,0,0,0,0,0,0,0,0,0,0,4,0,5,9,6,1,1,8
118612,2021,Brazil,Poland,1,3,12,16,27/06/2021,24,0,59,83,0,0,0,0,0,2,0,2,0,0,1,1,2,2,3,7
118612,2021,Poland,Slovenia,2,1,9,12,26/06/2021,16,0,45,61,0,0,0,0,4,3,1,8,0,0,0,0,4,1,1,6
118612,2021,France,Poland,0,3,14,17,23/06/2021,29,1,67,97,0,1,1,2,1,2,4,7,0,0,1,1,7,0,3,10
118612,2021,Iran,Poland,0,0,0,0,22/06/2021,0,0,0,0,0,0,0,0,0,0,0,0,0,0,0,0,0,0,0,0
118612,2021,Poland,Argentina,2,0,9,11,21/06/2021,25,0,39,64,1,0,0,1,0,1,2,3,0,0,0,0,5,1,0,6
118612,2021,Germany,Poland,0,0,11,11,17/06/2021,28,0,42,70,1,0,0,1,1,0,2,3,0,0,0,0,5,2,1,8
118612,2021,Japan,Poland,0,0,0,0,16/06/2021,0,0,0,0,0,0,0,0,0,0,0,0,0,0,0,0,0,0,0,0
118612,2021,Canada,Poland,1,2,11,14,15/06/2021,18,0,50,68,0,0,0,0,0,2,2,4,0,0,0,0,7,1,2,10
118612,2021,Poland,Brazil,1,3,5,9,11/6/2021,14,0,68,82,0,0,1,1,0,1,1,2,0,0,0,0,1,1,0,2
118612,2021,Poland,Netherlands,0,0,0,0,10/6/2021,0,0,0,0,0,0,0,0,0,0,0,0,0,0,0,0,0,0,0,0
118612,2021,Poland,Bulgaria,1,5,9,15,9/6/2021,18,0,40,58,0,0,0,0,0,2,1,3,0,0,1,1,3,0,0,3
118612,2021,Russia,Poland,0,3,8,11,5/6/2021,26,0,40,66,0,0,0,0,0,2,1,3,0,0,0,0,6,2,0,8
118612,2021,Poland,USA,0,0,0,0,4/6/2021,0,0,0,0,0,0,0,0,0,0,0,0,0,0,0,0,0,0,0,0
118612,2021,Australia,Poland,3,3,12,18,3/6/2021,10,0,36,46,0,0,0,0,2,0,0,2,0,0,0,0,4,0,0,4
118612,2021,Poland,Slovenia,0,0,0,0,30/05/2021,3,0,6,9,0,0,0,0,0,0,0,0,0,0,0,0,0,0,0,0
118612,2021,Poland,Serbia,1,4,12,17,29/05/2021,25,0,64,89,0,0,2,2,0,0,1,1,0,0,0,0,3,2,0,5
118612,2021,Poland,Italy,0,0,0,0,28/05/2021,0,0,0,0,0,0,0,0,0,0,0,0,0,0,0,0,0,0,0,0
115794,2021,Brazil,Poland,0,0,1,1,27/06/2021,0,0,2,2,0,0,0,0,0,0,0,0,0,0,0,0,0,0,0,0
115794,2021,Poland,Slovenia,0,0,0,0,26/06/2021,0,0,0,0,0,0,0,0,0,0,0,0,0,0,0,0,0,0,0,0
115794,2021,France,Poland,0,0,0,0,23/06/2021,0,0,0,0,0,0,0,0,0,0,0,0,0,0,0,0,0,0,0,0
115794,2021,Iran,Poland,0,1,10,11,22/06/2021,18,1,41,60,0,0,0,0,1,2,5,8,0,1,0,1,4,0,1,5
115794,2021,Poland,Argentina,0,0,0,0,21/06/2021,1,0,2,3,0,0,0,0,0,0,0,0,0,0,0,0,0,0,0,0
115794,2021,Germany,Poland,0,0,0,0,17/06/2021,0,0,0,0,0,0,0,0,0,0,0,0,0,0,0,0,0,0,0,0
115794,2021,Japan,Poland,0,0,8,8,16/06/2021,13,0,29,42,0,0,0,0,0,1,1,2,0,0,0,0,4,0,3,7
115794,2021,Canada,Poland,0,0,0,0,15/06/2021,0,0,0,0,0,0,0,0,0,0,0,0,0,0,0,0,0,0,0,0
115794,2021,Poland,Brazil,0,0,0,0,11/6/2021,0,0,1,1,0,0,0,0,0,0,0,0,0,0,0,0,0,0,0,0
115794,2021,Poland,Netherlands,0,1,14,15,10/6/2021,15,0,35,50,1,0,0,1,2,1,2,5,0,0,0,0,4,0,2,6
115794,2021,Poland,Bulgaria,0,0,0,0,9/6/2021,0,0,0,0,0,0,0,0,0,0,0,0,0,0,0,0,0,0,0,0
115794,2021,Russia,Poland,0,0,0,0,5/6/2021,2,0,1,3,0,0,0,0,0,0,0,0,0,0,0,0,0,0,0,0
115794,2021,Poland,USA,0,0,16,16,4/6/2021,31,1,35,67,0,0,0,0,0,2,1,3,0,0,0,0,5,1,2,8
115794,2021,Australia,Poland,0,0,0,0,3/6/2021,0,0,0,0,0,0,0,0,0,0,0,0,0,0,0,0,0,0,0,0
115794,2021,Poland,Slovenia,1,0,10,11,30/05/2021,27,0,62,89,0,0,0,0,0,2,1,3,0,0,0,0,3,2,0,5
115794,2021,Poland,Serbia,0,0,0,0,29/05/2021,0,0,0,0,0,0,0,0,0,0,0,0,0,0,0,0,0,0,0,0
115794,2021,Poland,Italy,0,1,6,7,28/05/2021,30,0,0,30,1,0,0,1,0,1,0,1,0,0,0,0,4,0,1,5
115845,2021,Brazil,Poland,0,3,14,17,27/06/2021,0,1,4,5,14,5,5,24,1,1,2,4,8,1,15,24,8,1,1,10
115845,2021,Poland,Slovenia,0,2,6,8,26/06/2021,0,0,2,2,4,4,7,15,2,3,1,6,3,3,8,14,3,2,0,5
115845,2021,France,Poland,0,3,17,20,23/06/2021,0,0,4,4,10,4,11,25,2,2,4,8,16,1,13,30,2,3,0,5
115845,2021,Poland,Argentina,1,3,10,14,21/06/2021,0,0,3,3,9,1,5,15,0,6,1,7,3,1,12,16,8,1,1,10
115845,2021,Germany,Poland,1,3,13,17,17/06/2021,0,0,4,4,10,1,6,17,0,2,1,3,3,0,17,20,6,5,1,12
115845,2021,Canada,Poland,0,1,13,14,15/06/2021,0,0,6,6,8,4,9,21,0,1,2,3,3,2,16,21,10,1,0,11
115845,2021,Poland,Brazil,0,2,7,9,11/6/2021,0,0,2,2,7,1,6,14,0,4,0,4,7,1,11,19,4,4,0,8
115845,2021,Poland,Netherlands,0,0,0,0,10/6/2021,0,0,0,0,0,0,0,0,0,0,0,0,0,0,0,0,0,0,0,0
115845,2021,Russia,Poland,1,1,9,11,5/6/2021,0,0,3,3,8,2,9,19,2,1,0,3,1,2,11,14,5,1,2,8
115845,2021,Poland,USA,0,0,0,0,4/6/2021,0,0,0,0,0,0,0,0,0,0,0,0,0,0,0,0,0,0,0,0
115845,2021,Poland,Slovenia,0,2,13,15,30/05/2021,0,0,8,8,8,4,17,29,0,1,1,2,10,2,13,25,4,6,1,11
115845,2021,Poland,Serbia,0,0,0,0,29/05/2021,0,0,0,0,0,0,0,0,0,0,0,0,0,0,0,0,0,0,0,0
142679,2021,Brazil,Poland,0,0,0,0,27/06/2021,0,0,0,0,0,0,0,0,0,0,0,0,1,1,2,4,0,0,0,0
142679,2021,Poland,Slovenia,0,0,1,1,26/06/2021,0,0,1,1,1,1,1,3,0,1,0,1,0,0,1,1,0,0,0,0
142679,2021,France,Poland,0,0,0,0,23/06/2021,0,0,0,0,0,0,0,0,0,0,0,0,1,0,1,2,3,0,0,3
142679,2021,Iran,Poland,1,2,19,22,22/06/2021,0,0,1,1,8,1,9,18,1,1,2,4,5,1,6,12,4,2,0,6
142679,2021,Poland,Argentina,0,0,0,0,21/06/2021,0,0,0,0,0,0,0,0,0,0,0,0,0,0,0,0,0,0,0,0
142679,2021,Germany,Poland,0,0,0,0,17/06/2021,0,0,0,0,0,0,0,0,0,0,0,0,0,0,0,0,0,0,0,0
142679,2021,Japan,Poland,0,0,0,0,16/06/2021,0,0,0,0,0,0,0,0,0,0,0,0,0,0,0,0,0,0,0,0
142679,2021,Canada,Poland,0,0,0,0,15/06/2021,0,0,0,0,0,0,0,0,0,0,0,0,0,0,0,0,0,0,0,0
142679,2021,Poland,Brazil,0,0,0,0,11/6/2021,0,0,0,0,0,0,0,0,0,0,0,0,0,0,0,0,0,0,0,0
142679,2021,Poland,Netherlands,0,3,12,15,10/6/2021,0,0,1,1,11,0,5,16,0,1,2,3,4,2,8,14,5,0,0,5
142679,2021,Poland,Bulgaria,0,0,0,0,9/6/2021,0,0,0,0,0,0,0,0,0,0,0,0,0,0,0,0,0,0,0,0
142679,2021,Poland,USA,0,3,16,19,4/6/2021,0,0,1,1,8,2,4,14,1,1,2,4,4,0,10,14,5,0,0,5
142679,2021,Australia,Poland,0,0,0,0,3/6/2021,0,0,0,0,0,0,0,0,0,0,0,0,0,0,0,0,0,0,0,0
142679,2021,Poland,Slovenia,0,1,15,16,30/05/2021,0,0,4,4,13,4,19,36,0,2,0,2,13,2,15,30,3,2,0,5
142679,2021,Poland,Serbia,1,0,3,4,29/05/2021,0,0,0,0,0,0,0,0,0,0,0,0,0,0,0,0,0,0,0,0
152870,2021,Poland,Slovenia,0,0,3,3,26/06/2021,0,0,0,0,2,0,0,2,0,1,2,3,0,0,0,0,1,0,0,1
152870,2021,France,Poland,0,0,0,0,23/06/2021,0,0,0,0,0,0,0,0,0,0,0,0,0,0,0,0,0,0,0,0
152870,2021,Iran,Poland,2,2,8,12,22/06/2021,0,0,1,1,9,0,3,12,1,5,3,9,0,0,3,3,3,0,0,3
152870,2021,Germany,Poland,0,4,10,14,17/06/2021,0,0,1,1,5,3,3,11,1,2,4,7,0,0,1,1,2,0,0,2
152870,2021,Japan,Poland,0,0,0,0,16/06/2021,0,0,0,0,0,0,0,0,0,0,0,0,0,0,0,0,0,0,0,0
152870,2021,Canada,Poland,0,3,10,13,15/06/2021,0,0,0,0,5,0,3,8,0,6,4,10,0,0,0,0,1,0,0,1
152870,2021,Poland,Brazil,0,0,11,11,11/6/2021,0,0,0,0,4,1,6,11,1,3,0,4,0,0,0,0,1,3,0,4
152870,2021,Poland,Bulgaria,1,2,12,15,9/6/2021,0,0,0,0,4,0,0,4,3,2,1,6,0,0,0,0,4,1,0,5
152870,2021,Poland,USA,0,1,6,7,4/6/2021,0,0,0,0,9,3,1,13,1,2,3,6,0,0,0,0,3,0,2,5
152870,2021,Australia,Poland,0,0,2,2,3/6/2021,0,0,0,0,0,0,0,0,1,0,1,2,0,0,0,0,0,1,0,1
152870,2021,Poland,Serbia,1,1,14,16,29/05/2021,0,0,0,0,7,2,3,12,4,8,1,13,0,0,0,0,3,0,0,3
152870,2021,Poland,Italy,0,0,0,0,28/05/2021,0,0,0,0,0,0,0,0,0,0,0,0,0,0,0,0,0,0,0,0
153395,2021,Brazil,Poland,0,0,1,1,27/06/2021,0,0,1,1,1,5,1,7,0,2,1,3,1,0,1,2,0,0,0,0
153395,2021,Poland,Slovenia,0,0,0,0,26/06/2021,0,0,0,0,0,0,0,0,0,0,0,0,0,0,0,0,0,0,0,0
153395,2021,France,Poland,0,0,0,0,23/06/2021,0,0,0,0,2,1,1,4,0,0,0,0,1,1,3,5,0,0,0,0
153395,2021,Poland,Argentina,0,4,8,12,21/06/2021,0,0,3,3,13,3,9,25,0,2,1,3,2,0,14,16,5,1,3,9
153395,2021,Germany,Poland,0,0,0,0,17/06/2021,0,0,0,0,0,0,0,0,0,0,0,0,0,0,0,0,0,0,0,0
153395,2021,Japan,Poland,0,3,9,12,16/06/2021,0,0,6,6,3,0,4,7,2,2,3,7,5,0,13,18,4,0,0,4
153395,2021,Poland,Brazil,0,2,9,11,11/6/2021,0,0,1,1,15,3,12,30,1,3,0,4,12,0,9,21,4,3,0,7
153395,2021,Poland,Netherlands,0,0,0,0,10/6/2021,0,0,0,0,0,0,0,0,0,0,0,0,0,0,0,0,0,0,0,0
153395,2021,Russia,Poland,0,0,0,0,5/6/2021,0,0,0,0,0,0,0,0,0,0,0,0,0,0,0,0,0,0,0,0
153395,2021,Poland,USA,0,1,3,4,4/6/2021,0,0,0,0,5,0,1,6,1,0,1,2,3,0,3,6,5,0,1,6
153395,2021,Australia,Poland,1,2,13,16,3/6/2021,0,0,1,1,11,1,3,15,1,1,0,2,2,0,6,8,1,3,0,4
153395,2021,Poland,Serbia,0,4,4,8,29/05/2021,0,0,0,0,11,1,16,28,6,2,3,11,6,0,6,12,4,1,1,6
153395,2021,Poland,Italy,0,0,0,0,28/05/2021,0,0,0,0,0,0,0,0,0,0,0,0,0,0,0,0,0,0,0,0
118614,2021,Brazil,Poland,0,0,0,0,27/06/2021,0,0,5,5,0,0,0,0,0,0,0,0,6,2,17,25,9,5,2,16
118614,2021,Poland,Slovenia,0,0,0,0,26/06/2021,0,0,3,3,0,0,0,0,0,0,0,0,7,0,8,15,7,2,1,10
118614,2021,France,Poland,0,0,0,0,23/06/2021,0,0,0,0,0,0,0,0,0,0,0,0,0,0,0,0,0,0,0,0
118614,2021,Iran,Poland,0,0,0,0,22/06/2021,0,0,0,0,0,0,0,0,0,0,0,0,0,0,0,0,0,0,0,0
118614,2021,Poland,Argentina,0,0,0,0,21/06/2021,0,0,3,3,0,0,0,0,0,0,0,0,6,0,8,14,6,1,1,8
118614,2021,Germany,Poland,0,0,0,0,17/06/2021,0,0,5,5,0,0,0,0,0,0,0,0,4,1,7,12,12,2,1,15
118614,2021,Japan,Poland,0,0,0,0,16/06/2021,0,0,4,4,0,0,0,0,0,0,0,0,3,0,5,8,5,2,2,9
118614,2021,Canada,Poland,0,0,0,0,15/06/2021,0,0,1,1,0,0,0,0,0,0,0,0,3,1,11,15,4,3,1,8
118614,2021,Poland,Brazil,0,0,0,0,11/6/2021,0,0,0,0,0,0,0,0,0,0,0,0,0,0,0,0,0,0,0,0
118614,2021,Poland,Netherlands,0,0,0,0,10/6/2021,0,0,6,6,0,0,0,0,0,0,0,0,2,0,3,5,9,4,0,13
118614,2021,Poland,Bulgaria,0,0,0,0,9/6/2021,0,0,0,0,0,0,0,0,0,0,0,0,0,0,0,0,0,0,0,0
118614,2021,Russia,Poland,0,0,0,0,5/6/2021,0,0,3,3,0,0,0,0,0,0,0,0,7,2,15,24,8,3,3,14
118614,2021,Poland,USA,0,0,0,0,4/6/2021,0,0,0,0,0,0,0,0,0,0,0,0,0,0,0,0,0,0,0,0
118614,2021,Australia,Poland,0,0,0,0,3/6/2021,0,0,4,4,0,0,0,0,0,0,0,0,4,1,3,8,8,1,0,9
118614,2021,Poland,Slovenia,0,0,0,0,30/05/2021,0,0,0,0,0,0,0,0,0,0,0,0,0,0,0,0,0,0,0,0
118614,2021,Poland,Serbia,0,0,0,0,29/05/2021,0,0,3,3,0,0,0,0,0,0,0,0,8,2,7,17,6,2,0,8
118614,2021,Poland,Italy,0,0,0,0,28/05/2021,0,0,0,0,0,0,0,0,0,0,0,0,0,0,0,0,0,0,0,0
150734,2021,Brazil,Poland,1,3,8,12,27/06/2021,0,0,0,0,7,1,8,16,1,7,7,15,0,0,1,1,2,0,0,2
150734,2021,Poland,Slovenia,1,2,9,12,26/06/2021,0,0,1,1,2,1,3,6,2,1,5,8,1,0,0,1,2,0,0,2
150734,2021,France,Poland,0,3,12,15,23/06/2021,0,0,1,1,9,2,5,16,4,4,7,15,0,0,0,0,2,0,1,3
150734,2021,Poland,Argentina,2,4,8,14,21/06/2021,0,0,0,0,5,0,5,10,0,6,6,12,0,0,0,0,2,0,0,2
150734,2021,Germany,Poland,0,0,0,0,17/06/2021,0,0,0,0,0,0,0,0,0,0,0,0,0,0,0,0,0,0,0,0
150734,2021,Japan,Poland,3,4,10,17,16/06/2021,0,0,0,0,5,0,5,10,1,3,3,7,0,0,0,0,2,3,1,6
150734,2021,Poland,Brazil,1,1,6,8,11/6/2021,0,0,0,0,2,0,3,5,0,0,0,0,0,0,0,0,1,1,0,2
150734,2021,Poland,Netherlands,3,5,5,13,10/6/2021,0,0,0,0,11,2,2,15,2,1,6,9,0,0,0,0,0,0,0,0
150734,2021,Russia,Poland,2,3,13,18,5/6/2021,0,0,0,0,2,0,0,2,0,0,2,2,0,0,0,0,3,1,0,4
150734,2021,Poland,USA,0,2,8,10,4/6/2021,0,0,3,3,7,0,3,10,5,1,1,7,0,0,0,0,1,0,0,1
150734,2021,Australia,Poland,0,0,0,0,3/6/2021,0,0,0,0,0,0,0,0,0,0,0,0,0,0,0,0,0,0,0,0
150734,2021,Poland,Slovenia,2,1,17,20,30/05/2021,0,0,0,0,9,1,7,17,5,5,2,12,0,0,1,1,2,1,0,3
150734,2021,Poland,Italy,2,2,10,14,28/05/2021,0,0,0,0,8,1,2,11,2,2,7,11,1,0,0,1,3,1,1,5
152866,2021,Brazil,Poland,0,0,0,0,27/06/2021,0,0,0,0,0,0,0,0,0,0,0,0,0,0,0,0,0,0,0,0
152866,2021,Poland,Slovenia,0,0,0,0,26/06/2021,0,0,0,0,0,0,0,0,0,0,0,0,0,0,0,0,0,0,0,0
152866,2021,Iran,Poland,0,0,0,0,22/06/2021,0,0,0,0,0,0,0,0,0,0,0,0,0,0,0,0,0,0,0,0
152866,2021,Poland,Argentina,0,0,0,0,21/06/2021,0,0,0,0,0,0,0,0,0,0,0,0,0,0,0,0,0,0,0,0
152866,2021,Japan,Poland,1,2,9,12,16/06/2021,0,0,1,1,15,2,8,25,0,1,3,4,2,0,5,7,10,1,1,12
152866,2021,Canada,Poland,0,0,0,0,15/06/2021,0,0,0,0,0,0,0,0,0,0,0,0,0,0,0,0,0,0,0,0
152866,2021,Poland,Netherlands,2,1,6,9,10/6/2021,0,0,2,2,5,0,2,7,2,2,0,4,6,0,8,14,9,2,1,12
152866,2021,Poland,Bulgaria,0,0,0,0,9/6/2021,0,0,0,0,0,0,0,0,0,0,0,0,0,0,0,0,0,0,0,0
152866,2021,Russia,Poland,0,0,0,0,5/6/2021,0,0,0,0,0,0,0,0,0,0,0,0,0,0,0,0,0,0,0,0
152866,2021,Australia,Poland,4,3,6,13,3/6/2021,0,0,1,1,6,2,5,13,0,1,1,2,5,0,7,12,2,1,0,3
152866,2021,Poland,Slovenia,0,1,2,3,30/05/2021,0,0,0,0,0,0,0,0,0,0,0,0,0,0,0,0,0,1,0,1
152866,2021,Poland,Italy,1,2,8,11,28/05/2021,0,0,0,0,9,2,4,15,0,2,0,2,12,0,8,20,9,2,0,11
150742,2021,Iran,Poland,1,1,6,8,22/06/2021,0,0,3,3,4,7,3,14,3,1,1,5,3,1,8,12,6,1,0,7
150742,2021,Poland,Argentina,0,0,0,0,21/06/2021,0,0,0,0,0,0,0,0,0,0,0,0,0,0,0,0,0,0,0,0
150742,2021,Germany,Poland,0,0,0,0,17/06/2021,0,0,0,0,0,0,0,0,0,0,0,0,0,0,0,0,0,0,0,0
150742,2021,Poland,Brazil,0,0,0,0,11/6/2021,0,0,0,0,0,0,0,0,0,0,0,0,0,0,0,0,0,0,0,0
150742,2021,Poland,Bulgaria,2,1,8,11,9/6/2021,0,0,3,3,11,1,5,17,1,2,0,3,9,0,1,10,1,1,0,2
150742,2021,Poland,USA,2,2,5,9,4/6/2021,0,0,2,2,3,2,7,12,2,1,0,3,2,2,3,7,3,1,0,4
150742,2021,Australia,Poland,0,0,0,0,3/6/2021,0,0,0,0,0,0,0,0,0,0,0,0,0,0,0,0,0,0,0,0
150742,2021,Poland,Slovenia,0,0,0,0,30/05/2021,0,0,0,0,0,0,0,0,0,0,0,0,0,0,0,0,0,0,0,0
150742,2021,Poland,Italy,3,4,5,12,28/05/2021,0,0,0,0,3,5,10,18,1,2,1,4,8,0,6,14,3,1,1,5
118618,2021,France,Poland,0,0,0,0,23/06/2021,0,0,0,0,0,0,0,0,0,0,0,0,0,0,0,0,0,0,0,0
118618,2021,Poland,Argentina,0,0,8,8,21/06/2021,0,0,0,0,6,1,1,8,1,4,2,7,0,0,0,0,2,0,1,3
118618,2021,Japan,Poland,0,1,11,12,16/06/2021,0,0,0,0,1,1,2,4,1,4,4,9,0,0,0,0,3,1,0,4
118618,2021,Canada,Poland,0,0,0,0,15/06/2021,0,0,0,0,0,0,0,0,0,0,0,0,0,0,0,0,0,0,0,0
118618,2021,Poland,Netherlands,0,2,7,9,10/6/2021,0,0,0,0,2,1,1,4,2,1,1,4,0,0,0,0,0,1,0,1
118618,2021,Poland,Bulgaria,0,0,0,0,9/6/2021,0,0,0,0,0,0,0,0,0,0,0,0,0,0,0,0,0,0,0,0
118618,2021,Russia,Poland,1,1,18,20,5/6/2021,0,0,0,0,4,1,1,6,3,6,4,13,0,0,0,0,4,0,0,4
118618,2021,Poland,USA,0,0,0,0,4/6/2021,0,0,0,0,0,0,0,0,0,0,0,0,0,0,0,0,0,0,0,0
118618,2021,Poland,Slovenia,0,2,8,10,30/05/2021,0,0,2,2,6,0,2,8,1,4,2,7,0,0,2,2,0,1,0,1
118618,2021,Poland,Serbia,0,0,0,0,29/05/2021,0,0,0,0,0,0,0,0,0,0,0,0,0,0,0,0,0,0,0,0
118618,2021,Poland,Italy,0,1,8,9,28/05/2021,0,0,0,0,7,1,1,9,5,2,13,20,0,0,0,0,2,1,1,4
152869,2021,Brazil,Poland,0,0,0,0,27/06/2021,0,0,0,0,0,0,0,0,0,0,0,0,0,0,0,0,0,0,0,0
152869,2021,Iran,Poland,0,0,0,0,22/06/2021,0,0,0,0,0,0,0,0,0,0,0,0,0,0,0,0,0,0,0,0
152869,2021,Germany,Poland,0,0,0,0,17/06/2021,0,0,0,0,0,0,0,0,0,0,0,0,0,0,0,0,0,0,0,0
152869,2021,Japan,Poland,0,0,0,0,16/06/2021,0,0,0,0,0,0,0,0,0,0,0,0,0,0,0,0,0,0,0,0
152869,2021,Canada,Poland,0,0,0,0,15/06/2021,0,0,0,0,0,0,0,0,0,0,0,0,0,0,0,0,0,0,0,0
152869,2021,Poland,Netherlands,0,0,0,0,10/6/2021,0,0,0,0,0,0,0,0,0,0,0,0,0,0,0,0,0,0,0,0
152869,2021,Poland,Bulgaria,1,0,6,7,9/6/2021,0,0,0,0,7,0,2,9,3,3,2,8,0,0,0,0,2,2,0,4
152869,2021,Russia,Poland,0,0,0,0,5/6/2021,0,0,0,0,0,0,0,0,0,0,0,0,0,0,0,0,0,0,0,0
152869,2021,Australia,Poland,2,2,5,9,3/6/2021,0,0,0,0,2,0,2,4,1,3,1,5,1,0,0,1,0,0,0,0
152869,2021,Poland,Slovenia,0,0,0,0,30/05/2021,0,0,0,0,0,0,0,0,0,0,0,0,0,0,0,0,0,0,0,0
152869,2021,Poland,Serbia,1,3,5,9,29/05/2021,0,0,0,0,5,2,2,9,1,7,2,10,0,1,0,1,0,0,0,0
152869,2021,Poland,Italy,0,0,0,0,28/05/2021,0,0,0,0,0,0,0,0,0,0,0,0,0,0,0,0,0,0,0,0
168238,2021,Brazil,Russia,0,3,11,14,23/06/2021,0,0,1,1,10,4,11,25,2,1,0,3,1,2,12,15,3,2,2,7
168238,2021,Russia,Italy,0,0,5,5,22/06/2021,0,0,0,0,0,0,0,0,0,0,0,0,0,0,0,0,0,0,0,0
168238,2021,Germany,Russia,1,2,5,8,21/06/2021,0,0,0,0,0,0,0,0,0,0,0,0,0,0,0,0,0,0,0,0
168238,2021,Bulgaria,Russia,0,0,3,3,17/06/2021,0,0,0,0,0,0,0,0,0,0,0,0,0,0,0,0,0,0,0,0
168238,2021,Argentina,Russia,3,0,13,16,16/06/2021,0,0,6,6,7,3,8,18,2,4,2,8,6,3,13,22,8,1,1,10
168238,2021,Russia,Serbia,0,3,6,9,15/06/2021,0,0,1,1,9,1,4,14,1,2,2,5,3,0,9,12,3,1,0,4
168238,2021,Slovenia,Russia,0,0,0,0,11/6/2021,0,0,0,0,0,0,0,0,0,0,0,0,0,0,0,0,0,0,0,0
168238,2021,Russia,Canada,0,2,4,6,10/6/2021,0,0,0,0,2,2,4,8,0,1,0,1,4,0,9,13,4,1,0,5
168238,2021,France,Russia,1,0,2,3,9/6/2021,0,0,0,0,0,0,0,0,0,0,0,0,0,0,0,0,0,0,0,0
168238,2021,Russia,Australia,2,1,3,6,4/6/2021,0,0,2,2,5,3,8,16,0,1,0,1,8,1,8,17,1,1,0,2
168238,2021,Russia,USA,0,0,0,0,3/6/2021,0,0,0,0,0,0,0,0,0,0,0,0,0,0,0,0,0,0,0,0
168238,2021,Russia,Japan,0,6,17,23,30/05/2021,0,0,0,0,16,5,7,28,1,3,3,7,14,1,21,36,5,0,2,7
168238,2021,Iran,Russia,0,0,0,0,29/05/2021,0,0,0,0,0,0,0,0,0,0,0,0,0,0,0,0,0,0,0,0
168238,2021,Netherlands,Russia,0,3,7,10,28/05/2021,0,0,1,1,5,0,7,12,0,2,4,6,5,2,13,20,4,1,1,6
142651,2021,Brazil,Russia,1,2,4,7,23/06/2021,0,0,0,0,3,0,0,3,3,6,3,12,0,0,0,0,1,0,0,1
142651,2021,Russia,Italy,0,0,0,0,22/06/2021,0,0,0,0,0,0,0,0,0,0,0,0,0,0,0,0,0,0,0,0
142651,2021,Germany,Russia,1,4,4,9,21/06/2021,0,0,2,2,8,0,2,10,1,7,3,11,0,0,1,1,1,0,0,1
142651,2021,Bulgaria,Russia,0,3,1,4,17/06/2021,0,0,0,0,6,0,1,7,2,2,2,6,0,0,2,2,1,0,0,1
142651,2021,Argentina,Russia,0,0,0,0,16/06/2021,0,0,0,0,0,0,0,0,0,0,0,0,0,0,0,0,0,0,0,0
142651,2021,Russia,Serbia,0,0,0,0,15/06/2021,0,0,0,0,0,0,0,0,0,0,0,0,0,0,0,0,0,0,0,0
142651,2021,Slovenia,Russia,0,1,5,6,11/6/2021,0,0,0,0,1,1,5,7,2,5,2,9,0,0,0,0,2,0,1,3
142651,2021,Russia,Canada,0,2,9,11,10/6/2021,0,0,1,1,4,0,6,10,6,4,2,12,0,0,0,0,0,1,0,1
142651,2021,France,Russia,0,4,4,8,9/6/2021,0,0,0,0,6,2,3,11,2,9,8,19,0,0,2,2,2,0,1,3
142651,2021,Russia,Poland,0,0,0,0,5/6/2021,0,0,0,0,0,0,0,0,0,0,0,0,0,0,0,0,0,0,0,0
142651,2021,Russia,Australia,0,0,0,0,4/6/2021,0,0,0,0,0,0,0,0,0,0,0,0,0,0,0,0,0,0,0,0
142651,2021,Russia,USA,0,3,6,9,3/6/2021,0,0,0,0,11,0,5,16,1,4,3,8,0,0,2,2,0,0,0,0
142651,2021,Russia,Japan,0,0,0,0,30/05/2021,0,0,0,0,0,0,0,0,0,0,0,0,0,0,0,0,0,0,0,0
142651,2021,Iran,Russia,0,2,5,7,29/05/2021,0,0,0,0,6,0,4,10,4,12,3,19,0,0,0,0,1,0,0,1
142651,2021,Netherlands,Russia,0,2,6,8,28/05/2021,0,0,0,0,5,1,4,10,6,4,4,14,0,0,1,1,0,0,0,0
119817,2021,Brazil,Russia,1,1,9,11,23/06/2021,0,0,0,0,3,0,3,6,2,0,2,4,1,0,0,1,0,0,1,1
119817,2021,Russia,Italy,0,0,14,14,22/06/2021,0,0,0,0,5,1,2,8,0,1,3,4,0,0,0,0,0,0,0,0
119817,2021,Germany,Russia,0,0,0,0,21/06/2021,0,0,0,0,0,0,0,0,0,0,0,0,0,0,0,0,0,0,0,0
119817,2021,Bulgaria,Russia,0,2,2,4,17/06/2021,0,0,1,1,1,0,1,2,1,1,1,3,0,0,0,0,1,0,0,1
119817,2021,Argentina,Russia,0,2,13,15,16/06/2021,0,0,1,1,7,2,1,10,2,7,6,15,0,0,1,1,0,0,1,1
119817,2021,Russia,Serbia,0,0,12,12,15/06/2021,0,0,2,2,5,1,3,9,3,2,4,9,1,1,1,3,2,0,0,2
119817,2021,Slovenia,Russia,0,1,13,14,11/6/2021,0,1,0,1,5,1,0,6,4,6,5,15,0,0,1,1,1,0,0,1
119817,2021,Russia,Canada,1,3,15,19,10/6/2021,0,0,0,0,8,0,2,10,4,1,1,6,0,1,0,1,1,0,0,1
119817,2021,France,Russia,0,0,0,0,9/6/2021,0,0,0,0,0,0,0,0,0,0,0,0,0,0,0,0,0,0,0,0
119817,2021,Russia,Poland,0,1,8,9,5/6/2021,0,0,0,0,4,1,3,8,2,6,3,11,1,0,2,3,2,0,0,2
119817,2021,Russia,Australia,0,1,14,15,4/6/2021,0,0,1,1,5,3,1,9,3,2,0,5,0,0,0,0,0,1,0,1
119817,2021,Russia,USA,0,0,0,0,3/6/2021,0,0,0,0,0,0,0,0,0,0,0,0,0,0,0,0,0,0,0,0
119817,2021,Russia,Japan,0,0,11,11,30/05/2021,0,0,0,0,7,1,3,11,4,7,5,16,0,0,1,1,1,0,1,2
119817,2021,Iran,Russia,0,2,16,18,29/05/2021,0,0,0,0,7,0,1,8,3,4,6,13,0,0,0,0,1,0,0,1
119817,2021,Netherlands,Russia,3,0,12,15,28/05/2021,0,0,0,0,10,1,1,12,0,9,2,11,0,0,0,0,1,1,0,2
148521,2021,Brazil,Russia,0,0,0,0,23/06/2021,0,0,0,0,0,0,0,0,0,0,0,0,0,0,0,0,0,0,0,0
148521,2021,Russia,Italy,0,0,0,0,22/06/2021,0,0,0,0,0,0,0,0,0,0,0,0,0,0,0,0,0,0,0,0
148521,2021,Germany,Russia,0,0,0,0,21/06/2021,0,0,0,0,0,0,0,0,0,0,0,0,0,0,0,0,0,0,0,0
148521,2021,Bulgaria,Russia,0,0,0,0,17/06/2021,0,0,0,0,0,0,0,0,0,0,0,0,0,0,0,0,0,0,1,1
148521,2021,Argentina,Russia,0,0,0,0,16/06/2021,0,0,0,0,0,0,0,0,0,0,0,0,0,0,0,0,0,0,0,0
148521,2021,Russia,Serbia,0,0,0,0,15/06/2021,0,0,0,0,0,0,0,0,0,0,0,0,0,0,0,0,0,0,0,0
148521,2021,Slovenia,Russia,0,0,0,0,11/6/2021,0,0,3,3,0,0,0,0,0,0,0,0,7,2,13,22,7,1,0,8
148521,2021,Russia,Canada,0,0,0,0,10/6/2021,0,0,1,1,0,0,0,0,0,0,0,0,6,1,13,20,7,6,0,13
148521,2021,France,Russia,0,0,0,0,9/6/2021,0,0,2,2,0,0,0,0,0,0,0,0,3,2,18,23,8,1,2,11
148521,2021,Russia,Poland,0,0,0,0,5/6/2021,0,0,0,0,0,0,0,0,0,0,0,0,0,0,0,0,0,0,0,0
148521,2021,Russia,Australia,0,0,0,0,4/6/2021,0,0,1,1,0,0,0,0,0,0,0,0,6,1,2,9,2,1,0,3
148521,2021,Russia,USA,0,0,0,0,3/6/2021,0,0,0,0,0,0,0,0,0,0,0,0,0,0,0,0,0,0,0,0
148521,2021,Russia,Japan,0,0,0,0,30/05/2021,0,0,8,8,0,0,0,0,0,0,0,0,9,1,9,19,9,7,0,16
148521,2021,Iran,Russia,0,0,0,0,29/05/2021,0,0,0,0,0,0,0,0,0,0,0,0,0,0,1,1,0,0,0,0
148521,2021,Netherlands,Russia,0,0,0,0,28/05/2021,0,0,0,0,0,0,0,0,0,0,0,0,0,0,0,0,0,0,0,0
142648,2021,Brazil,Russia,0,1,2,3,23/06/2021,0,0,0,0,0,0,0,0,0,0,0,0,0,0,0,0,0,0,0,0
142648,2021,Russia,Italy,1,2,11,14,22/06/2021,0,0,2,2,13,7,10,30,2,4,1,7,4,1,23,28,6,4,1,11
142648,2021,Germany,Russia,2,4,13,19,21/06/2021,0,0,1,1,11,2,4,17,1,3,3,7,6,0,17,23,6,2,0,8
142648,2021,Bulgaria,Russia,1,3,5,9,17/06/2021,0,0,3,3,12,1,3,16,1,1,2,4,5,1,8,14,2,1,1,4
142648,2021,Argentina,Russia,0,0,2,2,16/06/2021,0,0,0,0,0,0,0,0,0,0,0,0,0,0,0,0,0,0,1,1
142648,2021,Russia,Serbia,0,1,3,4,15/06/2021,0,0,1,1,2,2,6,10,1,0,1,2,4,0,6,10,4,0,0,4
142648,2021,Slovenia,Russia,2,4,14,20,11/6/2021,0,1,4,5,14,6,8,28,0,1,1,2,3,2,16,21,9,2,1,12
142648,2021,Russia,Canada,2,4,15,21,10/6/2021,0,0,3,3,14,3,9,26,2,2,1,5,8,2,13,23,3,2,0,5
142648,2021,France,Russia,0,1,6,7,9/6/2021,0,0,2,2,6,3,6,15,0,1,1,2,3,1,6,10,3,2,0,5
142648,2021,Russia,Poland,1,5,8,14,5/6/2021,0,0,4,4,12,3,10,25,1,1,3,5,5,3,11,19,12,2,1,15
142648,2021,Russia,Australia,2,4,8,14,4/6/2021,0,0,0,0,9,1,8,18,2,2,0,4,13,0,4,17,4,0,0,4
142648,2021,Russia,Japan,0,0,0,0,30/05/2021,0,0,0,0,0,0,0,0,0,0,0,0,0,0,0,0,0,0,0,0
142648,2021,Iran,Russia,0,0,0,0,29/05/2021,0,0,0,0,0,0,0,0,0,0,0,0,0,0,0,0,0,0,0,0
142648,2021,Netherlands,Russia,0,0,0,0,28/05/2021,0,0,0,0,0,0,0,0,0,0,0,0,0,0,0,0,0,0,0,0
142657,2021,Brazil,Russia,0,0,0,0,23/06/2021,0,0,0,0,0,0,0,0,0,0,0,0,0,0,0,0,0,0,0,0
142657,2021,Germany,Russia,0,0,0,0,21/06/2021,0,0,0,0,0,0,0,0,0,0,0,0,0,0,0,0,0,0,0,0
153362,2021,Brazil,Russia,0,2,0,2,23/06/2021,0,0,0,0,0,0,0,0,0,0,0,0,0,0,0,0,0,0,0,0
153362,2021,Russia,Italy,0,3,6,9,22/06/2021,0,0,0,0,0,0,0,0,0,0,0,0,0,0,0,0,1,0,0,1
153362,2021,Germany,Russia,0,1,2,3,21/06/2021,0,0,1,1,0,0,0,0,0,0,0,0,0,0,0,0,0,0,0,0
153362,2021,Bulgaria,Russia,1,3,6,10,17/06/2021,0,0,6,6,6,1,5,12,2,4,0,6,3,3,7,13,7,1,1,9
153362,2021,Argentina,Russia,0,0,5,5,16/06/2021,0,0,1,1,0,0,0,0,0,0,0,0,0,0,0,0,0,0,0,0
153362,2021,Russia,Serbia,1,0,2,3,15/06/2021,0,0,0,0,0,0,0,0,0,0,0,0,0,0,0,0,0,0,0,0
153362,2021,Slovenia,Russia,1,1,4,6,11/6/2021,0,0,2,2,2,0,3,5,1,0,0,1,4,1,6,11,2,0,0,2
153362,2021,Russia,Canada,0,0,0,0,10/6/2021,0,0,0,0,0,0,0,0,0,0,0,0,0,0,0,0,0,0,0,0
153362,2021,France,Russia,0,3,5,8,9/6/2021,0,0,3,3,6,1,5,12,2,3,2,7,6,1,11,18,1,1,0,2
153362,2021,Russia,Poland,0,2,2,4,5/6/2021,0,0,4,4,3,3,2,8,0,2,2,4,3,1,7,11,1,0,0,1
153362,2021,Russia,Australia,0,0,2,2,4/6/2021,0,0,0,0,1,0,1,2,0,1,0,1,4,0,0,4,1,1,0,2
153362,2021,Russia,USA,0,1,1,2,3/6/2021,0,0,0,0,0,1,1,2,0,0,0,0,0,0,0,0,0,0,1,1
153362,2021,Russia,Japan,0,1,9,10,30/05/2021,0,0,0,0,6,2,7,15,0,3,1,4,2,0,5,7,4,0,1,5
153362,2021,Iran,Russia,1,3,13,17,29/05/2021,0,0,1,1,10,3,8,21,2,3,3,8,7,0,6,13,6,1,1,8
153362,2021,Netherlands,Russia,2,2,4,8,28/05/2021,0,0,0,0,2,1,3,6,0,2,0,2,2,1,2,5,1,0,0,1
136632,2021,Brazil,Russia,0,0,0,0,23/06/2021,0,0,0,0,0,0,0,0,0,0,0,0,0,0,0,0,0,0,0,0
136632,2021,Russia,Italy,1,2,3,6,22/06/2021,16,0,43,59,0,0,0,0,1,2,4,7,0,0,0,0,2,0,1,3
136632,2021,Germany,Russia,0,0,0,0,21/06/2021,0,0,0,0,0,0,0,0,0,0,0,0,0,0,0,0,0,0,0,0
136632,2021,Bulgaria,Russia,0,0,2,2,17/06/2021,0,0,0,0,0,0,0,0,0,0,0,0,0,0,0,0,0,1,0,1
136632,2021,Argentina,Russia,0,2,3,5,16/06/2021,7,1,20,28,1,0,0,1,1,1,1,3,0,0,0,0,4,1,0,5
136632,2021,Russia,Serbia,0,2,3,5,15/06/2021,10,0,22,32,0,0,0,0,0,1,1,2,0,0,0,0,3,1,0,4
136632,2021,Slovenia,Russia,0,0,2,2,11/6/2021,5,1,23,29,0,0,0,0,1,1,3,5,0,0,0,0,5,0,1,6
136632,2021,Russia,Canada,0,0,0,0,10/6/2021,0,0,0,0,0,0,0,0,0,0,0,0,0,0,0,0,0,0,0,0
136632,2021,France,Russia,0,3,5,8,9/6/2021,19,0,32,51,2,0,0,2,0,3,1,4,0,0,1,1,3,0,0,3
136632,2021,Russia,Poland,1,1,5,7,5/6/2021,16,1,30,47,0,0,0,0,1,3,2,6,0,0,0,0,1,1,0,2
136632,2021,Russia,Australia,0,0,0,0,4/6/2021,0,0,0,0,0,0,0,0,0,0,0,0,0,0,0,0,0,0,0,0
136632,2021,Russia,USA,0,1,15,16,3/6/2021,28,0,61,89,2,0,0,2,1,4,2,7,0,0,0,0,4,6,2,12
136632,2021,Russia,Japan,1,0,8,9,30/05/2021,22,0,46,68,0,0,1,1,4,2,3,9,0,0,0,0,3,1,2,6
136632,2021,Iran,Russia,1,1,9,11,29/05/2021,14,0,1,15,0,0,0,0,0,0,0,0,0,0,0,0,2,1,1,4
136632,2021,Netherlands,Russia,2,4,4,10,28/05/2021,17,0,20,37,0,0,0,0,0,2,0,2,0,0,1,1,1,2,0,3
122265,2021,Bulgaria,Russia,0,0,0,0,17/06/2021,0,0,0,0,0,0,0,0,0,0,0,0,0,0,0,0,0,0,0,0
122265,2021,Argentina,Russia,0,2,1,3,16/06/2021,0,0,3,3,8,2,3,13,2,1,2,5,0,0,0,0,4,2,1,7
122265,2021,Russia,Serbia,0,0,0,0,15/06/2021,0,0,0,0,0,0,0,0,0,0,0,0,0,0,0,0,0,0,0,0
122265,2021,France,Russia,1,1,4,6,9/6/2021,0,0,2,2,5,2,8,15,0,2,4,6,0,0,0,0,1,0,1,2
122265,2021,Russia,Poland,2,6,6,14,5/6/2021,0,0,2,2,6,0,3,9,0,3,3,6,0,1,0,1,1,0,1,2
122265,2021,Russia,Australia,0,4,6,10,4/6/2021,0,0,1,1,12,1,7,20,2,0,4,6,0,0,0,0,2,1,0,3
122265,2021,Russia,USA,0,1,2,3,3/6/2021,0,0,0,0,1,0,1,2,1,1,0,2,0,0,0,0,1,0,0,1
142635,2021,Brazil,Russia,0,0,0,0,23/06/2021,0,0,0,0,0,0,0,0,0,0,0,0,0,0,0,0,0,0,0,0
142635,2021,Russia,Italy,1,1,13,15,22/06/2021,0,0,1,1,14,5,5,24,0,4,1,5,0,0,0,0,1,0,1,2
142635,2021,Germany,Russia,0,0,0,0,21/06/2021,0,0,0,0,0,0,0,0,0,0,0,0,0,0,0,0,0,0,0,0
142635,2021,Bulgaria,Russia,0,3,9,12,17/06/2021,0,0,1,1,12,3,8,23,1,0,2,3,0,0,1,1,2,0,0,2
142635,2021,Argentina,Russia,1,1,7,9,16/06/2021,0,0,0,0,3,1,8,12,1,0,0,1,0,0,0,0,1,0,1,2
142635,2021,Russia,Serbia,0,0,2,2,15/06/2021,0,0,0,0,0,0,0,0,0,0,0,0,0,0,0,0,0,0,0,0
142635,2021,Slovenia,Russia,0,2,8,10,11/6/2021,0,0,0,0,6,2,5,13,0,4,2,6,0,0,0,0,2,0,0,2
142635,2021,Russia,Canada,0,0,0,0,10/6/2021,0,0,0,0,0,0,0,0,0,0,0,0,0,0,0,0,0,0,0,0
142635,2021,France,Russia,0,3,7,10,9/6/2021,0,0,0,0,5,1,3,9,0,1,3,4,0,0,0,0,1,0,0,1
142635,2021,Russia,Poland,0,1,0,1,5/6/2021,0,0,0,0,0,0,0,0,0,0,0,0,0,0,0,0,0,0,0,0
142635,2021,Russia,Australia,0,5,8,13,4/6/2021,0,0,0,0,14,4,6,24,0,4,2,6,0,0,0,0,2,2,0,4
142635,2021,Russia,USA,0,1,4,5,3/6/2021,0,0,0,0,0,0,0,0,0,0,0,0,0,0,0,0,0,0,0,0
142635,2021,Russia,Japan,1,0,6,7,30/05/2021,0,0,0,0,0,0,0,0,0,0,0,0,0,0,0,0,1,0,0,1
142635,2021,Iran,Russia,0,3,0,3,29/05/2021,0,0,0,0,2,0,0,2,0,0,0,0,0,0,0,0,0,0,0,0
142635,2021,Netherlands,Russia,0,0,3,3,28/05/2021,0,0,0,0,0,0,0,0,0,0,0,0,0,0,0,0,0,0,0,0
117184,2021,Brazil,Russia,2,3,10,15,23/06/2021,0,0,2,2,11,1,4,16,1,2,0,3,0,0,1,1,6,0,1,7
117184,2021,Russia,Italy,0,2,4,6,22/06/2021,0,0,0,0,5,2,2,9,2,3,2,7,0,0,0,0,2,1,0,3
117184,2021,Germany,Russia,1,2,9,12,21/06/2021,0,0,2,2,17,4,11,32,0,0,5,5,0,0,1,1,7,1,1,9
117184,2021,Bulgaria,Russia,0,0,0,0,17/06/2021,0,0,0,0,0,0,0,0,0,0,0,0,0,0,0,0,0,0,0,0
117184,2021,Argentina,Russia,0,2,1,3,16/06/2021,0,0,0,0,1,0,4,5,2,2,1,5,0,0,0,0,0,0,0,0
117184,2021,Russia,Serbia,0,3,9,12,15/06/2021,0,0,1,1,20,5,14,39,3,6,1,10,0,0,7,7,6,2,0,8
117184,2021,Slovenia,Russia,2,3,6,11,11/6/2021,0,0,2,2,7,3,9,19,1,3,1,5,0,0,0,0,5,1,0,6
117184,2021,Russia,Canada,2,3,18,23,10/6/2021,0,1,3,4,19,3,10,32,1,1,1,3,1,0,0,1,4,2,0,6
117184,2021,France,Russia,0,2,5,7,9/6/2021,0,0,0,0,2,3,2,7,0,0,0,0,0,0,1,1,0,0,0,0
117184,2021,Russia,Poland,2,2,15,19,5/6/2021,0,0,2,2,16,8,8,32,0,1,1,2,1,0,0,1,7,1,1,9
117184,2021,Russia,USA,1,3,18,22,3/6/2021,0,1,2,3,13,2,15,30,1,2,2,5,0,0,1,1,7,0,0,7
117184,2021,Russia,Japan,2,3,16,21,30/05/2021,0,0,0,0,20,4,14,38,1,6,2,9,1,0,4,5,8,2,1,11
117184,2021,Iran,Russia,2,4,7,13,29/05/2021,0,0,0,0,19,3,10,32,1,2,3,6,1,0,0,1,5,1,1,7
117184,2021,Netherlands,Russia,3,2,17,22,28/05/2021,0,0,0,0,17,7,8,32,4,1,1,6,1,0,1,2,7,1,0,8
152885,2021,Brazil,Russia,1,0,8,9,23/06/2021,0,0,2,2,11,3,5,19,1,3,0,4,4,0,14,18,2,1,0,3
152885,2021,Russia,Italy,1,4,14,19,22/06/2021,0,0,4,4,11,2,12,25,1,4,0,5,11,6,22,39,6,0,1,7
152885,2021,Germany,Russia,2,2,15,19,21/06/2021,1,0,2,3,11,6,9,26,1,1,2,4,3,0,14,17,5,0,0,5
152885,2021,Bulgaria,Russia,0,0,0,0,17/06/2021,0,0,0,0,0,0,0,0,0,0,0,0,0,0,0,0,0,0,0,0
152885,2021,Argentina,Russia,0,6,10,16,16/06/2021,0,0,6,6,14,3,14,31,1,4,1,6,10,0,16,26,4,1,0,5
152885,2021,Russia,Serbia,2,3,16,21,15/06/2021,0,0,7,7,9,3,15,27,2,1,0,3,13,2,11,26,5,1,0,6
152885,2021,Slovenia,Russia,0,3,7,10,11/6/2021,0,0,4,4,7,3,14,24,4,3,2,9,4,1,20,25,2,2,0,4
152885,2021,Russia,Canada,0,2,4,6,10/6/2021,0,0,1,1,4,1,6,11,0,0,0,0,3,3,2,8,2,0,0,2
152885,2021,France,Russia,1,2,15,18,9/6/2021,0,0,4,4,14,3,10,27,0,5,0,5,8,3,16,27,9,2,0,11
152885,2021,Russia,Poland,0,1,3,4,5/6/2021,0,0,1,1,4,4,4,12,0,1,2,3,2,2,6,10,1,1,0,2
152885,2021,Russia,USA,0,3,10,13,3/6/2021,0,0,3,3,17,3,8,28,0,5,0,5,6,0,12,18,12,1,2,15
152885,2021,Russia,Japan,3,4,5,12,30/05/2021,0,0,0,0,9,4,9,22,2,1,2,5,10,1,14,25,1,0,0,1
152885,2021,Iran,Russia,0,0,13,13,29/05/2021,0,0,0,0,10,1,5,16,0,5,3,8,4,2,16,22,3,0,3,6
152885,2021,Netherlands,Russia,0,4,8,12,28/05/2021,0,0,3,3,11,1,8,20,0,4,2,6,7,2,12,21,7,3,1,11
143711,2021,Brazil,Russia,0,0,2,2,23/06/2021,0,0,1,1,1,1,1,3,0,0,1,1,0,0,0,0,0,0,0,0
143711,2021,Russia,Italy,1,1,5,7,22/06/2021,0,0,0,0,8,1,0,9,3,2,4,9,0,0,0,0,1,1,0,2
143711,2021,Germany,Russia,0,3,3,6,21/06/2021,0,0,2,2,9,0,2,11,4,3,6,13,1,0,1,2,0,0,0,0
143711,2021,Bulgaria,Russia,0,3,5,8,17/06/2021,0,0,0,0,6,0,1,7,0,3,2,5,0,0,0,0,0,1,0,1
143711,2021,Argentina,Russia,0,2,6,8,16/06/2021,0,0,0,0,7,0,4,11,1,4,6,11,0,0,1,1,2,0,0,2
143711,2021,Russia,Serbia,2,4,6,12,15/06/2021,0,0,2,2,5,2,4,11,4,6,3,13,0,0,0,0,2,1,0,3
143711,2021,Slovenia,Russia,0,1,4,5,11/6/2021,0,0,0,0,5,1,2,8,1,2,1,4,0,0,0,0,0,1,0,1
143711,2021,Russia,Canada,0,0,0,0,10/6/2021,0,0,0,0,0,0,0,0,0,0,0,0,0,0,0,0,0,0,0,0
143711,2021,France,Russia,0,3,10,13,9/6/2021,0,0,0,0,8,0,4,12,1,5,2,8,0,0,1,1,3,0,0,3
143711,2021,Russia,Poland,0,0,0,0,5/6/2021,0,0,0,0,0,0,0,0,0,0,0,0,0,0,0,0,0,0,0,0
143711,2021,Russia,Australia,0,0,0,0,4/6/2021,0,0,0,0,0,0,0,0,0,0,0,0,0,0,0,0,0,0,0,0
143711,2021,Russia,USA,1,1,4,6,3/6/2021,0,0,2,2,3,0,3,6,1,2,1,4,0,0,0,0,1,0,0,1
143711,2021,Russia,Japan,0,2,11,13,30/05/2021,0,0,0,0,6,2,1,9,6,6,3,15,0,0,0,0,3,2,1,6
143711,2021,Iran,Russia,0,0,1,1,29/05/2021,0,0,0,0,1,0,0,1,0,1,0,1,0,0,1,1,0,0,0,0
143711,2021,Netherlands,Russia,0,0,0,0,28/05/2021,0,0,0,0,0,0,0,0,0,0,0,0,0,0,0,0,0,0,0,0
124794,2021,Brazil,Russia,2,3,8,13,23/06/2021,21,2,38,61,1,0,2,3,0,2,2,4,0,0,0,0,2,1,0,3
124794,2021,Russia,Italy,0,2,3,5,22/06/2021,12,0,20,32,0,0,0,0,0,5,0,5,0,0,0,0,0,0,0,0
124794,2021,Germany,Russia,1,2,18,21,21/06/2021,27,1,53,81,2,0,1,3,2,3,3,8,0,0,0,0,8,2,1,11
124794,2021,Bulgaria,Russia,4,4,13,21,17/06/2021,16,0,37,53,2,0,0,2,0,1,2,3,0,0,1,1,7,1,0,8
124794,2021,Argentina,Russia,1,3,9,13,16/06/2021,21,0,32,53,1,0,2,3,2,1,0,3,0,0,0,0,7,0,0,7
124794,2021,Russia,Serbia,2,0,14,16,15/06/2021,14,2,45,61,0,0,3,3,1,4,1,6,0,0,1,1,8,2,0,10
124794,2021,Slovenia,Russia,2,0,16,18,11/6/2021,20,0,44,64,0,0,0,0,0,5,3,8,0,0,0,0,3,2,4,9
124794,2021,Russia,Canada,1,3,7,11,10/6/2021,14,2,73,89,0,0,0,0,2,3,2,7,0,0,2,2,3,1,0,4
124794,2021,France,Russia,0,1,2,3,9/6/2021,14,0,26,40,0,0,0,0,0,3,1,4,0,0,0,0,1,1,0,2
124794,2021,Russia,Poland,0,1,4,5,5/6/2021,8,1,23,32,0,0,0,0,0,1,2,3,0,0,1,1,3,0,1,4
124794,2021,Russia,Australia,0,3,12,15,4/6/2021,18,0,62,80,0,0,1,1,0,2,3,5,0,0,0,0,1,0,0,1
124794,2021,Russia,USA,0,0,0,0,3/6/2021,0,0,0,0,0,0,0,0,0,0,0,0,0,0,0,0,0,0,0,0
124794,2021,Russia,Japan,0,2,5,7,30/05/2021,20,0,27,47,1,1,0,2,0,3,0,3,0,0,0,0,2,2,0,4
124794,2021,Iran,Russia,0,3,6,9,29/05/2021,23,0,0,23,2,1,0,3,0,1,2,3,0,0,0,0,4,0,2,6
124794,2021,Netherlands,Russia,0,1,3,4,28/05/2021,21,0,23,44,1,0,1,2,0,0,1,1,0,0,0,0,2,1,0,3
132391,2021,Brazil,Russia,0,0,0,0,23/06/2021,0,0,5,5,0,0,0,0,0,0,0,0,5,2,16,23,5,6,0,11
132391,2021,Russia,Italy,0,0,0,0,22/06/2021,0,0,6,6,0,0,0,0,0,0,0,0,6,1,11,18,11,3,1,15
132391,2021,Germany,Russia,0,0,0,0,21/06/2021,0,0,6,6,0,0,0,0,0,0,0,0,6,0,11,17,10,4,0,14
132391,2021,Bulgaria,Russia,0,0,0,0,17/06/2021,0,0,5,5,0,0,0,0,0,0,0,0,5,1,10,16,10,2,0,12
132391,2021,Argentina,Russia,0,0,0,0,16/06/2021,0,0,3,3,0,0,0,0,0,0,0,0,7,1,13,21,6,3,1,10
132391,2021,Russia,Serbia,0,0,0,0,15/06/2021,0,0,7,7,0,0,0,0,0,0,0,0,6,0,12,18,9,3,0,12
132391,2021,Slovenia,Russia,0,0,0,0,11/6/2021,0,0,0,0,0,0,0,0,0,0,0,0,0,0,0,0,0,0,0,0
132391,2021,Russia,Canada,0,0,0,0,10/6/2021,0,0,0,0,0,0,0,0,0,0,0,0,0,0,0,0,0,0,0,0
132391,2021,France,Russia,0,0,0,0,9/6/2021,0,0,0,0,0,0,0,0,0,0,0,0,0,0,0,0,0,0,0,0
132391,2021,Russia,Poland,0,0,0,0,5/6/2021,0,0,1,1,0,0,0,0,0,0,0,0,6,4,16,26,6,3,1,10
132391,2021,Russia,Australia,0,0,0,0,4/6/2021,0,0,2,2,0,0,0,0,0,0,0,0,3,0,7,10,4,3,0,7
132391,2021,Russia,USA,0,0,0,0,3/6/2021,0,0,5,5,0,0,0,0,0,0,0,0,9,2,17,28,7,1,1,9
132391,2021,Russia,Japan,0,0,0,0,30/05/2021,0,0,0,0,0,0,0,0,0,0,0,0,0,0,0,0,0,0,0,0
132391,2021,Iran,Russia,0,0,0,0,29/05/2021,0,0,0,0,0,0,0,0,0,0,0,0,8,1,12,21,17,2,0,19
132391,2021,Netherlands,Russia,0,0,0,0,28/05/2021,0,0,3,3,0,0,0,0,0,0,0,0,5,1,13,19,8,7,0,15
124926,2021,Argentina,Serbia,0,1,4,5,17/06/2021,0,0,1,1,3,4,3,10,0,0,0,0,1,0,7,8,1,0,0,1
124926,2021,Serbia,Bulgaria,2,2,8,12,16/06/2021,0,0,2,2,6,3,2,11,1,2,3,6,2,1,10,13,0,0,0,0
124926,2021,Russia,Serbia,2,4,11,17,15/06/2021,0,0,3,3,15,9,7,31,1,5,4,10,12,2,30,44,6,1,1,8
124926,2021,USA,Serbia,0,3,7,10,11/6/2021,0,0,0,0,20,5,8,33,2,2,2,6,8,2,18,28,1,5,0,6
124926,2021,Serbia,Iran,1,6,7,14,10/6/2021,0,0,3,3,18,4,13,35,1,4,1,6,9,1,19,29,5,2,1,8
124926,2021,Serbia,Germany,1,2,15,18,9/6/2021,0,0,5,5,9,1,11,21,1,5,0,6,3,1,11,15,6,2,1,9
124926,2021,Brazil,Serbia,0,4,11,15,5/6/2021,0,0,5,5,10,5,11,26,1,5,2,8,10,2,24,36,5,3,1,9
124926,2021,Serbia,France,1,5,11,17,4/6/2021,0,0,1,1,8,5,11,24,2,2,5,9,8,5,15,28,7,1,0,8
124926,2021,Japan,Serbia,0,0,16,16,3/6/2021,0,0,3,3,19,1,11,31,3,1,1,5,11,0,14,25,2,5,1,8
124926,2021,Serbia,Slovenia,0,4,13,17,28/05/2021,0,0,3,3,18,7,9,34,4,2,0,6,5,1,13,19,6,3,1,10
136360,2021,Canada,Serbia,0,0,0,0,23/06/2021,0,0,2,2,0,0,0,0,0,0,0,0,0,0,0,0,4,2,1,7
136360,2021,Serbia,Netherlands,0,0,0,0,22/06/2021,0,0,2,2,0,0,0,0,0,0,0,0,0,0,0,0,2,4,1,7
136360,2021,Australia,Serbia,0,0,0,0,21/06/2021,0,0,1,1,0,0,0,0,0,0,0,0,0,0,0,0,7,1,1,9
136360,2021,Argentina,Serbia,0,0,0,0,17/06/2021,0,0,0,0,0,0,0,0,0,0,0,0,0,0,0,0,0,0,0,0
136360,2021,Serbia,Bulgaria,0,0,0,0,16/06/2021,0,0,0,0,0,0,0,0,0,0,0,0,0,0,0,0,0,0,0,0
136360,2021,Russia,Serbia,0,0,0,0,15/06/2021,0,0,1,1,0,0,0,0,0,0,0,0,0,0,0,0,0,1,0,1
136360,2021,USA,Serbia,0,0,0,0,11/6/2021,0,0,1,1,0,0,0,0,0,0,0,0,0,0,0,0,1,3,0,4
136360,2021,Serbia,Iran,0,0,0,0,10/6/2021,0,0,0,0,0,0,0,0,0,0,0,0,0,0,0,0,0,0,0,0
136360,2021,Serbia,Germany,0,0,0,0,9/6/2021,0,0,0,0,0,0,0,0,0,0,0,0,0,0,0,0,4,0,1,5
136360,2021,Brazil,Serbia,0,0,0,0,5/6/2021,0,0,0,0,0,0,0,0,0,0,0,0,0,0,0,0,0,0,0,0
136360,2021,Serbia,France,0,0,0,0,4/6/2021,0,0,0,0,0,0,0,0,0,0,0,0,0,0,0,0,0,0,0,0
136360,2021,Japan,Serbia,0,0,0,0,3/6/2021,0,0,0,0,0,0,0,0,0,0,0,0,0,0,0,0,0,0,0,0
136360,2021,Serbia,Italy,0,0,0,0,30/05/2021,0,0,0,0,0,0,0,0,0,0,0,0,0,0,0,0,0,0,0,0
136360,2021,Poland,Serbia,0,0,0,0,29/05/2021,0,0,0,0,0,0,0,0,0,0,0,0,0,0,0,0,0,0,0,0
136360,2021,Serbia,Slovenia,0,0,0,0,28/05/2021,0,0,0,0,0,0,0,0,0,0,0,0,0,0,0,0,0,0,0,0
150383,2021,Canada,Serbia,0,0,0,0,23/06/2021,0,0,10,10,0,0,0,0,0,0,0,0,8,0,18,26,8,0,1,9
150383,2021,Serbia,Netherlands,0,0,0,0,22/06/2021,0,0,2,2,0,0,0,0,0,0,0,0,6,1,11,18,7,2,0,9
150383,2021,Australia,Serbia,0,0,0,0,21/06/2021,0,0,1,1,0,0,0,0,0,0,0,0,8,3,5,16,0,0,0,0
150383,2021,Argentina,Serbia,0,0,0,0,17/06/2021,0,0,4,4,0,0,0,0,0,0,0,0,5,1,15,21,6,5,2,13
150383,2021,Serbia,Bulgaria,0,0,0,0,16/06/2021,0,0,1,1,0,0,0,0,0,0,0,0,4,1,12,17,5,0,0,5
150383,2021,Russia,Serbia,0,0,0,0,15/06/2021,0,0,1,1,0,0,0,0,0,0,0,0,3,3,10,16,3,3,2,8
150383,2021,USA,Serbia,0,0,0,0,11/6/2021,0,0,4,4,0,0,0,0,0,0,0,0,2,2,19,23,2,3,1,6
150383,2021,Serbia,Iran,0,0,0,0,10/6/2021,0,0,9,9,0,0,0,0,0,0,0,0,10,1,16,27,5,8,0,13
150383,2021,Serbia,Germany,0,0,0,0,9/6/2021,0,0,2,2,0,0,0,0,0,0,0,0,3,1,16,20,1,1,0,2
150383,2021,Brazil,Serbia,0,0,0,0,5/6/2021,0,0,5,5,0,0,0,0,0,0,0,0,3,0,14,17,11,3,0,14
150383,2021,Serbia,France,0,0,0,0,4/6/2021,0,0,6,6,0,0,0,0,0,0,0,0,15,3,13,31,4,1,0,5
150383,2021,Japan,Serbia,0,0,0,0,3/6/2021,0,0,2,2,0,0,0,0,0,0,0,0,3,0,7,10,3,7,0,10
150383,2021,Serbia,Italy,0,0,0,0,30/05/2021,0,1,10,11,0,0,0,0,0,0,0,0,9,0,6,15,11,2,0,13
150383,2021,Poland,Serbia,0,0,0,0,29/05/2021,0,0,4,4,0,0,0,0,0,0,0,0,8,6,10,24,10,3,2,15
150383,2021,Serbia,Slovenia,0,0,0,0,28/05/2021,0,0,3,3,0,0,0,0,0,0,0,0,6,2,11,19,3,0,0,3
146579,2021,Canada,Serbia,0,5,13,18,23/06/2021,0,0,1,1,10,2,4,16,4,6,9,19,2,0,2,4,5,0,1,6
146579,2021,Serbia,Netherlands,3,1,16,20,22/06/2021,0,1,1,2,8,0,4,12,1,6,7,14,0,1,0,1,3,1,1,5
146579,2021,Australia,Serbia,3,3,8,14,21/06/2021,0,0,2,2,5,1,1,7,7,1,2,10,0,0,0,0,2,1,0,3
146579,2021,Argentina,Serbia,0,0,9,9,17/06/2021,0,0,2,2,4,2,1,7,3,1,4,8,0,0,0,0,0,1,0,1
146579,2021,Serbia,Bulgaria,2,1,13,16,16/06/2021,0,0,3,3,7,0,0,7,0,3,2,5,1,0,0,1,2,0,0,2
146579,2021,Russia,Serbia,0,0,15,15,15/06/2021,0,0,4,4,9,0,2,11,2,5,3,10,1,0,0,1,2,0,0,2
146579,2021,USA,Serbia,0,1,16,17,11/6/2021,0,0,1,1,7,1,2,10,2,5,1,8,0,0,0,0,1,2,0,3
146579,2021,Serbia,Iran,1,4,22,27,10/6/2021,0,0,5,5,9,3,3,15,1,3,2,6,1,0,1,2,6,2,0,8
146579,2021,Serbia,Germany,1,2,13,16,9/6/2021,0,0,1,1,6,0,2,8,2,3,8,13,0,0,1,1,1,1,2,4
146579,2021,Brazil,Serbia,0,1,12,13,5/6/2021,0,0,0,0,11,3,3,17,1,5,3,9,1,0,0,1,5,2,0,7
146579,2021,Serbia,France,0,3,13,16,4/6/2021,0,0,2,2,10,0,2,12,3,12,8,23,0,0,0,0,4,1,0,5
146579,2021,Japan,Serbia,0,2,14,16,3/6/2021,0,0,1,1,10,2,4,16,4,5,1,10,0,0,1,1,1,0,0,1
146579,2021,Serbia,Italy,0,3,10,13,30/05/2021,0,0,0,0,3,1,2,6,0,3,1,4,0,0,0,0,1,0,0,1
146579,2021,Poland,Serbia,0,3,13,16,29/05/2021,0,0,0,0,4,4,0,8,1,2,0,3,1,0,0,1,4,0,0,4
146579,2021,Serbia,Slovenia,0,2,11,13,28/05/2021,0,0,0,0,3,2,2,7,1,3,1,5,2,0,3,5,2,1,0,3
132022,2021,Canada,Serbia,5,5,19,29,23/06/2021,1,1,7,9,13,4,16,33,2,3,5,10,10,0,16,26,11,2,1,14
132022,2021,Serbia,Netherlands,1,4,12,17,22/06/2021,0,0,10,10,11,1,5,17,0,2,0,2,11,2,20,33,2,1,0,3
132022,2021,Australia,Serbia,2,0,8,10,21/06/2021,0,0,0,0,9,1,7,17,1,0,0,1,4,0,1,5,2,1,0,3
132022,2021,Argentina,Serbia,0,1,10,11,17/06/2021,0,0,2,2,11,3,9,23,1,3,1,5,4,1,13,18,2,0,0,2
132022,2021,Serbia,Bulgaria,3,1,15,19,16/06/2021,0,0,2,2,9,2,3,14,1,1,2,4,2,1,8,11,6,0,0,6
132022,2021,Russia,Serbia,0,4,10,14,15/06/2021,0,0,5,5,14,4,10,28,1,4,2,7,4,1,13,18,5,3,2,10
132022,2021,USA,Serbia,3,2,15,20,11/6/2021,0,0,2,2,9,0,7,16,2,3,1,6,9,2,3,14,6,4,1,11
132022,2021,Serbia,Iran,2,0,11,13,10/6/2021,0,0,1,1,4,1,4,9,0,1,1,2,4,2,4,10,2,5,0,7
132022,2021,Serbia,Germany,0,1,0,1,9/6/2021,0,0,1,1,0,1,3,4,0,0,0,0,2,2,4,8,4,0,0,4
132022,2021,Brazil,Serbia,2,2,9,13,5/6/2021,0,0,1,1,12,4,8,24,0,2,1,3,14,1,9,24,7,1,3,11
132022,2021,Serbia,France,0,3,13,16,4/6/2021,0,0,5,5,15,4,7,26,0,4,3,7,14,1,11,26,6,4,0,10
132022,2021,Japan,Serbia,1,4,10,15,3/6/2021,0,0,4,4,11,3,2,16,2,4,1,7,20,2,14,36,4,2,0,6
132022,2021,Serbia,Italy,0,3,9,12,30/05/2021,0,0,0,0,17,3,17,37,0,1,5,6,6,1,14,21,7,2,0,9
132022,2021,Poland,Serbia,1,3,10,14,29/05/2021,0,0,0,0,12,1,4,17,0,3,0,3,6,6,12,24,6,1,0,7
132022,2021,Serbia,Slovenia,0,2,17,19,28/05/2021,0,0,1,1,11,3,9,23,2,4,0,6,13,1,19,33,5,1,1,7
124911,2021,Canada,Serbia,0,0,0,0,23/06/2021,0,0,0,0,0,0,0,0,0,0,0,0,0,0,0,0,0,0,0,0
124911,2021,Serbia,Netherlands,0,2,8,10,22/06/2021,22,1,44,67,0,0,0,0,0,2,2,4,0,0,0,0,2,2,1,5
124911,2021,Australia,Serbia,0,0,2,2,21/06/2021,2,0,11,13,0,0,0,0,0,1,0,1,0,0,0,0,1,0,0,1
124911,2021,Argentina,Serbia,0,1,6,7,17/06/2021,20,0,43,63,0,0,0,0,0,0,1,1,0,0,0,0,4,2,1,7
124911,2021,Serbia,Bulgaria,0,0,7,7,16/06/2021,21,1,29,51,0,0,1,1,0,0,1,1,0,0,0,0,4,3,1,8
124911,2021,Russia,Serbia,1,1,13,15,15/06/2021,20,0,66,86,1,0,2,3,0,2,3,5,0,1,0,1,10,3,6,19
124911,2021,USA,Serbia,0,0,16,16,11/6/2021,19,0,60,79,0,0,0,0,1,1,0,2,0,0,2,2,4,3,0,7
124911,2021,Serbia,Iran,0,0,9,9,10/6/2021,34,0,55,89,0,0,0,0,0,1,2,3,0,0,0,0,8,3,1,12
124911,2021,Serbia,Germany,0,0,1,1,9/6/2021,5,1,3,9,0,0,1,1,0,0,0,0,0,0,0,0,2,0,1,3
124911,2021,Brazil,Serbia,0,1,10,11,5/6/2021,26,0,39,65,0,0,0,0,1,1,0,2,0,0,0,0,2,2,0,4
124911,2021,Serbia,France,0,1,16,17,4/6/2021,23,1,59,83,0,0,0,0,1,6,0,7,0,0,0,0,6,2,1,9
124911,2021,Japan,Serbia,0,0,18,18,3/6/2021,34,0,48,82,2,0,0,2,2,2,0,4,0,0,1,1,5,2,0,7
124911,2021,Serbia,Italy,1,2,13,16,30/05/2021,26,1,77,104,1,0,1,2,1,1,6,8,0,0,1,1,10,3,1,14
124911,2021,Poland,Serbia,0,2,9,11,29/05/2021,27,0,58,85,1,1,1,3,0,3,0,3,0,0,0,0,4,1,0,5
124911,2021,Serbia,Slovenia,0,3,14,17,28/05/2021,36,0,71,107,0,0,0,0,2,2,0,4,0,0,1,1,11,3,0,14
162122,2021,Canada,Serbia,2,1,15,18,23/06/2021,0,0,3,3,13,6,15,34,0,1,4,5,9,1,21,31,14,1,1,16
162122,2021,Serbia,Netherlands,0,3,8,11,22/06/2021,0,0,0,0,10,1,7,18,2,4,2,8,8,0,10,18,1,2,1,4
162122,2021,Australia,Serbia,0,1,2,3,21/06/2021,0,0,0,0,2,0,3,5,0,1,0,1,3,2,4,9,0,1,0,1
162122,2021,Argentina,Serbia,0,0,0,0,17/06/2021,0,0,0,0,0,0,0,0,0,0,0,0,0,0,0,0,0,0,0,0
162122,2021,Serbia,Bulgaria,0,0,0,0,16/06/2021,0,0,0,0,0,0,0,0,0,0,0,0,0,0,0,0,0,0,0,0
162122,2021,Russia,Serbia,0,0,0,0,15/06/2021,0,0,0,0,0,0,0,0,0,0,0,0,0,0,0,0,0,0,0,0
162122,2021,USA,Serbia,0,0,0,0,11/6/2021,0,0,0,0,0,0,0,0,0,0,0,0,0,0,0,0,0,0,0,0
162122,2021,Serbia,Iran,0,0,0,0,10/6/2021,0,0,0,0,0,0,0,0,0,0,0,0,0,0,0,0,0,0,0,0
162122,2021,Serbia,Germany,0,0,0,0,9/6/2021,0,0,0,0,0,0,0,0,0,0,0,0,0,0,0,0,0,0,0,0
162122,2021,Brazil,Serbia,0,0,0,0,5/6/2021,0,0,0,0,0,0,0,0,0,0,0,0,0,0,0,0,0,0,0,0
162122,2021,Serbia,France,0,0,0,0,4/6/2021,0,0,0,0,0,0,0,0,0,0,0,0,0,0,0,0,0,0,0,0
162122,2021,Japan,Serbia,0,0,0,0,3/6/2021,0,0,0,0,0,0,0,0,0,0,0,0,0,0,0,0,0,0,0,0
162122,2021,Serbia,Italy,0,0,0,0,30/05/2021,0,0,0,0,0,0,0,0,0,0,0,0,0,0,0,0,0,0,0,0
162122,2021,Poland,Serbia,0,1,0,1,29/05/2021,0,0,0,0,1,1,3,5,0,0,0,0,1,2,1,4,3,1,0,4
173249,2021,Canada,Serbia,0,0,0,0,23/06/2021,0,0,0,0,0,0,0,0,0,0,0,0,0,0,0,0,0,0,0,0
173249,2021,Serbia,Netherlands,0,0,0,0,22/06/2021,0,0,0,0,0,0,0,0,0,0,0,0,0,0,0,0,0,0,0,0
173249,2021,Australia,Serbia,0,0,0,0,21/06/2021,0,0,0,0,0,0,0,0,0,0,0,0,0,0,0,0,0,0,0,0
173249,2021,Poland,Serbia,0,0,0,0,29/05/2021,0,0,0,0,0,0,0,0,0,0,0,0,0,0,0,0,0,0,0,0
173249,2021,Serbia,Slovenia,0,0,0,0,28/05/2021,1,0,1,2,0,0,0,0,0,0,0,0,0,0,0,0,0,0,0,0
173251,2021,Canada,Serbia,0,0,0,0,23/06/2021,0,0,0,0,0,0,0,0,0,0,0,0,0,0,0,0,0,0,0,0
173251,2021,Serbia,Netherlands,0,3,4,7,22/06/2021,0,0,0,0,6,2,2,10,1,0,1,2,1,2,9,12,2,1,1,4
173251,2021,Australia,Serbia,0,3,6,9,21/06/2021,0,0,1,1,7,2,7,16,0,0,2,2,8,0,8,16,3,0,1,4
173251,2021,Argentina,Serbia,1,2,4,7,17/06/2021,0,0,0,0,2,2,3,7,1,0,1,2,2,1,12,15,0,0,1,1
173251,2021,Serbia,Bulgaria,0,0,0,0,16/06/2021,0,0,0,0,0,0,0,0,0,0,0,0,0,0,0,0,0,0,0,0
173251,2021,Russia,Serbia,0,0,0,0,15/06/2021,0,0,0,0,0,0,0,0,0,0,0,0,0,0,0,0,0,0,0,0
173251,2021,USA,Serbia,0,0,0,0,11/6/2021,0,0,0,0,0,0,0,0,0,0,0,0,0,0,0,0,0,0,0,0
173251,2021,Serbia,Iran,1,4,8,13,10/6/2021,0,0,1,1,5,4,5,14,1,1,2,4,4,2,3,9,6,1,0,7
173251,2021,Serbia,Germany,2,6,5,13,9/6/2021,0,0,2,2,12,3,4,19,1,2,3,6,3,2,7,12,7,3,2,12
173251,2021,Brazil,Serbia,0,0,0,0,5/6/2021,0,0,0,0,0,0,0,0,0,0,0,0,0,0,0,0,0,0,0,0
173251,2021,Serbia,France,0,0,0,0,4/6/2021,0,0,0,0,0,0,0,0,0,0,0,0,0,0,0,0,0,0,0,0
173251,2021,Japan,Serbia,0,0,0,0,3/6/2021,0,0,0,0,0,0,0,0,0,0,0,0,0,0,0,0,0,0,0,0
173251,2021,Serbia,Italy,0,6,6,12,30/05/2021,0,0,0,0,9,3,8,20,3,2,1,6,9,0,23,32,8,3,0,11
173251,2021,Poland,Serbia,0,1,5,6,29/05/2021,0,0,0,0,3,1,2,6,1,1,0,2,1,1,7,9,2,0,0,2
173251,2021,Serbia,Slovenia,0,0,0,0,28/05/2021,0,0,0,0,0,0,0,0,0,0,0,0,0,0,0,0,0,0,0,0
143792,2021,Argentina,Serbia,0,0,7,7,17/06/2021,0,0,1,1,4,0,0,4,0,3,0,3,0,0,0,0,1,1,0,2
143792,2021,Serbia,Bulgaria,0,0,0,0,16/06/2021,0,0,0,0,1,0,0,1,0,0,1,1,0,0,0,0,0,0,0,0
143792,2021,Russia,Serbia,0,0,0,0,15/06/2021,0,0,0,0,0,0,0,0,0,0,0,0,0,0,0,0,0,0,0,0
143792,2021,USA,Serbia,0,0,0,0,11/6/2021,0,0,0,0,0,0,0,0,0,0,0,0,0,0,0,0,0,0,0,0
143792,2021,Serbia,Iran,0,0,0,0,10/6/2021,0,0,0,0,0,0,0,0,0,0,0,0,0,0,0,0,0,0,0,0
143792,2021,Serbia,Germany,0,0,0,0,9/6/2021,0,0,0,0,0,0,0,0,0,0,0,0,0,0,0,0,0,0,0,0
143792,2021,Brazil,Serbia,0,1,6,7,5/6/2021,0,0,0,0,3,0,1,4,0,3,1,4,0,0,0,0,1,0,0,1
143792,2021,Serbia,France,0,0,0,0,4/6/2021,0,0,0,0,0,0,0,0,0,0,0,0,0,0,0,0,0,0,0,0
143792,2021,Japan,Serbia,0,0,0,0,3/6/2021,0,0,0,0,0,0,0,0,0,0,0,0,0,0,0,0,0,0,0,0
143792,2021,Serbia,Italy,0,0,7,7,30/05/2021,0,0,0,0,3,0,0,3,3,3,1,7,0,0,3,3,1,2,0,3
143792,2021,Poland,Serbia,0,0,1,1,29/05/2021,0,0,0,0,0,0,1,1,0,0,0,0,0,0,0,0,0,0,0,0
143792,2021,Serbia,Slovenia,0,0,0,0,28/05/2021,0,0,0,0,0,0,0,0,0,0,0,0,0,0,0,0,0,0,0,0
124915,2021,Canada,Serbia,0,4,3,7,23/06/2021,0,0,2,2,12,8,9,29,0,3,5,8,0,0,0,0,8,1,1,10
124915,2021,Serbia,Netherlands,0,0,0,0,22/06/2021,0,0,0,0,0,0,0,0,0,0,0,0,0,0,0,0,0,0,0,0
124915,2021,Australia,Serbia,0,4,11,15,21/06/2021,0,0,3,3,19,4,6,29,0,3,0,3,0,0,0,0,3,1,0,4
124915,2021,Argentina,Serbia,0,1,3,4,17/06/2021,0,0,1,1,1,0,1,2,0,1,0,1,0,0,0,0,0,1,0,1
124915,2021,Serbia,Bulgaria,1,3,5,9,16/06/2021,0,0,1,1,11,5,3,19,0,1,5,6,0,0,0,0,4,2,2,8
124915,2021,Russia,Serbia,0,1,9,10,15/06/2021,0,0,2,2,7,6,7,20,2,1,2,5,0,0,0,0,2,1,2,5
124915,2021,USA,Serbia,2,4,9,15,11/6/2021,0,0,1,1,15,5,7,27,0,3,2,5,0,1,0,1,4,6,0,10
124915,2021,Serbia,Iran,0,0,2,2,10/6/2021,0,0,1,1,2,1,0,3,0,0,0,0,0,0,0,0,0,0,0,0
124915,2021,Serbia,Germany,0,1,0,1,9/6/2021,0,0,0,0,1,0,1,2,0,1,2,3,0,0,0,0,0,0,0,0
124915,2021,Brazil,Serbia,1,1,10,12,5/6/2021,0,0,1,1,10,8,6,24,1,1,2,4,0,0,0,0,1,1,1,3
124915,2021,Serbia,France,2,4,11,17,4/6/2021,0,0,2,2,20,3,7,30,2,1,4,7,0,0,0,0,3,0,0,3
124915,2021,Japan,Serbia,0,4,9,13,3/6/2021,0,0,2,2,7,4,7,18,1,3,4,8,0,0,0,0,2,0,0,2
124915,2021,Serbia,Italy,0,1,1,2,30/05/2021,0,0,0,0,0,0,3,3,0,0,1,1,0,0,0,0,1,0,0,1
124915,2021,Poland,Serbia,2,1,11,14,29/05/2021,0,0,0,0,9,8,10,27,0,2,0,2,0,0,1,1,4,1,0,5
124915,2021,Serbia,Slovenia,0,0,0,0,28/05/2021,0,0,0,0,0,0,0,0,0,0,0,0,0,0,0,0,0,0,0,0
143794,2021,Canada,Serbia,1,4,1,6,23/06/2021,0,0,2,2,7,6,6,19,1,0,2,3,0,0,0,0,1,0,0,1
143794,2021,Serbia,Netherlands,8,4,15,27,22/06/2021,0,0,2,2,24,8,10,42,1,6,1,8,0,0,0,0,3,2,0,5
143794,2021,Australia,Serbia,0,0,0,0,21/06/2021,0,0,0,0,0,0,0,0,0,0,0,0,0,0,0,0,0,0,0,0
143794,2021,Argentina,Serbia,1,5,6,12,17/06/2021,0,0,2,2,10,5,6,21,1,2,4,7,0,0,0,0,5,0,1,6
143794,2021,Serbia,Bulgaria,0,0,0,0,16/06/2021,0,0,0,0,0,0,0,0,0,0,0,0,0,0,0,0,0,0,0,0
143794,2021,Russia,Serbia,0,2,2,4,15/06/2021,0,0,0,0,4,4,2,10,0,0,0,0,0,0,0,0,1,1,0,2
143794,2021,USA,Serbia,0,0,0,0,11/6/2021,0,0,0,0,0,0,0,0,0,0,0,0,0,0,0,0,0,0,0,0
143794,2021,Serbia,Iran,1,5,7,13,10/6/2021,0,0,2,2,21,3,8,32,1,2,3,6,0,0,0,0,7,1,0,8
143794,2021,Serbia,Germany,2,5,6,13,9/6/2021,0,0,1,1,13,4,11,28,0,1,2,3,0,0,0,0,3,3,0,6
143794,2021,Brazil,Serbia,1,2,1,4,5/6/2021,0,0,0,0,0,5,3,8,0,1,0,1,0,0,0,0,0,2,0,2
143794,2021,Serbia,France,0,2,3,5,4/6/2021,0,0,0,0,5,0,0,5,0,0,0,0,0,0,0,0,0,0,0,0
143794,2021,Japan,Serbia,0,2,0,2,3/6/2021,0,0,3,3,0,0,5,5,1,2,0,3,0,0,0,0,0,0,0,0
143794,2021,Serbia,Italy,2,7,10,19,30/05/2021,0,0,0,0,18,5,17,40,1,3,3,7,0,0,0,0,4,1,0,5
143794,2021,Poland,Serbia,2,0,3,5,29/05/2021,0,0,0,0,4,0,2,6,0,0,0,0,0,0,0,0,0,0,0,0
143794,2021,Serbia,Slovenia,1,6,8,15,28/05/2021,0,0,1,1,27,6,11,44,1,4,1,6,0,0,0,0,3,1,0,4
116525,2021,Canada,Serbia,0,6,6,12,23/06/2021,0,0,3,3,6,2,1,9,2,2,7,11,1,0,1,2,1,1,0,2
116525,2021,Serbia,Netherlands,0,1,11,12,22/06/2021,0,0,1,1,5,4,2,11,0,5,6,11,1,0,1,2,5,1,0,6
116525,2021,Australia,Serbia,0,2,18,20,21/06/2021,0,0,2,2,7,1,1,9,3,5,1,9,1,0,0,1,3,0,0,3
116525,2021,Argentina,Serbia,0,2,6,8,17/06/2021,0,0,1,1,3,1,2,6,1,5,0,6,0,0,0,0,1,1,0,2
116525,2021,Serbia,Bulgaria,1,1,9,11,16/06/2021,0,0,4,4,7,0,1,8,5,4,3,12,0,0,0,0,1,1,0,2
116525,2021,Russia,Serbia,0,3,14,17,15/06/2021,0,0,2,2,5,0,2,7,1,8,5,14,0,0,0,0,1,1,0,2
116525,2021,USA,Serbia,0,3,14,17,11/6/2021,0,0,0,0,4,1,2,7,4,3,1,8,0,0,1,1,1,1,0,2
116525,2021,Serbia,Iran,3,2,16,21,10/6/2021,0,0,2,2,6,0,2,8,8,4,4,16,0,0,1,1,3,3,2,8
116525,2021,Serbia,Germany,1,3,10,14,9/6/2021,0,0,2,2,3,0,3,6,4,3,4,11,0,0,0,0,3,0,1,4
116525,2021,Brazil,Serbia,0,0,7,7,5/6/2021,0,0,0,0,3,0,1,4,1,2,2,5,0,0,0,0,1,1,0,2
116525,2021,Serbia,France,0,4,18,22,4/6/2021,0,0,1,1,4,2,2,8,3,6,5,14,0,0,0,0,2,0,0,2
116525,2021,Japan,Serbia,0,3,9,12,3/6/2021,0,0,1,1,9,1,1,11,4,3,1,8,0,0,0,0,1,1,0,2
116525,2021,Serbia,Italy,1,0,14,15,30/05/2021,0,0,0,0,10,2,2,14,3,4,6,13,0,0,1,1,0,0,1,1
116525,2021,Poland,Serbia,1,2,11,14,29/05/2021,0,0,0,0,11,0,4,15,1,6,4,11,0,0,0,0,3,1,0,4
116525,2021,Serbia,Slovenia,2,2,20,24,28/05/2021,0,0,1,1,4,1,1,6,4,6,2,12,0,0,1,1,4,0,0,4
173250,2021,Canada,Serbia,0,2,11,13,23/06/2021,28,1,84,113,1,0,0,1,0,1,3,4,0,0,1,1,7,2,0,9
173250,2021,Serbia,Netherlands,0,0,4,4,22/06/2021,6,0,18,24,0,0,0,0,0,1,0,1,0,0,0,0,1,0,0,1
173250,2021,Australia,Serbia,1,2,15,18,21/06/2021,19,2,42,63,0,0,0,0,0,2,3,5,0,0,0,0,1,0,0,1
173250,2021,Argentina,Serbia,0,0,0,0,17/06/2021,0,0,4,4,0,0,0,0,0,0,0,0,0,0,0,0,1,1,0,2
173250,2021,Serbia,Bulgaria,0,0,0,0,16/06/2021,0,0,0,0,0,0,0,0,0,0,0,0,0,0,0,0,0,0,0,0
173250,2021,Russia,Serbia,0,0,0,0,15/06/2021,2,0,2,4,0,0,0,0,0,0,0,0,0,0,0,0,0,0,0,0
173250,2021,USA,Serbia,0,0,0,0,11/6/2021,0,0,0,0,0,0,0,0,0,0,0,0,0,0,0,0,0,0,0,0
173250,2021,Serbia,Iran,0,0,0,0,10/6/2021,3,0,0,3,0,0,0,0,0,0,0,0,0,0,1,1,0,0,0,0
173250,2021,Serbia,Germany,0,2,13,15,9/6/2021,25,0,39,64,1,0,0,1,0,1,3,4,0,0,0,0,4,1,0,5
173250,2021,Brazil,Serbia,0,0,4,4,5/6/2021,12,0,20,32,0,0,1,1,1,1,1,3,0,0,0,0,2,1,0,3
173250,2021,Serbia,France,0,0,0,0,4/6/2021,2,0,4,6,0,0,0,0,0,0,0,0,0,0,0,0,1,0,0,1
173250,2021,Japan,Serbia,0,0,0,0,3/6/2021,1,0,2,3,0,0,0,0,0,1,0,1,0,0,0,0,0,0,0,0
173250,2021,Serbia,Italy,0,0,0,0,30/05/2021,0,0,7,7,0,0,0,0,0,0,0,0,0,0,0,0,1,1,0,2
168276,2021,Canada,Serbia,0,0,0,0,23/06/2021,0,0,0,0,0,0,0,0,0,0,0,0,0,0,0,0,0,0,0,0
168276,2021,Serbia,Netherlands,0,0,0,0,22/06/2021,0,0,0,0,0,0,0,0,0,0,0,0,0,0,0,0,0,0,0,0
168276,2021,Australia,Serbia,0,0,0,0,21/06/2021,0,0,0,0,0,1,0,1,0,0,0,0,0,0,0,0,0,0,0,0
168276,2021,Serbia,Italy,0,0,0,0,30/05/2021,0,0,0,0,0,0,0,0,0,0,0,0,0,0,0,0,0,0,0,0
168276,2021,Poland,Serbia,0,0,0,0,29/05/2021,0,0,0,0,0,0,0,0,0,0,0,0,0,0,0,0,0,0,0,0
146751,2021,Canada,Serbia,0,0,0,0,23/06/2021,0,0,0,0,0,0,0,0,0,0,0,0,0,0,0,0,0,0,0,0
146751,2021,Serbia,Netherlands,0,0,0,0,22/06/2021,0,0,0,0,0,0,0,0,0,0,0,0,0,0,3,3,0,0,0,0
146751,2021,Australia,Serbia,0,0,2,2,21/06/2021,0,0,1,1,3,1,1,5,0,1,0,1,3,1,8,12,0,2,0,2
146751,2021,Argentina,Serbia,0,0,0,0,17/06/2021,0,0,0,0,0,0,0,0,0,0,0,0,0,0,1,1,0,0,0,0
146751,2021,Serbia,Bulgaria,0,0,0,0,16/06/2021,0,0,1,1,1,0,3,4,0,0,0,0,1,0,2,3,3,0,0,3
146751,2021,Russia,Serbia,0,0,0,0,15/06/2021,0,0,0,0,0,0,0,0,0,0,0,0,0,0,0,0,0,0,0,0
146751,2021,USA,Serbia,0,0,0,0,11/6/2021,0,0,0,0,0,0,0,0,0,0,0,0,0,0,1,1,0,0,0,0
146751,2021,Serbia,Iran,0,0,0,0,10/6/2021,0,0,0,0,0,0,0,0,0,0,0,0,1,1,1,3,0,0,0,0
146751,2021,Serbia,Germany,0,1,0,1,9/6/2021,0,0,1,1,0,0,1,1,1,0,1,2,1,0,3,4,1,0,0,1
146751,2021,Brazil,Serbia,0,0,0,0,5/6/2021,0,0,0,0,0,0,0,0,0,0,0,0,0,0,0,0,0,0,0,0
146751,2021,Serbia,France,0,0,0,0,4/6/2021,0,0,0,0,0,0,0,0,0,0,0,0,0,0,0,0,0,0,0,0
146751,2021,Japan,Serbia,0,0,0,0,3/6/2021,0,0,0,0,0,0,0,0,0,0,0,0,0,0,0,0,0,0,0,0
146751,2021,Serbia,Italy,0,0,0,0,30/05/2021,0,0,0,0,0,0,0,0,0,0,0,0,0,0,0,0,0,0,0,0
146751,2021,Poland,Serbia,0,2,0,2,29/05/2021,0,0,0,0,0,2,3,5,0,1,1,2,5,2,6,13,2,0,0,2
146751,2021,Serbia,Slovenia,0,0,0,0,28/05/2021,0,0,0,0,0,0,0,0,0,0,0,0,0,0,0,0,0,0,0,0
151390,2021,France,Slovenia,0,2,7,9,27/06/2021,0,0,0,0,11,1,6,18,1,8,1,10,0,0,0,0,3,1,0,4
151390,2021,Poland,Slovenia,3,3,8,14,26/06/2021,0,0,2,2,7,4,10,21,2,5,2,9,0,0,0,0,2,0,0,2
151390,2021,Slovenia,Bulgaria,0,1,11,12,23/06/2021,0,0,0,0,12,3,4,19,1,3,1,5,0,0,0,0,1,0,0,1
151390,2021,Japan,Slovenia,1,3,6,10,22/06/2021,0,0,0,0,11,2,7,20,2,3,1,6,0,0,1,1,5,0,0,5
151390,2021,Slovenia,USA,1,6,12,19,21/06/2021,0,0,2,2,15,8,5,28,2,2,0,4,0,0,0,0,7,2,2,11
151390,2021,Iran,Slovenia,2,4,12,18,17/06/2021,0,0,1,1,8,7,9,24,1,5,1,7,0,0,0,0,3,1,0,4
151390,2021,Brazil,Slovenia,0,4,10,14,15/06/2021,0,0,2,2,15,4,7,26,0,2,2,4,0,0,0,0,2,1,0,3
151390,2021,Slovenia,Russia,1,5,6,12,11/6/2021,0,0,4,4,5,8,4,17,0,3,2,5,0,0,0,0,7,2,0,9
151390,2021,Slovenia,Canada,2,3,12,17,9/6/2021,0,0,3,3,14,4,5,23,1,1,0,2,0,0,0,0,6,1,1,8
151390,2021,Slovenia,Germany,0,2,3,5,5/6/2021,0,0,1,1,12,2,5,19,1,6,2,9,0,0,0,0,3,0,0,3
151390,2021,Argentina,Slovenia,1,3,8,12,4/6/2021,0,0,2,2,6,3,7,16,0,1,0,1,0,0,0,0,2,0,0,2
151390,2021,Netherlands,Slovenia,1,2,12,15,3/6/2021,0,0,1,1,10,3,4,17,1,2,3,6,0,0,0,0,5,1,1,7
151390,2021,Poland,Slovenia,1,3,10,14,30/05/2021,0,0,2,2,15,3,19,37,2,4,0,6,0,0,0,0,0,1,0,1
151390,2021,Italy,Slovenia,0,0,0,0,29/05/2021,0,0,0,0,0,0,0,0,0,0,0,0,0,0,0,0,0,0,0,0
151390,2021,Serbia,Slovenia,0,5,9,14,28/05/2021,0,0,0,0,13,9,5,27,1,3,1,5,0,0,0,0,5,4,0,9
114962,2021,France,Slovenia,1,3,9,13,27/06/2021,0,0,0,0,3,1,3,7,1,3,4,8,1,0,1,2,1,0,0,1
114962,2021,Poland,Slovenia,2,3,8,13,26/06/2021,0,0,0,0,7,1,2,10,0,2,3,5,0,0,1,1,2,0,0,2
114962,2021,Slovenia,Bulgaria,1,0,11,12,23/06/2021,0,0,0,0,5,2,0,7,0,1,1,2,0,0,0,0,2,0,0,2
114962,2021,Japan,Slovenia,1,0,9,10,22/06/2021,0,0,0,0,3,0,0,3,0,1,0,1,0,0,0,0,0,0,0,0
114962,2021,Slovenia,USA,1,6,11,18,21/06/2021,0,0,0,0,8,0,4,12,4,4,3,11,0,0,3,3,2,0,0,2
114962,2021,Iran,Slovenia,0,4,12,16,17/06/2021,0,0,4,4,8,1,3,12,1,2,1,4,2,0,0,2,4,0,0,4
114962,2021,Slovenia,Australia,3,4,21,28,16/06/2021,0,0,1,1,7,1,0,8,0,1,4,5,1,0,2,3,4,1,0,5
114962,2021,Brazil,Slovenia,1,3,14,18,15/06/2021,0,0,1,1,8,1,4,13,4,6,4,14,0,0,0,0,1,2,0,3
114962,2021,Slovenia,Russia,1,5,10,16,11/6/2021,0,0,1,1,6,1,4,11,1,2,6,9,0,0,0,0,3,0,1,4
114962,2021,France,Slovenia,1,7,6,14,10/6/2021,0,0,0,0,11,1,3,15,1,4,5,10,0,0,0,0,2,0,0,2
114962,2021,Slovenia,Canada,1,3,10,14,9/6/2021,0,0,0,0,4,0,1,5,0,3,5,8,1,0,0,1,0,0,0,0
114962,2021,Slovenia,Germany,0,2,8,10,5/6/2021,0,0,1,1,5,2,3,10,0,1,9,10,1,0,2,3,2,0,0,2
114962,2021,Argentina,Slovenia,0,2,10,12,4/6/2021,0,0,0,0,6,0,2,8,1,6,7,14,0,0,1,1,3,1,0,4
114962,2021,Netherlands,Slovenia,0,2,10,12,3/6/2021,0,0,2,2,3,0,1,4,2,1,2,5,0,0,0,0,2,1,0,3
114962,2021,Poland,Slovenia,3,2,12,17,30/05/2021,0,0,3,3,6,1,7,14,1,1,0,2,0,0,2,2,1,0,0,1
114962,2021,Italy,Slovenia,1,0,17,18,29/05/2021,0,0,0,0,6,1,4,11,1,0,0,1,1,1,0,2,0,0,0,0
114962,2021,Serbia,Slovenia,1,2,13,16,28/05/2021,0,0,0,0,6,2,0,8,3,2,0,5,0,0,0,0,1,1,0,2
181130,2021,France,Slovenia,0,0,0,0,10/6/2021,0,0,0,0,0,0,0,0,0,0,0,0,0,0,0,0,0,0,0,0
181130,2021,Slovenia,Germany,0,0,0,0,5/6/2021,3,1,2,6,0,0,0,0,0,0,0,0,0,0,0,0,0,0,0,0
181130,2021,Argentina,Slovenia,0,0,0,0,4/6/2021,0,0,0,0,0,0,0,0,0,0,0,0,0,0,0,0,0,0,0,0
181130,2021,Netherlands,Slovenia,0,1,0,1,3/6/2021,0,0,8,8,0,0,0,0,1,0,0,1,0,0,0,0,0,1,0,1
151391,2021,France,Slovenia,0,1,6,7,27/06/2021,0,0,3,3,0,1,1,2,1,5,2,8,0,0,0,0,3,0,0,3
151391,2021,Poland,Slovenia,0,1,5,6,26/06/2021,0,0,1,1,2,1,1,4,1,1,0,2,0,0,1,1,0,0,0,0
151391,2021,Slovenia,Bulgaria,0,3,9,12,23/06/2021,0,0,2,2,2,0,0,2,1,1,4,6,0,0,0,0,5,1,0,6
151391,2021,Japan,Slovenia,0,1,11,12,22/06/2021,1,0,1,2,6,0,0,6,3,2,1,6,0,0,0,0,0,1,0,1
151391,2021,Slovenia,USA,1,2,16,19,21/06/2021,0,0,1,1,4,2,3,9,2,6,6,14,1,0,0,1,2,1,1,4
151391,2021,Iran,Slovenia,0,1,12,13,17/06/2021,0,0,1,1,5,1,2,8,2,4,3,9,3,0,1,4,2,4,0,6
151391,2021,Slovenia,Australia,0,2,8,10,16/06/2021,0,0,0,0,7,1,2,10,1,3,6,10,0,0,0,0,2,2,0,4
151391,2021,Brazil,Slovenia,3,1,16,20,15/06/2021,0,0,0,0,7,3,2,12,2,6,2,10,1,0,0,1,5,3,0,8
151391,2021,Slovenia,Russia,0,0,12,12,11/6/2021,0,1,3,4,2,1,3,6,2,7,8,17,0,0,0,0,4,2,1,7
151391,2021,Slovenia,Canada,0,2,9,11,9/6/2021,0,0,1,1,3,0,2,5,1,2,2,5,0,0,1,1,0,0,0,0
151391,2021,Slovenia,Germany,0,1,9,10,5/6/2021,0,0,0,0,1,3,1,5,0,4,4,8,1,0,0,1,2,0,0,2
151391,2021,Argentina,Slovenia,1,4,11,16,4/6/2021,0,0,1,1,2,1,4,7,2,2,8,12,0,0,2,2,3,0,0,3
151391,2021,Netherlands,Slovenia,0,0,9,9,3/6/2021,0,0,1,1,3,0,2,5,1,3,4,8,0,0,0,0,0,0,0,0
151391,2021,Poland,Slovenia,0,2,12,14,30/05/2021,0,0,3,3,7,2,4,13,2,5,2,9,0,0,1,1,0,1,0,1
151391,2021,Italy,Slovenia,2,1,7,10,29/05/2021,0,0,2,2,6,0,0,6,2,0,0,2,0,0,1,1,0,0,0,0
151391,2021,Serbia,Slovenia,0,1,15,16,28/05/2021,0,0,0,0,8,0,3,11,4,5,1,10,0,0,4,4,3,1,0,4
119022,2021,France,Slovenia,0,0,0,0,27/06/2021,0,0,0,0,0,0,0,0,0,0,0,0,0,0,0,0,0,0,0,0
119022,2021,Poland,Slovenia,0,0,0,0,26/06/2021,0,0,0,0,0,0,0,0,0,0,0,0,0,0,0,0,0,0,0,0
119022,2021,Slovenia,Bulgaria,0,0,0,0,23/06/2021,0,0,0,0,0,0,0,0,0,0,0,0,0,0,0,0,0,0,0,0
119022,2021,Japan,Slovenia,0,0,0,0,22/06/2021,0,0,0,0,0,0,0,0,0,0,0,0,0,0,0,0,0,0,0,0
119022,2021,Slovenia,USA,0,0,2,2,21/06/2021,0,0,0,0,0,0,1,1,0,0,0,0,0,0,0,0,0,0,1,1
119022,2021,Iran,Slovenia,0,0,0,0,17/06/2021,0,0,0,0,0,0,0,0,0,0,0,0,0,0,0,0,0,0,0,0
119022,2021,Slovenia,Australia,0,3,7,10,16/06/2021,0,0,3,3,8,3,12,23,1,1,4,6,0,0,0,0,3,3,0,6
119022,2021,Brazil,Slovenia,0,1,1,2,15/06/2021,0,0,2,2,0,0,3,3,0,0,0,0,0,0,0,0,1,0,0,1
119022,2021,Slovenia,Russia,1,1,14,16,11/6/2021,0,0,0,0,4,1,2,7,1,0,3,4,0,0,0,0,1,1,0,2
119022,2021,France,Slovenia,1,4,7,12,10/6/2021,0,0,1,1,9,0,10,19,0,4,6,10,0,0,0,0,7,2,2,11
119022,2021,Slovenia,Canada,0,0,0,0,9/6/2021,0,0,0,0,0,0,0,0,0,0,0,0,0,0,0,0,0,0,0,0
119022,2021,Slovenia,Germany,0,0,0,0,5/6/2021,0,0,0,0,0,0,3,3,0,0,1,1,0,0,0,0,0,0,0,0
119022,2021,Argentina,Slovenia,0,1,2,3,4/6/2021,0,0,0,0,4,0,3,7,0,2,0,2,0,0,0,0,0,1,0,1
119022,2021,Netherlands,Slovenia,0,0,0,0,3/6/2021,0,0,0,0,0,0,0,0,0,0,0,0,0,0,0,0,0,0,0,0
119022,2021,Poland,Slovenia,1,0,1,2,30/05/2021,0,0,0,0,2,0,1,3,0,0,0,0,0,0,0,0,0,0,0,0
119022,2021,Italy,Slovenia,0,1,1,2,29/05/2021,0,0,0,0,0,0,0,0,0,1,0,1,0,0,0,0,0,0,0,0
114952,2021,France,Slovenia,0,0,0,0,27/06/2021,0,0,0,0,0,0,0,0,0,0,0,0,0,0,0,0,0,0,0,0
114952,2021,Poland,Slovenia,0,1,2,3,26/06/2021,0,0,0,0,0,1,1,2,0,0,0,0,0,0,0,0,1,0,0,1
114952,2021,Slovenia,Bulgaria,0,0,0,0,23/06/2021,0,0,0,0,0,0,0,0,0,0,0,0,0,0,0,0,0,0,0,0
114952,2021,Japan,Slovenia,0,0,0,0,22/06/2021,0,0,0,0,0,0,0,0,0,0,0,0,0,0,0,0,0,0,0,0
114952,2021,Slovenia,USA,0,0,0,0,21/06/2021,0,0,0,0,0,0,0,0,0,0,0,0,0,0,0,0,0,0,0,0
114952,2021,Iran,Slovenia,0,0,2,2,17/06/2021,0,0,0,0,2,0,1,3,0,1,0,1,0,0,0,0,0,1,0,1
114952,2021,Slovenia,Australia,0,0,1,1,16/06/2021,0,0,0,0,2,2,0,4,0,0,0,0,0,0,0,0,0,0,0,0
114952,2021,Brazil,Slovenia,0,0,0,0,15/06/2021,0,0,0,0,0,0,0,0,0,0,0,0,0,0,0,0,0,0,0,0
114952,2021,Slovenia,Russia,0,0,0,0,11/6/2021,0,0,0,0,0,0,0,0,0,0,0,0,0,0,0,0,0,0,0,0
114952,2021,France,Slovenia,0,3,1,4,10/6/2021,0,0,0,0,4,3,1,8,0,0,0,0,0,0,0,0,0,0,0,0
114952,2021,Slovenia,Canada,0,0,0,0,9/6/2021,0,0,0,0,0,0,0,0,0,0,0,0,0,0,0,0,0,0,0,0
114952,2021,Slovenia,Germany,1,2,3,6,5/6/2021,0,0,1,1,4,0,7,11,2,0,1,3,0,0,0,0,7,1,1,9
114952,2021,Argentina,Slovenia,0,0,0,0,4/6/2021,0,0,0,0,0,0,0,0,0,0,0,0,0,0,0,0,0,0,0,0
114952,2021,Netherlands,Slovenia,0,0,0,0,3/6/2021,0,0,0,0,0,0,0,0,0,0,0,0,0,0,0,0,0,0,0,0
114952,2021,Italy,Slovenia,0,4,6,10,29/05/2021,0,0,2,2,6,2,9,17,0,0,0,0,0,0,0,0,1,0,0,1
114952,2021,Serbia,Slovenia,0,0,2,2,28/05/2021,0,0,0,0,1,0,0,1,0,0,0,0,0,0,0,0,0,0,0,0
114956,2021,France,Slovenia,0,0,0,0,27/06/2021,0,0,0,0,0,0,0,0,0,0,0,0,0,0,0,0,0,0,0,0
114956,2021,Poland,Slovenia,0,0,2,2,26/06/2021,4,0,6,10,0,0,0,0,2,1,1,4,0,0,0,0,0,0,0,0
114956,2021,Slovenia,Bulgaria,0,0,0,0,23/06/2021,0,0,0,0,0,0,0,0,0,0,0,0,0,0,0,0,0,0,0,0
114956,2021,Japan,Slovenia,0,0,0,0,22/06/2021,0,0,0,0,0,0,0,0,0,0,0,0,0,0,0,0,0,0,0,0
114956,2021,Slovenia,USA,0,0,0,0,21/06/2021,0,0,0,0,0,0,0,0,0,0,0,0,0,0,0,0,0,0,0,0
114956,2021,Iran,Slovenia,0,0,0,0,17/06/2021,2,0,7,9,0,0,0,0,0,0,0,0,0,0,0,0,0,0,0,0
114956,2021,Slovenia,Australia,0,0,0,0,16/06/2021,3,0,6,9,0,0,0,0,0,1,0,1,0,0,0,0,0,0,0,0
114956,2021,Brazil,Slovenia,0,0,0,0,15/06/2021,3,0,1,4,0,0,0,0,0,0,0,0,0,1,0,1,0,1,0,1
114956,2021,Slovenia,Russia,0,0,0,0,11/6/2021,0,0,0,0,0,0,0,0,0,0,0,0,0,0,0,0,0,0,0,0
114956,2021,France,Slovenia,1,1,1,3,10/6/2021,16,2,7,25,0,0,0,0,0,0,0,0,0,0,0,0,0,3,0,3
114956,2021,Slovenia,Canada,0,0,0,0,9/6/2021,0,0,0,0,0,0,0,0,0,0,0,0,0,0,0,0,0,0,0,0
114956,2021,Poland,Slovenia,0,0,0,0,30/05/2021,1,1,2,4,0,0,0,0,0,0,0,0,0,0,0,0,0,0,0,0
114956,2021,Italy,Slovenia,0,0,0,0,29/05/2021,1,0,4,5,0,0,0,0,0,0,0,0,0,0,0,0,0,0,0,0
114956,2021,Serbia,Slovenia,1,0,11,12,28/05/2021,36,0,51,87,0,2,0,2,0,1,1,2,0,0,0,0,5,5,0,10
151404,2021,France,Slovenia,0,0,0,0,27/06/2021,0,0,0,0,0,0,0,0,0,0,0,0,0,0,0,0,1,0,0,1
151404,2021,Slovenia,Bulgaria,0,1,1,2,23/06/2021,0,0,0,0,0,0,1,1,0,0,0,0,0,0,1,1,0,0,0,0
151404,2021,Slovenia,USA,0,0,0,0,21/06/2021,0,0,0,0,0,0,0,0,0,0,0,0,0,0,0,0,0,0,0,0
151404,2021,Slovenia,Australia,0,0,0,0,16/06/2021,0,0,0,0,0,0,0,0,0,0,0,0,0,0,0,0,0,0,0,0
151404,2021,Brazil,Slovenia,0,0,0,0,15/06/2021,0,0,0,0,0,0,0,0,0,0,0,0,0,0,0,0,0,0,0,0
151404,2021,France,Slovenia,0,1,3,4,10/6/2021,0,1,1,2,1,3,0,4,2,1,2,5,0,0,0,0,0,1,0,1
151404,2021,Slovenia,Canada,0,0,0,0,9/6/2021,0,0,0,0,0,0,0,0,0,0,0,0,0,0,0,0,0,0,0,0
151404,2021,Slovenia,Germany,0,0,4,4,5/6/2021,0,0,0,0,1,0,2,3,1,1,4,6,0,0,1,1,0,1,0,1
151404,2021,Argentina,Slovenia,0,0,0,0,4/6/2021,0,0,0,0,0,0,0,0,0,0,0,0,0,0,0,0,0,0,0,0
151404,2021,Poland,Slovenia,0,0,0,0,30/05/2021,0,0,0,0,0,0,0,0,0,0,0,0,0,0,0,0,0,0,0,0
151404,2021,Serbia,Slovenia,0,0,0,0,28/05/2021,0,0,0,0,0,0,0,0,0,0,0,0,0,0,0,0,0,0,0,0
155920,2021,France,Slovenia,0,0,0,0,27/06/2021,0,0,0,0,0,0,0,0,0,0,0,0,0,0,0,0,0,0,0,0
155920,2021,Poland,Slovenia,0,0,0,0,26/06/2021,0,0,0,0,0,0,0,0,0,0,0,0,0,0,0,0,0,0,0,0
155920,2021,Slovenia,Bulgaria,0,0,0,0,23/06/2021,0,0,0,0,0,0,0,0,0,0,0,0,0,0,0,0,0,0,0,0
155920,2021,Japan,Slovenia,0,0,1,1,22/06/2021,0,0,3,3,5,4,4,13,1,1,0,2,1,2,5,8,2,0,0,2
155920,2021,Slovenia,USA,0,0,0,0,21/06/2021,0,0,0,0,0,0,0,0,0,0,0,0,0,0,0,0,0,0,0,0
155920,2021,Iran,Slovenia,0,0,0,0,17/06/2021,0,0,0,0,0,0,0,0,0,0,0,0,0,0,0,0,0,0,0,0
155920,2021,Slovenia,Australia,0,0,2,2,16/06/2021,0,0,0,0,5,1,4,10,0,1,0,1,3,2,5,10,1,0,0,1
155920,2021,Brazil,Slovenia,0,0,0,0,15/06/2021,0,0,0,0,0,0,0,0,0,0,0,0,0,0,0,0,0,0,0,0
155920,2021,Slovenia,Russia,0,0,0,0,11/6/2021,0,0,0,0,0,0,0,0,0,0,0,0,0,0,0,0,0,0,0,0
155920,2021,France,Slovenia,0,2,2,4,10/6/2021,0,0,0,0,0,0,2,2,0,1,0,1,1,2,5,8,1,0,0,1
155920,2021,Slovenia,Canada,0,0,0,0,9/6/2021,0,0,0,0,0,0,0,0,0,0,0,0,0,0,0,0,0,0,0,0
155920,2021,Slovenia,Germany,0,0,2,2,5/6/2021,0,0,1,1,2,1,3,6,0,0,1,1,1,0,3,4,1,0,1,2
155920,2021,Argentina,Slovenia,2,4,8,14,4/6/2021,0,0,3,3,11,2,5,18,1,1,1,3,1,0,15,16,7,3,1,11
155920,2021,Netherlands,Slovenia,0,0,0,0,3/6/2021,0,0,0,0,0,0,0,0,0,0,0,0,0,0,0,0,0,0,0,0
155920,2021,Poland,Slovenia,0,0,0,0,30/05/2021,0,0,0,0,0,0,0,0,0,0,0,0,0,0,0,0,0,0,0,0
155920,2021,Italy,Slovenia,0,2,5,7,29/05/2021,0,0,3,3,12,1,12,25,0,0,0,0,7,0,6,13,1,0,0,1
155920,2021,Serbia,Slovenia,0,0,2,2,28/05/2021,0,0,0,0,2,0,0,2,0,0,0,0,0,0,2,2,0,2,0,2
154546,2021,France,Slovenia,0,0,0,0,27/06/2021,0,0,0,0,0,0,0,0,0,0,0,0,0,0,0,0,0,0,0,0
154546,2021,Poland,Slovenia,0,0,0,0,26/06/2021,0,0,0,0,0,0,0,0,0,0,0,0,0,0,0,0,0,0,0,0
154546,2021,Slovenia,Bulgaria,0,0,0,0,23/06/2021,0,0,1,1,0,0,0,0,0,0,0,0,0,1,2,3,1,0,0,1
154546,2021,Japan,Slovenia,0,0,1,1,22/06/2021,0,0,0,0,0,0,1,1,0,0,0,0,0,0,0,0,0,0,0,0
154546,2021,Iran,Slovenia,0,0,0,0,17/06/2021,0,0,0,0,0,0,0,0,0,0,0,0,0,0,0,0,0,0,0,0
154546,2021,Slovenia,Australia,0,0,0,0,16/06/2021,0,0,0,0,0,0,0,0,0,0,0,0,0,0,0,0,0,0,0,0
154546,2021,Slovenia,Russia,0,0,0,0,11/6/2021,0,0,0,0,0,0,0,0,0,0,0,0,1,0,0,1,0,0,0,0
154546,2021,France,Slovenia,0,0,0,0,10/6/2021,0,0,0,0,0,0,0,0,0,0,0,0,0,0,0,0,0,0,0,0
154546,2021,Slovenia,Germany,0,0,0,0,5/6/2021,0,0,0,0,0,0,0,0,0,0,0,0,0,0,0,0,0,0,0,0
154546,2021,Netherlands,Slovenia,0,0,0,0,3/6/2021,0,0,0,0,0,0,0,0,0,0,0,0,0,0,0,0,0,0,0,0
154546,2021,Poland,Slovenia,0,0,0,0,30/05/2021,2,0,1,3,0,0,0,0,0,0,0,0,0,0,0,0,0,0,0,0
154546,2021,Italy,Slovenia,0,0,0,0,29/05/2021,0,0,0,0,0,0,0,0,0,0,0,0,0,0,0,0,0,0,0,0
154546,2021,Serbia,Slovenia,0,0,0,0,28/05/2021,0,0,0,0,0,0,0,0,0,0,0,0,0,0,1,1,1,0,0,1
144415,2021,France,Slovenia,0,0,0,0,27/06/2021,0,0,5,5,0,0,0,0,0,0,0,0,4,1,10,15,5,0,0,5
144415,2021,Poland,Slovenia,0,0,0,0,26/06/2021,0,0,3,3,0,0,0,0,0,0,0,0,6,4,18,28,13,4,2,19
144415,2021,Slovenia,Bulgaria,0,0,0,0,23/06/2021,0,0,2,2,0,0,0,0,0,0,0,0,7,0,7,14,6,5,0,11
144415,2021,Japan,Slovenia,0,0,0,0,22/06/2021,0,0,2,2,0,0,0,0,0,0,0,0,6,0,10,16,2,4,0,6
144415,2021,Slovenia,USA,0,0,0,0,21/06/2021,1,0,5,6,0,0,0,0,0,0,0,0,6,1,8,15,13,3,1,17
144415,2021,Iran,Slovenia,0,0,0,0,17/06/2021,0,1,3,4,0,0,0,0,0,0,0,0,11,3,7,21,8,7,0,15
144415,2021,Slovenia,Australia,0,0,0,0,16/06/2021,0,0,3,3,0,0,0,0,0,0,0,0,7,1,7,15,9,6,0,15
144415,2021,Brazil,Slovenia,0,0,0,0,15/06/2021,0,0,4,4,0,0,0,0,0,0,0,0,6,1,11,18,8,5,1,14
144415,2021,Slovenia,Russia,0,0,0,0,11/6/2021,0,0,9,9,0,0,0,0,0,0,0,0,5,4,14,23,8,1,0,9
144415,2021,France,Slovenia,0,0,0,0,10/6/2021,0,0,3,3,0,0,0,0,0,0,0,0,6,0,17,23,11,8,1,20
144415,2021,Slovenia,Canada,0,0,0,0,9/6/2021,0,0,7,7,0,0,0,0,0,0,0,0,6,0,9,15,6,2,0,8
144415,2021,Slovenia,Germany,0,0,0,0,5/6/2021,0,0,5,5,0,0,0,0,0,0,0,0,8,2,9,19,18,3,0,21
144415,2021,Argentina,Slovenia,0,0,0,0,4/6/2021,0,0,3,3,0,0,0,0,0,0,0,0,3,0,8,11,12,1,0,13
144415,2021,Netherlands,Slovenia,0,0,0,0,3/6/2021,0,0,2,2,0,0,0,0,0,0,0,0,9,0,2,11,7,1,0,8
144415,2021,Poland,Slovenia,0,0,0,0,30/05/2021,0,0,4,4,0,0,0,0,0,0,0,0,8,1,10,19,17,5,1,23
144415,2021,Italy,Slovenia,0,0,0,0,29/05/2021,0,0,2,2,0,0,0,0,0,0,0,0,4,0,3,7,2,0,0,2
144415,2021,Serbia,Slovenia,0,0,0,0,28/05/2021,0,0,6,6,0,0,0,0,0,0,0,0,7,0,13,20,5,5,1,11
161754,2021,Poland,Slovenia,0,0,0,0,26/06/2021,0,0,0,0,0,0,0,0,0,0,0,0,0,0,0,0,0,0,0,0
161754,2021,Japan,Slovenia,1,0,4,5,22/06/2021,0,0,0,0,2,0,0,2,0,1,1,2,0,0,0,0,0,0,0,0
161754,2021,Slovenia,USA,0,0,0,0,21/06/2021,0,0,0,0,0,0,0,0,0,0,0,0,0,0,0,0,0,0,0,0
161754,2021,Iran,Slovenia,0,0,0,0,17/06/2021,0,0,0,0,0,0,0,0,0,0,0,0,0,0,0,0,0,0,0,0
161754,2021,Slovenia,Australia,0,0,0,0,16/06/2021,0,0,0,0,0,0,0,0,0,0,0,0,0,0,0,0,0,0,0,0
161754,2021,Brazil,Slovenia,0,0,0,0,15/06/2021,0,0,0,0,0,0,0,0,0,0,0,0,0,0,0,0,0,0,0,0
161754,2021,Slovenia,Russia,0,0,0,0,11/6/2021,1,0,3,4,0,0,0,0,0,0,2,2,0,0,0,0,0,0,0,0
161754,2021,France,Slovenia,0,2,11,13,10/6/2021,0,0,0,0,1,0,1,2,0,1,1,2,0,0,0,0,1,0,0,1
161754,2021,Slovenia,Canada,0,0,0,0,9/6/2021,0,0,1,1,0,0,0,0,0,0,0,0,0,0,0,0,0,0,0,0
161754,2021,Argentina,Slovenia,0,0,0,0,4/6/2021,0,0,0,0,0,0,0,0,0,0,0,0,0,0,0,0,1,0,0,1
161754,2021,Netherlands,Slovenia,0,0,4,4,3/6/2021,0,0,0,0,1,0,1,2,0,0,2,2,0,0,0,0,1,0,0,1
161754,2021,Poland,Slovenia,0,0,0,0,30/05/2021,0,0,0,0,0,0,0,0,0,0,0,0,0,0,0,0,0,0,0,0
161754,2021,Italy,Slovenia,0,0,1,1,29/05/2021,0,0,0,0,0,0,0,0,0,0,0,0,0,0,1,1,0,0,0,0
161754,2021,Serbia,Slovenia,0,0,0,0,28/05/2021,0,0,0,0,0,0,0,0,0,0,0,0,0,0,0,0,0,0,0,0
119018,2021,France,Slovenia,1,2,7,10,27/06/2021,17,0,48,65,0,0,1,1,1,3,1,5,0,0,0,0,4,0,1,5
119018,2021,Poland,Slovenia,0,0,7,7,26/06/2021,15,0,46,61,0,0,0,0,0,2,1,3,0,0,0,0,4,0,1,5
119018,2021,Slovenia,Bulgaria,1,2,10,13,23/06/2021,18,0,36,54,0,0,1,1,0,0,3,3,0,0,0,0,3,2,1,6
119018,2021,Japan,Slovenia,1,1,12,14,22/06/2021,21,1,42,64,0,0,1,1,2,0,0,2,0,0,0,0,7,1,0,8
119018,2021,Slovenia,USA,1,2,15,18,21/06/2021,20,1,93,114,1,0,0,1,1,5,2,8,0,0,2,2,4,3,2,9
119018,2021,Iran,Slovenia,1,2,10,13,17/06/2021,26,0,57,83,1,0,1,2,0,2,0,2,0,0,0,0,7,3,0,10
119018,2021,Slovenia,Australia,0,1,17,18,16/06/2021,36,0,43,79,2,0,0,2,0,0,1,1,0,0,0,0,6,2,2,10
119018,2021,Brazil,Slovenia,0,1,15,16,15/06/2021,33,1,58,92,3,0,0,3,0,4,1,5,0,0,0,0,4,4,5,13
119018,2021,Slovenia,Russia,1,4,11,16,11/6/2021,26,0,67,93,0,0,1,1,2,1,5,8,0,0,0,0,10,2,0,12
119018,2021,France,Slovenia,0,1,13,14,10/6/2021,38,1,28,67,0,0,0,0,3,3,3,9,0,0,0,0,5,0,2,7
119018,2021,Slovenia,Canada,0,3,5,8,9/6/2021,14,0,44,58,1,0,0,1,0,1,2,3,0,0,0,0,7,2,1,10
119018,2021,Slovenia,Germany,2,2,18,22,5/6/2021,35,0,61,96,1,0,0,1,0,4,2,6,0,0,0,0,8,4,1,13
119018,2021,Argentina,Slovenia,0,0,9,9,4/6/2021,35,1,39,75,1,0,0,1,0,1,3,4,0,0,0,0,5,0,1,6
119018,2021,Netherlands,Slovenia,3,1,6,10,3/6/2021,11,1,37,49,0,0,0,0,1,2,0,3,0,0,1,1,9,2,2,13
119018,2021,Poland,Slovenia,0,2,19,21,30/05/2021,37,0,59,96,2,1,0,3,1,1,0,2,0,0,0,0,4,3,0,7
119018,2021,Italy,Slovenia,1,4,2,7,29/05/2021,18,0,38,56,0,0,0,0,0,0,0,0,0,0,0,0,0,0,0,0
119018,2021,Serbia,Slovenia,1,0,3,4,28/05/2021,7,0,7,14,0,0,1,1,0,1,2,3,0,0,0,0,0,0,1,1
114957,2021,France,Slovenia,0,2,7,9,27/06/2021,0,0,5,5,8,4,6,18,2,3,2,7,3,2,12,17,1,1,0,2
114957,2021,Poland,Slovenia,0,3,11,14,26/06/2021,0,0,1,1,13,3,4,20,0,1,1,2,1,2,13,16,3,3,2,8
114957,2021,Slovenia,Bulgaria,1,0,6,7,23/06/2021,0,0,4,4,3,2,1,6,0,2,0,2,0,0,2,2,1,1,0,2
114957,2021,Japan,Slovenia,0,2,13,15,22/06/2021,0,0,5,5,12,1,6,19,2,2,1,5,3,0,13,16,3,0,0,3
114957,2021,Slovenia,USA,0,6,18,24,21/06/2021,0,0,3,3,16,2,17,35,0,5,3,8,7,2,30,39,9,0,2,11
114957,2021,Iran,Slovenia,0,3,17,20,17/06/2021,0,0,3,3,16,3,8,27,1,2,0,3,14,0,14,28,3,6,0,9
114957,2021,Slovenia,Australia,0,1,2,3,16/06/2021,0,0,0,0,1,3,3,7,0,0,0,0,2,0,1,3,5,0,0,5
114957,2021,Brazil,Slovenia,0,3,10,13,15/06/2021,0,0,1,1,9,2,12,23,0,3,2,5,4,2,12,18,7,2,0,9
114957,2021,Slovenia,Russia,0,4,8,12,11/6/2021,0,0,5,5,18,5,14,37,0,5,2,7,6,1,19,26,6,3,1,10
114957,2021,France,Slovenia,0,0,0,0,10/6/2021,0,0,0,0,0,0,0,0,0,0,0,0,0,0,0,0,0,0,0,0
114957,2021,Slovenia,Canada,0,1,9,10,9/6/2021,0,0,1,1,9,2,6,17,1,1,0,2,7,2,11,20,5,4,0,9
114957,2021,Slovenia,Germany,1,3,10,14,5/6/2021,1,0,2,3,11,6,14,31,0,2,1,3,3,0,12,15,8,2,0,10
114957,2021,Argentina,Slovenia,0,0,0,0,4/6/2021,0,0,0,0,0,0,0,0,0,0,0,0,0,0,0,0,0,0,0,0
114957,2021,Netherlands,Slovenia,1,3,9,13,3/6/2021,0,0,7,7,8,0,6,14,0,3,0,3,7,2,12,21,3,0,1,4
114957,2021,Poland,Slovenia,0,3,11,14,30/05/2021,0,1,9,10,12,2,17,31,1,2,0,3,18,1,14,33,5,1,0,6
114957,2021,Italy,Slovenia,0,0,0,0,29/05/2021,0,0,0,0,0,0,0,0,0,0,0,0,0,0,0,0,0,0,0,0
114957,2021,Serbia,Slovenia,0,4,7,11,28/05/2021,0,0,0,0,14,4,14,32,0,0,1,1,4,3,19,26,3,4,1,8
136918,2021,France,Slovenia,1,0,9,10,27/06/2021,0,0,0,0,8,6,12,26,0,2,2,4,8,2,14,24,8,1,2,11
136918,2021,Poland,Slovenia,0,3,5,8,26/06/2021,0,0,5,5,9,8,9,26,1,0,3,4,9,0,8,17,2,1,1,4
136918,2021,Slovenia,Bulgaria,0,1,8,9,23/06/2021,0,0,2,2,6,4,9,19,1,5,4,10,5,1,10,16,9,2,1,12
136918,2021,Japan,Slovenia,1,2,6,9,22/06/2021,0,0,1,1,6,1,8,15,0,3,0,3,5,0,6,11,2,2,0,4
136918,2021,Slovenia,USA,0,3,14,17,21/06/2021,0,0,5,5,25,5,13,43,2,3,0,5,6,3,22,31,4,5,2,11
136918,2021,Iran,Slovenia,0,6,7,13,17/06/2021,0,0,4,4,20,5,9,34,1,0,0,1,8,1,15,24,2,3,0,5
136918,2021,Slovenia,Australia,1,3,6,10,16/06/2021,0,0,4,4,14,2,5,21,1,1,1,3,6,0,4,10,7,3,0,10
136918,2021,Brazil,Slovenia,1,4,9,14,15/06/2021,0,0,3,3,14,4,11,29,1,3,3,7,12,2,28,42,12,1,0,13
136918,2021,Slovenia,Russia,2,6,11,19,11/6/2021,0,0,3,3,27,2,11,40,3,3,3,9,5,2,26,33,8,0,0,8
136918,2021,France,Slovenia,2,4,12,18,10/6/2021,0,0,5,5,10,0,14,24,4,3,0,7,9,2,19,30,5,0,2,7
136918,2021,Slovenia,Canada,2,1,6,9,9/6/2021,0,0,1,1,10,4,4,18,0,1,1,2,5,0,6,11,1,1,0,2
136918,2021,Slovenia,Germany,0,6,4,10,5/6/2021,0,0,0,0,7,1,10,18,1,1,1,3,9,4,6,19,4,2,0,6
136918,2021,Argentina,Slovenia,0,2,6,8,4/6/2021,0,0,3,3,11,3,14,28,1,2,6,9,6,0,13,19,7,1,2,10
136918,2021,Netherlands,Slovenia,0,0,0,0,3/6/2021,0,0,0,0,0,0,0,0,0,0,0,0,0,0,0,0,0,0,0,0
136918,2021,Poland,Slovenia,0,4,11,15,30/05/2021,0,0,6,6,16,7,17,40,1,3,0,4,10,1,13,24,3,4,1,8
136918,2021,Italy,Slovenia,4,2,13,19,29/05/2021,0,0,4,4,8,0,8,16,1,0,0,1,5,3,8,16,1,0,0,1
136918,2021,Serbia,Slovenia,1,5,13,19,28/05/2021,0,1,2,3,9,4,14,27,1,2,1,4,15,0,20,35,4,5,2,11
168747,2021,France,Slovenia,0,1,0,1,27/06/2021,0,0,1,1,1,2,2,5,0,0,0,0,0,0,3,3,0,0,0,0
168747,2021,Poland,Slovenia,0,0,0,0,26/06/2021,0,0,0,0,0,0,0,0,0,0,0,0,0,0,0,0,0,0,0,0
168747,2021,Slovenia,Bulgaria,0,1,6,7,23/06/2021,0,0,1,1,8,1,1,10,2,3,0,5,0,0,5,5,1,0,1,2
168747,2021,Japan,Slovenia,0,0,0,0,22/06/2021,0,0,1,1,0,0,0,0,0,0,0,0,0,0,0,0,0,1,0,1
168747,2021,Slovenia,USA,0,0,0,0,21/06/2021,0,0,0,0,0,0,0,0,0,0,0,0,0,0,0,0,0,0,0,0
168747,2021,Iran,Slovenia,0,0,0,0,17/06/2021,0,0,0,0,0,0,2,2,0,1,0,1,0,0,3,3,0,0,0,0
168747,2021,Slovenia,Australia,0,2,8,10,16/06/2021,0,0,2,2,11,4,4,19,3,3,4,10,8,0,17,25,3,1,0,4
168747,2021,Brazil,Slovenia,0,1,0,1,15/06/2021,0,0,1,1,2,0,1,3,0,0,0,0,0,1,2,3,0,0,0,0
168747,2021,Slovenia,Russia,0,0,2,2,11/6/2021,0,0,0,0,2,1,0,3,0,0,1,1,0,0,3,3,2,1,0,3
168747,2021,France,Slovenia,0,7,8,15,10/6/2021,0,0,3,3,19,2,10,31,1,8,0,9,3,2,13,18,6,0,1,7
168747,2021,Slovenia,Canada,0,2,3,5,9/6/2021,0,0,1,1,3,0,0,3,0,0,0,0,0,0,2,2,1,1,0,2
168747,2021,Slovenia,Germany,1,2,1,4,5/6/2021,0,0,0,0,3,1,1,5,0,0,1,1,2,1,6,9,2,1,0,3
168747,2021,Argentina,Slovenia,0,0,0,0,4/6/2021,0,0,0,0,0,0,0,0,0,0,0,0,0,0,0,0,0,0,0,0
168747,2021,Netherlands,Slovenia,1,2,7,10,3/6/2021,0,1,0,1,14,4,9,27,1,0,2,3,2,1,3,6,2,2,0,4
168747,2021,Poland,Slovenia,0,0,0,0,30/05/2021,0,0,0,0,1,0,0,1,0,0,0,0,0,0,0,0,0,0,0,0
168747,2021,Italy,Slovenia,0,0,0,0,29/05/2021,0,0,0,0,2,1,4,7,0,0,0,0,2,1,2,5,0,0,0,0
168747,2021,Serbia,Slovenia,0,0,0,0,28/05/2021,0,0,0,0,0,0,0,0,0,0,0,0,0,0,0,0,0,0,0,0
118893,2021,USA,Japan,1,5,5,11,23/06/2021,0,0,1,1,11,1,7,19,0,0,0,0,0,0,0,0,5,3,0,8
118893,2021,Bulgaria,USA,0,0,0,0,22/06/2021,0,0,0,0,0,0,0,0,0,0,0,0,0,0,0,0,0,0,0,0
118893,2021,Slovenia,USA,0,1,9,10,21/06/2021,0,0,3,3,8,5,11,24,1,4,1,6,2,0,3,5,4,3,0,7
118893,2021,Netherlands,USA,0,6,9,15,17/06/2021,0,1,2,3,17,4,7,28,2,7,7,16,1,0,3,4,5,4,1,10
118893,2021,USA,France,0,0,0,0,16/06/2021,0,0,0,0,0,0,0,0,0,0,0,0,0,0,0,0,0,0,0,0
118893,2021,Italy,USA,3,3,9,15,15/06/2021,0,0,0,0,13,3,5,21,1,1,3,5,2,0,0,2,4,1,1,6
118893,2021,USA,Serbia,0,1,5,6,11/6/2021,0,0,1,1,7,3,5,15,2,1,1,4,0,0,1,1,3,2,0,5
118893,2021,USA,Australia,1,3,8,12,5/6/2021,0,0,2,2,12,2,4,18,1,0,0,1,2,0,6,8,4,2,2,8
118893,2021,Poland,USA,0,4,1,5,4/6/2021,0,0,0,0,9,2,5,16,0,0,1,1,9,1,6,16,5,1,2,8
124941,2021,Slovenia,USA,1,7,11,19,21/06/2021,1,0,2,3,16,4,13,33,4,3,2,9,17,2,17,36,7,1,1,9
124941,2021,Netherlands,USA,4,2,11,17,17/06/2021,0,0,8,8,15,5,8,28,2,5,3,10,8,2,16,26,4,3,0,7
124941,2021,Italy,USA,0,2,7,9,15/06/2021,0,0,2,2,12,0,7,19,2,0,0,2,6,1,10,17,4,0,0,4
124941,2021,USA,Serbia,0,0,0,0,11/6/2021,0,0,0,0,0,0,0,0,0,0,0,0,0,0,0,0,0,0,0,0
124941,2021,Germany,USA,0,0,0,0,10/6/2021,0,0,0,0,0,0,0,0,0,0,0,0,0,0,0,0,0,0,0,0
124941,2021,Iran,USA,0,0,0,0,9/6/2021,0,0,0,0,0,0,0,0,0,0,0,0,0,0,0,0,0,0,0,0
147721,2021,USA,Japan,0,0,0,0,23/06/2021,0,0,0,0,0,0,0,0,0,0,0,0,0,0,0,0,0,0,0,0
147721,2021,Bulgaria,USA,0,0,9,9,22/06/2021,0,0,0,0,6,1,3,10,4,1,3,8,0,0,3,3,2,0,0,2
147721,2021,Slovenia,USA,0,0,0,0,21/06/2021,0,0,0,0,0,0,0,0,0,0,0,0,0,0,0,0,0,0,0,0
147721,2021,Netherlands,USA,0,0,0,0,17/06/2021,0,0,0,0,0,0,0,0,0,0,0,0,0,0,0,0,0,0,0,0
147721,2021,USA,France,0,0,0,0,16/06/2021,0,0,0,0,0,0,0,0,0,0,0,0,0,0,0,0,0,0,0,0
147721,2021,Italy,USA,0,0,0,0,15/06/2021,0,0,0,0,0,0,0,0,0,0,0,0,0,0,0,0,0,0,0,0
147721,2021,Germany,USA,0,0,0,0,10/6/2021,0,0,0,0,0,0,0,0,0,0,0,0,0,0,0,0,0,0,0,0
147721,2021,Iran,USA,0,0,10,10,9/6/2021,0,0,0,0,2,0,6,8,3,5,3,11,1,0,0,1,3,0,0,3
147721,2021,USA,Australia,0,4,4,8,5/6/2021,0,0,0,0,6,0,6,12,1,3,5,9,1,0,2,3,4,0,1,5
147721,2021,Poland,USA,0,0,0,0,4/6/2021,0,0,0,0,0,0,0,0,0,0,0,0,0,0,0,0,0,0,0,0
147721,2021,Russia,USA,1,1,5,7,3/6/2021,0,0,0,0,4,1,0,5,0,2,1,3,0,0,0,0,2,0,0,2
147721,2021,USA,Argentina,0,0,0,0,30/05/2021,0,0,0,0,0,0,0,0,0,0,0,0,0,0,0,0,0,0,0,0
147721,2021,USA,Brazil,0,2,7,9,29/05/2021,0,0,0,0,5,0,3,8,2,0,0,2,0,0,0,0,0,0,0,0
147417,2021,USA,Japan,0,0,0,0,23/06/2021,0,0,0,0,0,0,0,0,0,0,0,0,0,0,0,0,0,0,0,0
147417,2021,Bulgaria,USA,0,1,10,11,22/06/2021,0,0,1,1,8,4,3,15,0,4,2,6,0,0,0,0,6,2,0,8
147417,2021,Slovenia,USA,0,1,3,4,21/06/2021,0,0,1,1,5,3,2,10,0,2,0,2,0,0,0,0,0,0,1,1
147417,2021,Netherlands,USA,0,0,0,0,17/06/2021,0,0,0,0,0,0,0,0,0,0,0,0,0,0,0,0,0,0,0,0
147417,2021,USA,France,2,5,9,16,16/06/2021,0,0,1,1,7,5,13,25,5,4,4,13,0,0,1,1,6,3,0,9
147417,2021,Italy,USA,0,0,0,0,15/06/2021,0,0,0,0,0,0,0,0,0,0,0,0,0,0,0,0,0,0,0,0
147417,2021,Germany,USA,1,3,9,13,10/6/2021,0,0,1,1,7,1,6,14,1,3,4,8,0,0,0,0,6,1,2,9
147417,2021,Iran,USA,0,0,1,1,9/6/2021,0,0,0,0,2,1,1,4,1,1,1,3,0,0,0,0,1,0,0,1
147417,2021,USA,Australia,0,1,9,10,5/6/2021,0,0,1,1,9,3,8,20,2,2,3,7,0,0,0,0,4,1,0,5
147417,2021,Poland,USA,0,2,1,3,4/6/2021,0,0,0,0,2,2,3,7,1,0,2,3,0,0,0,0,2,0,0,2
147417,2021,Russia,USA,0,2,7,9,3/6/2021,0,0,2,2,6,2,4,12,0,1,4,5,0,0,0,0,3,1,0,4
147417,2021,USA,Argentina,0,2,6,8,30/05/2021,0,0,0,0,13,0,5,18,3,1,1,5,0,0,0,0,4,0,0,4
147417,2021,USA,Brazil,0,0,0,0,29/05/2021,0,0,0,0,0,0,0,0,0,0,0,0,0,0,0,0,0,0,0,0
147417,2021,USA,Canada,1,5,5,11,28/05/2021,0,0,0,0,11,4,18,33,1,2,2,5,1,0,0,1,6,2,0,8
140185,2021,USA,Japan,0,0,0,0,23/06/2021,0,0,0,0,0,0,0,0,0,0,0,0,0,0,0,0,0,0,0,0
140185,2021,Bulgaria,USA,3,2,9,14,22/06/2021,0,0,0,0,3,1,2,6,1,3,8,12,0,0,0,0,1,0,0,1
140185,2021,Slovenia,USA,1,3,0,4,21/06/2021,0,0,0,0,4,0,0,4,0,2,0,2,0,0,0,0,0,0,0,0
140185,2021,Netherlands,USA,1,4,11,16,17/06/2021,0,0,1,1,7,1,3,11,3,4,7,14,1,0,0,1,4,0,0,4
140185,2021,USA,France,1,7,13,21,16/06/2021,0,0,1,1,6,2,5,13,3,9,9,21,1,0,0,1,4,0,2,6
140185,2021,Italy,USA,2,1,3,6,15/06/2021,0,0,1,1,1,1,1,3,1,1,1,3,0,0,0,0,1,0,0,1
140185,2021,USA,Serbia,0,0,0,0,11/6/2021,0,0,0,0,0,0,0,0,0,0,0,0,0,0,0,0,0,0,0,0
140185,2021,Germany,USA,0,5,6,11,10/6/2021,0,0,1,1,5,0,2,7,1,0,5,6,0,0,0,0,3,0,0,3
140185,2021,Iran,USA,0,0,0,0,9/6/2021,0,0,0,0,0,0,0,0,0,0,0,0,0,0,0,0,0,0,0,0
140185,2021,USA,Australia,0,0,0,0,5/6/2021,0,0,0,0,0,0,0,0,0,0,0,0,0,0,0,0,0,0,0,0
140185,2021,Poland,USA,1,3,9,13,4/6/2021,0,0,1,1,4,1,5,10,3,0,0,3,1,0,0,1,0,1,0,1
140185,2021,Russia,USA,0,2,2,4,3/6/2021,0,0,0,0,4,0,2,6,1,2,1,4,1,0,2,3,0,0,1,1
140185,2021,USA,Brazil,1,5,5,11,29/05/2021,0,0,1,1,5,1,5,11,2,0,0,2,2,0,1,3,0,0,0,0
118913,2021,USA,Japan,0,0,0,0,23/06/2021,0,0,0,0,0,0,0,0,0,0,0,0,0,0,0,0,0,0,0,0
118913,2021,Bulgaria,USA,1,1,11,13,22/06/2021,22,0,45,67,2,0,0,2,0,3,1,4,0,0,0,0,3,0,1,4
118913,2021,Slovenia,USA,0,0,0,0,21/06/2021,0,0,0,0,0,0,0,0,0,0,0,0,0,0,0,0,0,0,0,0
118913,2021,Netherlands,USA,0,0,0,0,17/06/2021,0,0,0,0,0,0,0,0,0,0,0,0,0,0,0,0,0,0,0,0
118913,2021,USA,France,0,3,12,15,16/06/2021,33,0,76,109,3,0,1,4,1,4,3,8,0,0,0,0,9,0,1,10
118913,2021,Italy,USA,0,0,0,0,15/06/2021,0,0,0,0,0,0,0,0,0,0,0,0,0,0,0,0,0,0,0,0
118913,2021,USA,Serbia,0,0,0,0,11/6/2021,1,0,4,5,0,0,0,0,0,0,0,0,0,0,0,0,0,0,0,0
118913,2021,Germany,USA,1,2,8,11,10/6/2021,20,0,33,53,1,0,0,1,4,1,2,7,0,0,0,0,7,0,0,7
118913,2021,Iran,USA,0,0,7,7,9/6/2021,20,1,59,80,1,0,0,1,0,1,3,4,0,0,0,0,4,1,2,7
118913,2021,USA,Australia,0,0,1,1,5/6/2021,2,0,7,9,0,0,0,0,0,0,0,0,0,0,0,0,0,1,0,1
118913,2021,Russia,USA,0,0,0,0,3/6/2021,0,0,0,0,0,0,0,0,0,0,0,0,0,0,0,0,0,0,0,0
118913,2021,USA,Brazil,0,0,0,0,29/05/2021,0,0,0,0,0,0,0,0,0,0,0,0,0,0,0,0,0,0,0,0
118913,2021,USA,Canada,0,0,0,0,28/05/2021,0,0,0,0,0,0,0,0,0,0,0,0,0,0,0,0,0,0,0,0
139254,2021,USA,Japan,0,4,5,9,23/06/2021,0,0,5,5,11,3,6,20,4,3,0,7,5,0,7,12,0,3,0,3
139254,2021,Bulgaria,USA,0,0,0,0,22/06/2021,0,0,0,0,0,0,0,0,0,0,0,0,0,0,0,0,0,0,0,0
139254,2021,Slovenia,USA,1,2,17,20,21/06/2021,0,0,3,3,15,2,12,29,1,7,2,10,8,1,25,34,12,3,2,17
139254,2021,Netherlands,USA,0,0,0,0,17/06/2021,0,0,0,0,0,0,0,0,0,0,0,0,0,0,0,0,0,0,0,0
139254,2021,USA,France,0,4,13,17,16/06/2021,0,0,5,5,19,5,21,45,2,4,3,9,14,0,21,35,9,3,2,14
139254,2021,Italy,USA,0,3,8,11,15/06/2021,0,0,1,1,8,1,10,19,0,1,0,1,1,0,13,14,10,2,1,13
139254,2021,USA,Serbia,0,4,8,12,11/6/2021,0,0,5,5,20,1,9,30,2,2,0,4,7,1,12,20,4,3,0,7
139254,2021,Germany,USA,0,0,2,2,10/6/2021,0,0,0,0,0,0,0,0,0,0,0,0,0,0,0,0,0,0,0,0
139254,2021,Iran,USA,0,1,8,9,9/6/2021,0,0,1,1,5,5,12,22,0,0,3,3,6,1,6,13,2,1,0,3
139254,2021,USA,Australia,0,0,0,0,5/6/2021,0,0,0,0,0,0,0,0,0,0,0,0,0,0,0,0,0,0,0,0
139254,2021,Poland,USA,0,1,1,2,4/6/2021,0,0,1,1,3,3,3,9,0,1,0,1,4,0,10,14,0,1,0,1
139254,2021,Russia,USA,0,4,12,16,3/6/2021,0,0,2,2,10,7,9,26,2,3,2,7,3,1,18,22,6,2,1,9
139254,2021,USA,Argentina,0,6,6,12,30/05/2021,0,0,6,6,15,3,9,27,5,5,0,10,14,0,22,36,4,0,2,6
139254,2021,USA,Brazil,2,1,9,12,29/05/2021,0,0,2,2,7,2,10,19,1,0,1,2,12,3,17,32,1,0,0,1
139254,2021,USA,Canada,1,3,8,12,28/05/2021,0,0,0,0,13,6,5,24,1,0,2,3,5,1,12,18,8,3,0,11
170104,2021,USA,Japan,0,0,0,0,23/06/2021,0,0,0,0,0,0,0,0,0,0,0,0,0,0,0,0,0,0,0,0
170104,2021,Bulgaria,USA,0,1,6,7,22/06/2021,0,0,1,1,2,0,1,3,0,1,0,1,0,0,0,0,0,0,1,1
170104,2021,Iran,USA,0,0,0,0,9/6/2021,0,0,0,0,0,0,0,0,0,0,0,0,0,0,0,0,0,0,0,0
170104,2021,USA,Canada,0,0,0,0,28/05/2021,0,0,0,0,0,0,0,0,0,0,0,0,0,0,0,0,0,0,0,0
124879,2021,USA,Japan,1,1,16,18,23/06/2021,22,0,33,55,3,1,2,6,1,0,1,2,0,0,0,0,9,2,1,12
124879,2021,Bulgaria,USA,0,0,0,0,22/06/2021,0,0,0,0,0,0,0,0,0,0,0,0,0,0,0,0,0,0,0,0
124879,2021,Slovenia,USA,0,3,18,21,21/06/2021,42,0,66,108,0,0,4,4,1,10,5,16,0,0,1,1,7,2,2,11
124879,2021,Netherlands,USA,3,2,16,21,17/06/2021,28,0,63,91,3,0,1,4,0,0,3,3,0,0,0,0,6,1,2,9
124879,2021,USA,France,0,0,0,0,16/06/2021,0,0,0,0,0,0,0,0,0,0,0,0,0,0,0,0,0,0,0,0
124879,2021,Italy,USA,2,2,9,13,15/06/2021,17,1,51,69,0,0,1,1,0,2,1,3,0,0,0,0,5,1,0,6
124879,2021,USA,Australia,1,2,10,13,5/6/2021,21,0,34,55,2,0,2,4,1,4,4,9,0,0,0,0,6,3,1,10
124879,2021,Poland,USA,0,2,5,7,4/6/2021,21,1,29,51,0,0,2,2,0,1,0,1,0,0,0,0,1,3,0,4
124879,2021,Russia,USA,1,3,13,17,3/6/2021,35,0,50,85,4,0,2,6,0,4,2,6,0,0,1,1,4,6,2,12
124879,2021,USA,Argentina,3,2,16,21,30/05/2021,37,0,45,82,1,0,0,1,1,3,2,6,0,0,0,0,2,2,0,4
124879,2021,USA,Brazil,1,1,14,16,29/05/2021,19,0,58,77,0,1,1,2,0,0,0,0,0,0,0,0,0,0,0,0
124879,2021,USA,Canada,1,0,12,13,28/05/2021,29,0,59,88,3,0,3,6,1,2,1,4,0,0,0,0,2,0,0,2
118901,2021,USA,Japan,0,2,12,14,23/06/2021,0,0,1,1,6,1,0,7,4,4,1,9,0,0,0,0,1,0,0,1
118901,2021,Bulgaria,USA,0,0,0,0,22/06/2021,0,0,0,0,0,0,0,0,0,0,0,0,0,0,0,0,0,0,0,0
118901,2021,Slovenia,USA,1,3,12,16,21/06/2021,0,0,2,2,9,2,4,15,2,4,2,8,0,0,0,0,5,1,0,6
118901,2021,Netherlands,USA,0,0,0,0,17/06/2021,0,0,0,0,0,0,0,0,0,0,0,0,0,0,0,0,0,0,0,0
118901,2021,USA,France,0,5,9,14,16/06/2021,0,0,3,3,10,0,5,15,2,4,5,11,0,0,0,0,4,0,0,4
118901,2021,Italy,USA,1,2,1,4,15/06/2021,0,0,0,0,2,0,3,5,1,1,4,6,0,0,1,1,2,0,0,2
118901,2021,USA,Serbia,2,2,11,15,11/6/2021,0,0,2,2,3,2,4,9,2,4,1,7,2,0,0,2,1,0,0,1
118901,2021,Germany,USA,0,0,0,0,10/6/2021,0,0,0,0,0,0,0,0,0,0,0,0,0,0,0,0,0,0,0,0
118901,2021,Poland,USA,0,3,3,6,4/6/2021,0,0,0,0,1,2,5,8,3,0,0,3,0,0,0,0,1,1,0,2
118901,2021,USA,Argentina,1,5,18,24,30/05/2021,0,0,2,2,6,0,3,9,0,2,0,2,0,0,1,1,2,0,0,2
118901,2021,USA,Brazil,0,0,0,0,29/05/2021,0,0,0,0,0,0,0,0,0,0,0,0,0,0,0,0,0,0,0,0
118901,2021,USA,Canada,1,5,5,11,28/05/2021,1,0,0,1,3,0,4,7,1,1,3,5,0,0,1,1,2,0,0,2
136074,2021,USA,Serbia,1,3,4,8,11/6/2021,0,0,1,1,10,2,2,14,0,3,0,3,0,0,0,0,2,2,0,4
136074,2021,Germany,USA,0,1,0,1,10/6/2021,0,0,0,0,1,0,1,2,1,1,0,2,0,0,0,0,1,0,0,1
136074,2021,Iran,USA,0,5,5,10,9/6/2021,0,0,1,1,14,3,9,26,0,2,1,3,0,0,0,0,4,2,2,8
136074,2021,USA,Australia,0,0,0,0,5/6/2021,0,0,0,0,0,0,0,0,0,0,0,0,0,0,0,0,0,0,0,0
136074,2021,Poland,USA,0,0,7,7,4/6/2021,0,0,0,0,5,3,6,14,0,0,1,1,0,0,1,1,3,2,0,5
136074,2021,Russia,USA,0,2,2,4,3/6/2021,0,0,1,1,4,3,7,14,0,0,1,1,0,0,0,0,2,1,0,3
136074,2021,USA,Argentina,1,3,2,6,30/05/2021,0,0,1,1,6,6,3,15,3,1,0,4,0,0,0,0,2,0,2,4
136074,2021,USA,Brazil,0,5,6,11,29/05/2021,0,0,1,1,15,6,9,30,3,0,0,3,0,0,0,0,0,0,0,0
136074,2021,USA,Canada,0,0,0,0,28/05/2021,0,0,0,0,0,0,0,0,0,0,0,0,0,0,0,0,0,0,0,0
147725,2021,USA,Japan,0,0,0,0,23/06/2021,0,0,0,0,0,0,0,0,0,0,0,0,0,0,0,0,0,0,0,0
147725,2021,Bulgaria,USA,0,0,0,0,22/06/2021,0,0,0,0,0,0,0,0,0,0,0,0,0,0,0,0,0,0,0,0
147725,2021,Slovenia,USA,0,0,0,0,21/06/2021,0,0,0,0,0,0,0,0,0,0,0,0,0,0,0,0,0,0,0,0
147725,2021,USA,France,0,0,0,0,16/06/2021,0,0,0,0,0,0,0,0,0,0,0,0,0,0,0,0,0,0,0,0
147725,2021,USA,Serbia,0,3,4,7,11/6/2021,0,0,1,1,5,4,6,15,0,1,0,1,5,3,7,15,0,3,0,3
147725,2021,Germany,USA,1,5,4,10,10/6/2021,0,0,2,2,9,4,10,23,2,2,2,6,3,3,9,15,3,0,1,4
147725,2021,Iran,USA,1,1,5,7,9/6/2021,0,0,1,1,0,2,1,3,0,1,0,1,3,0,3,6,0,0,0,0
147725,2021,Russia,USA,0,0,0,0,3/6/2021,0,0,0,0,0,0,0,0,0,0,0,0,0,0,0,0,0,0,0,0
147725,2021,USA,Argentina,0,0,0,0,30/05/2021,0,0,0,0,0,0,0,0,0,0,0,0,0,0,0,0,0,0,0,0
147725,2021,USA,Brazil,0,0,0,0,29/05/2021,0,0,0,0,0,0,0,0,0,0,0,0,0,0,0,0,0,0,0,0
147725,2021,USA,Canada,0,0,0,0,28/05/2021,0,0,0,0,0,0,0,0,0,0,0,0,0,0,0,0,0,0,0,0
147543,2021,USA,Serbia,0,4,13,17,11/6/2021,25,0,63,88,2,1,1,4,0,3,1,4,0,0,0,0,4,1,0,5
147543,2021,Germany,USA,0,0,0,0,10/6/2021,2,0,2,4,1,0,0,1,0,0,0,0,0,0,0,0,0,0,0,0
147543,2021,Iran,USA,0,0,0,0,9/6/2021,0,0,1,1,0,0,0,0,0,0,0,0,0,0,1,1,0,0,0,0
147543,2021,Poland,USA,0,0,4,4,4/6/2021,12,0,17,29,1,0,0,1,0,0,1,1,0,0,0,0,3,2,0,5
147543,2021,USA,Argentina,0,0,0,0,30/05/2021,0,0,0,0,0,0,0,0,0,0,0,0,0,0,0,0,0,0,0,0
143682,2021,USA,Japan,0,0,0,0,23/06/2021,0,0,0,0,0,0,0,0,0,0,0,0,0,0,0,0,0,0,0,0
143682,2021,Bulgaria,USA,1,3,7,11,22/06/2021,0,0,2,2,7,1,10,18,2,2,3,7,6,0,11,17,9,5,0,14
143682,2021,Slovenia,USA,0,0,0,0,21/06/2021,0,0,0,0,0,0,0,0,0,0,0,0,0,1,0,1,0,0,0,0
143682,2021,Netherlands,USA,0,0,0,0,17/06/2021,0,0,0,0,0,0,0,0,0,0,0,0,0,0,0,0,0,0,0,0
143682,2021,USA,France,0,0,15,15,16/06/2021,0,0,2,2,12,5,13,30,1,5,5,11,13,2,14,29,6,2,1,9
143682,2021,Italy,USA,0,0,0,0,15/06/2021,0,0,0,0,0,0,0,0,0,0,0,0,0,0,0,0,0,0,0,0
143682,2021,USA,Australia,3,1,11,15,5/6/2021,0,0,1,1,4,3,8,15,1,1,0,2,11,0,17,28,1,1,1,3
143682,2021,Poland,USA,0,2,1,3,4/6/2021,0,0,0,0,2,0,3,5,0,1,0,1,2,0,2,4,0,3,0,3
143682,2021,Russia,USA,1,2,12,15,3/6/2021,0,0,2,2,14,2,5,21,1,2,2,5,5,1,15,21,6,7,2,15
143682,2021,USA,Argentina,0,0,0,0,30/05/2021,0,0,0,0,0,0,0,0,0,0,0,0,0,0,0,0,0,0,0,0
143682,2021,USA,Brazil,0,1,4,5,29/05/2021,0,0,0,0,4,3,6,13,1,1,0,2,8,1,8,17,0,0,0,0
143682,2021,USA,Canada,0,0,0,0,28/05/2021,0,0,0,0,0,0,0,0,0,0,0,0,0,0,0,0,0,0,0,0
133463,2021,USA,Japan,0,2,7,9,23/06/2021,0,0,3,3,12,1,3,16,0,2,0,2,13,1,12,26,4,6,0,10
133463,2021,Bulgaria,USA,0,3,6,9,22/06/2021,0,0,1,1,13,2,8,23,0,0,3,3,7,0,7,14,6,1,1,8
133463,2021,Slovenia,USA,1,1,3,5,21/06/2021,0,0,0,0,0,0,1,1,0,1,0,1,0,0,1,1,1,0,0,1
133463,2021,Netherlands,USA,3,4,15,22,17/06/2021,0,0,0,0,17,3,10,30,1,2,3,6,13,3,12,28,7,1,0,8
133463,2021,USA,France,0,0,2,2,16/06/2021,0,0,0,0,0,0,0,0,0,0,0,0,0,0,0,0,0,0,0,0
133463,2021,Italy,USA,0,1,0,1,15/06/2021,0,0,0,0,0,0,0,0,0,0,0,0,0,0,0,0,0,0,0,0
133463,2021,USA,Serbia,0,2,7,9,11/6/2021,0,0,0,0,4,1,7,12,1,1,0,2,12,1,5,18,2,2,0,4
133463,2021,Germany,USA,2,2,14,18,10/6/2021,0,0,1,1,9,0,6,15,1,2,2,5,2,1,9,12,3,2,0,5
133463,2021,Iran,USA,0,0,12,12,9/6/2021,0,0,1,1,11,2,6,19,1,4,1,6,8,4,14,26,9,1,1,11
133463,2021,USA,Australia,0,1,1,2,5/6/2021,0,0,0,0,0,0,0,0,0,0,0,0,0,0,0,0,0,0,0,0
133463,2021,Poland,USA,1,1,6,8,4/6/2021,0,0,1,1,2,2,8,12,0,1,2,3,5,1,8,14,5,1,0,6
133463,2021,Russia,USA,0,0,0,0,3/6/2021,0,0,0,0,0,0,0,0,0,0,0,0,0,0,0,0,0,0,0,0
133463,2021,USA,Argentina,1,2,12,15,30/05/2021,0,0,5,5,5,5,11,21,0,2,1,3,7,0,7,14,9,4,2,15
133463,2021,USA,Brazil,0,0,2,2,29/05/2021,0,0,0,0,0,1,3,4,0,0,0,0,0,1,2,3,0,0,0,0
133463,2021,USA,Canada,0,2,10,12,28/05/2021,0,0,0,0,5,2,8,15,0,0,0,0,10,2,12,24,4,2,0,6
148120,2021,USA,Serbia,0,0,0,0,11/6/2021,0,0,0,0,0,0,0,0,0,0,0,0,0,0,0,0,0,0,0,0
148120,2021,Iran,USA,0,3,8,11,9/6/2021,0,0,0,0,2,2,1,5,1,3,2,6,0,0,1,1,2,0,1,3
148120,2021,USA,Australia,0,0,0,0,5/6/2021,0,0,0,0,0,0,0,0,0,0,0,0,0,0,0,0,0,0,0,0
148120,2021,Poland,USA,0,0,3,3,4/6/2021,0,0,1,1,3,1,0,4,1,0,1,2,0,0,0,0,0,0,1,1
148120,2021,Russia,USA,0,0,8,8,3/6/2021,0,0,1,1,4,0,2,6,1,1,0,2,0,0,0,0,1,0,1,2
148120,2021,USA,Argentina,0,0,0,0,30/05/2021,0,0,0,0,0,0,0,0,0,0,0,0,0,0,0,0,0,0,0,0
148120,2021,USA,Canada,0,1,14,15,28/05/2021,0,0,0,0,8,0,4,12,1,3,0,4,0,0,0,0,2,1,0,3
116069,2021,USA,Japan,0,4,8,12,23/06/2021,0,0,4,4,5,0,6,11,1,4,2,7,0,0,0,0,3,0,0,3
116069,2021,Bulgaria,USA,0,0,0,0,22/06/2021,0,0,0,0,0,0,0,0,0,0,0,0,0,0,0,0,0,0,0,0
116069,2021,Slovenia,USA,1,1,12,14,21/06/2021,0,0,2,2,4,4,3,11,1,6,4,11,0,0,0,0,5,0,1,6
116069,2021,Netherlands,USA,1,4,13,18,17/06/2021,0,0,3,3,8,1,1,10,0,6,6,12,1,0,1,2,4,0,1,5
116069,2021,USA,France,0,0,0,0,16/06/2021,0,0,0,0,0,0,0,0,0,0,0,0,0,0,0,0,0,0,0,0
116069,2021,Italy,USA,1,1,13,15,15/06/2021,0,0,0,0,3,0,2,5,2,1,3,6,1,0,0,1,5,2,0,7
116069,2021,USA,Serbia,4,2,11,17,11/6/2021,0,0,0,0,4,1,4,9,1,3,1,5,1,0,3,4,1,1,0,2
116069,2021,Germany,USA,1,3,7,11,10/6/2021,0,0,2,2,3,1,4,8,1,2,4,7,1,0,0,1,4,0,0,4
116069,2021,Iran,USA,0,0,0,0,9/6/2021,0,0,0,0,0,0,0,0,0,0,0,0,0,0,0,0,0,0,0,0
116069,2021,USA,Australia,1,2,9,12,5/6/2021,0,0,0,0,5,0,0,5,3,2,3,8,0,0,0,0,3,0,1,4
116069,2021,Russia,USA,0,1,5,6,3/6/2021,0,0,0,0,2,1,2,5,0,2,1,3,0,0,0,0,2,1,0,3
116069,2021,USA,Argentina,0,5,6,11,30/05/2021,0,0,1,1,8,2,4,14,0,0,1,1,0,0,0,0,1,0,0,1
116069,2021,USA,Brazil,0,0,0,0,29/05/2021,0,0,0,0,0,0,0,0,0,0,0,0,0,0,0,0,0,0,0,0
116069,2021,USA,Canada,0,0,0,0,28/05/2021,0,0,0,0,0,0,0,0,0,0,0,0,0,0,0,0,0,0,0,0
133895,2021,Netherlands,USA,0,0,0,0,17/06/2021,0,0,2,2,0,0,0,0,0,0,0,0,3,1,5,9,7,3,1,11
133895,2021,USA,France,0,0,0,0,16/06/2021,0,0,0,0,0,0,0,0,0,0,0,0,0,0,0,0,0,0,0,0
133895,2021,Italy,USA,0,0,0,0,15/06/2021,0,0,0,0,0,0,0,0,0,0,0,0,0,0,0,0,0,0,0,0
133895,2021,USA,Serbia,0,0,0,0,11/6/2021,0,0,0,0,0,0,0,0,0,0,0,0,0,0,0,0,0,0,0,0
133895,2021,Germany,USA,0,0,0,0,10/6/2021,0,0,0,0,0,0,0,0,0,0,0,0,0,0,0,0,0,0,0,0
133895,2021,USA,Australia,0,0,0,0,5/6/2021,0,0,8,8,0,0,0,0,0,0,0,0,3,1,10,14,7,2,0,9
133895,2021,Poland,USA,0,0,0,0,4/6/2021,0,0,0,0,0,0,0,0,0,0,0,0,0,0,0,0,0,0,0,0
133895,2021,Russia,USA,0,0,0,0,3/6/2021,0,0,0,0,0,0,0,0,0,0,0,0,0,0,0,0,0,0,0,0
133895,2021,USA,Argentina,0,0,0,0,30/05/2021,0,0,0,0,0,0,0,0,0,0,0,0,0,0,0,0,0,0,0,0
133895,2021,USA,Brazil,0,0,0,0,29/05/2021,0,0,0,0,0,0,0,0,0,0,0,0,0,0,0,0,0,0,0,0
133895,2021,USA,Canada,0,0,0,0,28/05/2021,0,0,0,0,0,0,0,0,0,0,0,0,0,0,0,0,0,0,0,0
119732,2021,USA,Japan,0,0,0,0,23/06/2021,0,0,4,4,0,0,0,0,0,0,0,0,6,1,8,15,1,0,2,3
119732,2021,Bulgaria,USA,0,0,0,0,22/06/2021,0,0,6,6,0,0,0,0,0,0,0,0,3,0,7,10,8,3,0,11
119732,2021,Slovenia,USA,0,0,0,0,21/06/2021,0,0,7,7,0,0,0,0,0,0,0,0,2,0,12,14,9,0,0,9
119732,2021,Netherlands,USA,0,0,0,0,17/06/2021,0,0,3,3,0,0,0,0,0,0,0,0,5,1,3,9,7,0,0,7
119732,2021,USA,France,0,0,0,0,16/06/2021,0,0,8,8,0,0,0,0,0,0,0,0,8,1,12,21,14,3,0,17
119732,2021,Italy,USA,0,0,0,0,15/06/2021,0,0,3,3,0,0,0,0,0,0,0,0,5,2,2,9,6,5,0,11
119732,2021,USA,Serbia,0,0,0,0,11/6/2021,0,0,3,3,0,0,0,0,0,0,0,0,12,0,10,22,1,5,0,6
119732,2021,Germany,USA,0,0,0,0,10/6/2021,0,0,5,5,0,0,0,0,0,0,0,0,5,0,7,12,6,1,0,7
119732,2021,Iran,USA,0,0,0,0,9/6/2021,0,0,8,8,0,0,0,0,0,0,0,0,4,0,11,15,9,3,0,12
119732,2021,USA,Australia,0,0,0,0,5/6/2021,0,0,0,0,0,0,0,0,0,0,0,0,0,0,0,0,0,0,0,0
119732,2021,Poland,USA,0,0,0,0,4/6/2021,0,0,1,1,0,0,0,0,0,0,0,0,4,0,11,15,8,7,0,15
119732,2021,Russia,USA,0,0,0,0,3/6/2021,0,0,5,5,0,0,0,0,0,0,0,0,10,0,17,27,8,2,1,11
119732,2021,USA,Argentina,0,0,0,0,30/05/2021,0,0,3,3,0,0,0,0,0,0,0,0,9,1,5,15,6,5,0,11
119732,2021,USA,Brazil,0,0,0,0,29/05/2021,0,0,1,1,0,0,0,0,0,0,0,0,4,1,2,7,2,0,0,2
119732,2021,USA,Canada,0,0,0,0,28/05/2021,0,0,2,2,0,0,0,0,0,0,0,0,3,0,7,10,16,3,0,19
142412,2022,USA,Argentina,0,1,3,4,10/7/2022,2,0,1,3,0,0,0,0,0,0,0,0,0,0,0,0,0,0,0,0
142412,2022,France,Argentina,0,0,3,3,9/7/2022,1,0,1,2,0,0,0,0,0,0,0,0,0,0,0,0,0,0,0,0
142412,2022,Argentina,Australia,0,0,0,0,8/7/2022,0,0,0,0,0,0,0,0,0,0,0,0,0,0,0,0,0,0,0,0
142412,2022,Canada,Argentina,0,0,0,0,5/7/2022,0,0,7,7,0,0,0,0,0,0,0,0,0,0,0,0,0,0,0,0
142412,2022,Argentina,Netherlands,0,1,14,15,25/06/2022,35,0,59,94,1,0,1,2,0,3,7,10,0,1,1,2,4,7,4,15
142412,2022,Argentina,China,0,0,17,17,24/06/2022,36,0,41,77,1,0,0,1,0,1,1,2,0,0,0,0,6,1,1,8
142412,2022,Argentina,Slovenia,0,2,6,8,23/06/2022,25,0,42,67,1,1,0,2,1,1,1,3,0,0,0,0,7,2,0,9
142412,2022,Argentina,Japan,0,2,13,15,21/06/2022,25,0,44,69,1,0,0,1,0,1,0,1,0,0,1,1,4,0,1,5
142412,2022,Argentina,Italy,0,1,9,10,12/6/2022,47,0,30,77,0,0,1,1,0,4,0,4,0,0,0,0,7,0,4,11
142412,2022,Serbia,Argentina,0,0,4,4,10/6/2022,27,0,19,46,0,1,0,1,1,0,0,1,0,0,0,0,3,0,0,3
142412,2022,Germany,Argentina,0,0,10,10,9/6/2022,23,0,44,67,0,0,2,2,0,1,0,1,0,0,1,1,6,0,2,8
142412,2022,Poland,Argentina,1,1,8,10,8/6/2022,31,0,31,62,1,0,0,1,0,0,0,0,0,0,0,0,4,3,3,10
174866,2022,,,-,-,-,-,-,-,-,-,-,-,-,-,-,-,-,-,-,-,-,-,-,-,-,-,-
142410,2022,,,-,-,-,-,-,-,-,-,-,-,-,-,-,-,-,-,-,-,-,-,-,-,-,-,-
142411,2022,USA,Argentina,0,1,12,13,10/7/2022,0,0,2,2,8,0,4,12,3,7,4,14,1,1,2,4,1,2,2,5
142411,2022,France,Argentina,0,2,5,7,9/7/2022,0,0,1,1,5,1,4,10,1,2,4,7,0,0,1,1,2,0,1,3
142411,2022,Argentina,Australia,0,1,16,17,8/7/2022,0,0,0,0,10,0,7,17,5,3,5,13,0,0,0,0,1,2,0,3
142411,2022,Canada,Argentina,0,0,0,0,5/7/2022,0,0,0,0,0,0,0,0,0,0,0,0,0,0,0,0,0,0,0,0
142411,2022,Argentina,Netherlands,0,0,0,0,25/06/2022,0,0,0,0,0,0,0,0,0,0,0,0,0,0,0,0,0,0,0,0
142411,2022,Argentina,China,0,0,0,0,24/06/2022,0,0,0,0,0,0,0,0,0,0,0,0,0,0,0,0,0,0,0,0
142411,2022,Argentina,Slovenia,0,0,0,0,23/06/2022,0,0,0,0,0,0,0,0,0,0,0,0,0,0,0,0,0,0,0,0
142411,2022,Argentina,Japan,0,0,4,4,21/06/2022,0,0,0,0,0,2,2,4,1,3,3,7,0,0,0,0,1,0,0,1
142411,2022,Argentina,Italy,0,3,10,13,12/6/2022,0,0,0,0,3,0,2,5,5,3,1,9,1,0,1,2,1,0,2,3
142411,2022,Serbia,Argentina,0,0,0,0,10/6/2022,0,0,0,0,0,0,0,0,0,0,0,0,0,0,0,0,0,0,0,0
142411,2022,Germany,Argentina,0,0,0,0,9/6/2022,0,0,0,0,0,0,0,0,0,0,0,0,0,0,0,0,0,0,0,0
142411,2022,Poland,Argentina,0,0,0,0,8/6/2022,0,0,0,0,0,0,0,0,0,0,0,0,0,0,0,0,0,0,0,0
171315,2022,,,-,-,-,-,-,-,-,-,-,-,-,-,-,-,-,-,-,-,-,-,-,-,-,-,-
132647,2022,,,-,-,-,-,-,-,-,-,-,-,-,-,-,-,-,-,-,-,-,-,-,-,-,-,-
118886,2022,,,-,-,-,-,-,-,-,-,-,-,-,-,-,-,-,-,-,-,-,-,-,-,-,-,-
152692,2022,USA,Argentina,0,3,16,19,10/7/2022,0,0,0,0,9,3,7,19,2,7,3,12,0,0,1,1,4,1,3,8
152692,2022,France,Argentina,1,5,10,16,9/7/2022,0,0,4,4,10,0,3,13,1,6,5,12,1,0,1,2,1,1,0,2
152692,2022,Argentina,Australia,0,2,4,6,8/7/2022,0,0,0,0,5,2,1,8,2,2,2,6,0,0,0,0,2,0,0,2
152692,2022,Canada,Argentina,0,4,14,18,5/7/2022,0,1,0,1,11,2,6,19,1,4,1,6,1,0,1,2,0,0,1,1
152692,2022,Argentina,Netherlands,0,4,10,14,25/06/2022,0,0,1,1,10,1,4,15,6,7,6,19,1,0,5,6,1,1,0,2
152692,2022,Argentina,China,0,4,13,17,24/06/2022,0,0,2,2,12,1,5,18,1,8,3,12,1,0,0,1,2,0,1,3
152692,2022,Argentina,Slovenia,1,4,9,14,23/06/2022,0,0,1,1,6,2,7,15,5,5,4,14,2,0,0,2,3,0,1,4
152692,2022,Argentina,Japan,0,3,11,14,21/06/2022,0,0,1,1,8,1,3,12,3,7,10,20,1,0,2,3,3,2,2,7
152692,2022,Argentina,Italy,2,6,14,22,12/6/2022,0,0,2,2,12,2,7,21,2,7,9,18,1,0,3,4,4,0,4,8
152692,2022,Serbia,Argentina,0,0,0,0,10/6/2022,0,0,0,0,0,0,0,0,0,0,0,0,0,0,0,0,0,0,0,0
152692,2022,Germany,Argentina,3,2,18,23,9/6/2022,0,0,1,1,8,2,3,13,2,14,5,21,0,0,0,0,1,0,1,2
152692,2022,Poland,Argentina,1,3,9,13,8/6/2022,0,0,0,0,4,1,5,10,1,3,5,9,0,0,0,0,0,0,0,0
153053,2022,USA,Argentina,0,0,0,0,10/7/2022,0,0,6,6,0,0,0,0,0,0,0,0,11,1,9,21,12,4,2,18
153053,2022,France,Argentina,0,0,0,0,9/7/2022,0,0,8,8,0,0,0,0,0,0,0,0,3,0,13,16,8,6,3,17
153053,2022,Argentina,Australia,0,0,0,0,8/7/2022,0,0,6,6,0,0,0,0,0,0,0,0,13,0,2,15,10,1,1,12
153053,2022,Canada,Argentina,0,0,0,0,5/7/2022,0,0,3,3,0,0,0,0,0,0,0,0,7,0,6,13,5,7,2,14
153053,2022,Argentina,Netherlands,0,0,0,0,25/06/2022,0,0,3,3,0,0,0,0,0,0,0,0,8,2,6,16,12,7,0,19
153053,2022,Argentina,China,0,0,0,0,24/06/2022,1,0,9,10,0,0,0,0,0,0,0,0,12,0,12,24,11,3,1,15
153053,2022,Argentina,Slovenia,0,0,0,0,23/06/2022,1,1,7,9,0,0,0,0,0,0,0,0,7,1,8,16,12,10,1,23
153053,2022,Argentina,Japan,0,0,0,0,21/06/2022,0,0,2,2,0,0,0,0,0,0,0,0,4,2,10,16,12,3,0,15
153053,2022,Argentina,Italy,0,0,0,0,12/6/2022,0,0,5,5,0,0,0,0,0,0,0,0,6,1,13,20,11,5,6,22
153053,2022,Serbia,Argentina,0,0,0,0,10/6/2022,0,0,4,4,0,0,0,0,0,0,0,0,3,0,19,22,6,1,4,11
153053,2022,Germany,Argentina,0,0,0,0,9/6/2022,0,0,7,7,0,0,0,0,0,0,0,0,7,2,8,17,14,2,2,18
153053,2022,Poland,Argentina,0,0,0,0,8/6/2022,0,0,9,9,0,0,0,0,0,0,0,0,6,1,10,17,4,3,2,9
136737,2022,USA,Argentina,0,0,0,0,10/7/2022,0,0,0,0,0,0,0,0,0,0,0,0,0,0,0,0,0,0,0,0
136737,2022,France,Argentina,0,0,0,0,9/7/2022,0,0,0,0,0,0,0,0,0,0,0,0,0,0,0,0,0,0,0,0
136737,2022,Argentina,Australia,0,0,0,0,8/7/2022,0,0,0,0,0,0,0,0,0,0,0,0,0,0,0,0,0,0,0,0
136737,2022,Canada,Argentina,0,1,1,2,5/7/2022,0,0,0,0,0,0,0,0,0,0,0,0,0,0,0,0,0,0,0,0
136737,2022,Argentina,Netherlands,0,0,2,2,25/06/2022,0,0,0,0,0,0,0,0,0,0,0,0,0,0,0,0,1,0,0,1
136737,2022,Argentina,China,0,0,0,0,24/06/2022,0,0,0,0,0,0,0,0,0,0,0,0,0,0,0,0,0,0,0,0
136737,2022,Argentina,Slovenia,0,0,1,1,23/06/2022,0,0,0,0,0,0,0,0,0,0,0,0,0,0,0,0,0,0,0,0
136737,2022,Argentina,Japan,1,3,14,18,21/06/2022,0,0,5,5,7,2,6,15,0,2,1,3,7,0,11,18,1,3,0,4
136737,2022,Argentina,Italy,0,1,5,6,12/6/2022,0,0,2,2,3,0,4,7,0,0,2,2,0,0,4,4,2,1,2,5
136737,2022,Serbia,Argentina,0,0,2,2,10/6/2022,0,0,1,1,1,0,0,1,0,0,0,0,1,3,3,7,0,0,0,0
136737,2022,Germany,Argentina,0,1,16,17,9/6/2022,0,0,4,4,10,2,6,18,0,3,2,5,3,5,12,20,5,0,1,6
136737,2022,Poland,Argentina,1,1,7,9,8/6/2022,0,0,1,1,9,3,13,25,0,0,4,4,1,0,13,14,7,3,0,10
174853,2022,USA,Argentina,0,1,2,3,10/7/2022,0,0,2,2,4,2,4,10,0,1,0,1,4,0,5,9,1,1,1,3
174853,2022,France,Argentina,0,0,0,0,9/7/2022,0,0,2,2,0,0,1,1,0,0,0,0,0,0,0,0,0,0,0,0
174853,2022,Argentina,Australia,0,0,3,3,8/7/2022,0,0,0,0,2,3,4,9,0,0,0,0,3,0,5,8,1,0,1,2
174853,2022,Canada,Argentina,0,0,0,0,5/7/2022,0,0,0,0,1,1,1,3,0,0,0,0,0,0,0,0,0,0,0,0
174853,2022,Argentina,Netherlands,0,0,0,0,25/06/2022,0,0,0,0,0,0,0,0,0,0,0,0,0,0,0,0,0,0,0,0
174853,2022,Argentina,China,0,0,0,0,24/06/2022,0,0,0,0,0,0,0,0,0,0,0,0,0,0,0,0,0,0,0,0
174853,2022,Argentina,Slovenia,0,0,4,4,23/06/2022,0,0,0,0,2,3,3,8,1,0,1,2,1,1,4,6,2,1,0,3
174853,2022,Argentina,Japan,0,0,0,0,21/06/2022,0,0,0,0,0,0,0,0,0,0,0,0,0,0,0,0,0,0,0,0
174853,2022,Argentina,Italy,0,0,2,2,12/6/2022,0,0,1,1,1,4,3,8,1,0,0,1,3,1,3,7,0,2,0,2
174853,2022,Serbia,Argentina,2,2,9,13,10/6/2022,1,0,3,4,8,5,8,21,3,3,1,7,5,0,15,20,1,1,2,4
174853,2022,Germany,Argentina,0,1,2,3,9/6/2022,0,0,0,0,1,3,5,9,2,1,1,4,1,0,4,5,0,1,1,2
174853,2022,Poland,Argentina,0,0,4,4,8/6/2022,0,0,0,0,3,0,2,5,0,3,0,3,2,1,7,10,1,3,0,4
142415,2022,USA,Argentina,0,0,0,0,10/7/2022,0,0,0,0,0,0,0,0,0,0,0,0,0,0,0,0,0,0,0,0
142415,2022,France,Argentina,0,0,1,1,9/7/2022,0,0,0,0,0,0,0,0,0,0,0,0,0,0,0,0,0,0,0,0
142415,2022,Argentina,Australia,3,3,10,16,8/7/2022,1,0,0,1,16,5,3,24,0,6,3,9,0,0,0,0,6,5,1,12
142415,2022,Canada,Argentina,0,3,4,7,5/7/2022,0,0,0,0,2,5,2,9,1,1,0,2,0,0,0,0,2,0,0,2
142415,2022,Argentina,Netherlands,1,6,12,19,25/06/2022,0,0,0,0,19,3,9,31,1,7,2,10,0,1,0,1,6,2,1,9
142415,2022,Argentina,China,2,4,15,21,24/06/2022,0,1,0,1,20,1,8,29,3,3,2,8,0,0,0,0,5,5,0,10
142415,2022,Argentina,Slovenia,1,5,7,13,23/06/2022,0,0,0,0,11,5,13,29,0,2,2,4,2,0,3,5,6,0,1,7
142415,2022,Argentina,Japan,0,7,6,13,21/06/2022,0,0,0,0,17,4,9,30,1,2,0,3,0,1,1,2,3,1,0,4
142415,2022,Argentina,Italy,0,5,9,14,12/6/2022,0,0,2,2,17,6,11,34,1,7,4,12,0,2,2,4,2,1,6,9
142415,2022,Serbia,Argentina,2,4,6,12,10/6/2022,0,0,1,1,11,7,12,30,2,2,2,6,1,0,0,1,3,4,1,8
142415,2022,Germany,Argentina,1,4,11,16,9/6/2022,0,0,1,1,16,5,10,31,2,4,0,6,0,0,1,1,2,5,2,9
142415,2022,Poland,Argentina,0,5,8,13,8/6/2022,0,0,1,1,7,3,12,22,1,3,5,9,0,0,1,1,2,2,0,4
125048,2022,USA,Argentina,0,5,11,16,10/7/2022,1,0,2,3,16,6,14,36,0,6,2,8,3,0,16,19,4,4,2,10
125048,2022,France,Argentina,1,6,8,15,9/7/2022,0,0,2,2,15,3,11,29,1,3,9,13,3,2,15,20,10,2,4,16
125048,2022,Argentina,Australia,1,3,8,12,8/7/2022,0,0,1,1,10,3,3,16,1,2,0,3,7,2,15,24,6,2,4,12
125048,2022,Canada,Argentina,1,5,7,13,5/7/2022,0,0,2,2,15,1,15,31,2,3,8,13,5,1,26,32,7,2,0,9
125048,2022,Argentina,Netherlands,3,5,11,19,25/06/2022,0,0,3,3,15,2,10,27,1,2,5,8,11,2,13,26,2,4,0,6
125048,2022,Argentina,China,1,5,8,14,24/06/2022,0,0,2,2,12,2,8,22,0,5,1,6,8,1,28,37,6,1,2,9
125048,2022,Argentina,Slovenia,0,4,10,14,23/06/2022,0,0,3,3,11,3,10,24,1,4,4,9,9,3,16,28,6,3,1,10
125048,2022,Argentina,Japan,0,0,12,12,21/06/2022,0,0,1,1,13,2,8,23,0,4,7,11,9,6,14,29,4,2,2,8
125048,2022,Argentina,Italy,0,3,11,14,12/6/2022,1,0,3,4,7,0,7,14,0,5,4,9,0,0,10,10,7,1,3,11
125048,2022,Serbia,Argentina,0,2,1,3,10/6/2022,0,0,0,0,2,2,2,6,0,2,2,4,3,1,9,13,1,0,3,4
125048,2022,Germany,Argentina,2,0,10,12,9/6/2022,0,0,2,2,10,1,13,24,2,3,1,6,5,2,15,22,1,1,2,4
125048,2022,Poland,Argentina,0,1,4,5,8/6/2022,0,0,3,3,4,2,7,13,1,2,0,3,0,1,12,13,2,3,1,6
125049,2022,,,-,-,-,-,-,-,-,-,-,-,-,-,-,-,-,-,-,-,-,-,-,-,-,-,-
117457,2022,USA,Argentina,1,3,19,23,10/7/2022,55,1,53,109,0,1,2,3,2,5,5,12,0,0,0,0,3,0,2,5
117457,2022,France,Argentina,0,3,9,12,9/7/2022,28,0,60,88,2,1,1,4,0,2,2,4,0,0,0,0,4,3,2,9
117457,2022,Argentina,Australia,3,1,12,16,8/7/2022,46,0,42,88,0,0,1,1,0,3,2,5,0,0,1,1,3,5,3,11
117457,2022,Canada,Argentina,1,4,14,19,5/7/2022,28,0,63,91,0,0,0,0,1,2,3,6,0,0,0,0,5,0,0,5
162546,2022,USA,Argentina,0,5,9,14,10/7/2022,0,0,1,1,24,3,10,37,0,4,2,6,2,0,7,9,6,3,1,10
162546,2022,France,Argentina,1,3,10,14,9/7/2022,0,0,1,1,12,2,11,25,1,1,1,3,0,0,1,1,10,2,0,12
162546,2022,Argentina,Australia,0,1,2,3,8/7/2022,0,0,0,0,1,2,2,5,0,0,0,0,2,1,4,7,0,1,0,1
162546,2022,Canada,Argentina,0,1,12,13,5/7/2022,0,0,2,2,13,2,11,26,0,2,2,4,3,1,7,11,6,1,2,9
162546,2022,Argentina,Netherlands,0,0,0,0,25/06/2022,0,0,0,0,0,0,0,0,0,0,0,0,0,0,0,0,0,0,0,0
162546,2022,Argentina,China,0,0,0,0,24/06/2022,0,0,0,0,0,0,0,0,0,0,0,0,0,0,0,0,0,0,0,0
162546,2022,Argentina,Slovenia,0,1,0,1,23/06/2022,0,0,0,0,0,1,2,3,0,0,0,0,0,0,0,0,1,0,0,1
162546,2022,Argentina,Japan,0,1,0,1,21/06/2022,0,0,0,0,0,0,0,0,0,0,0,0,0,0,0,0,0,0,0,0
162546,2022,Argentina,Italy,0,1,7,8,12/6/2022,0,0,4,4,8,6,11,25,0,2,3,5,1,3,16,20,2,1,2,5
162546,2022,Serbia,Argentina,0,6,9,15,10/6/2022,0,0,4,4,18,3,11,32,0,5,2,7,4,2,13,19,2,3,2,7
162546,2022,Germany,Argentina,0,0,0,0,9/6/2022,0,0,0,0,0,0,0,0,0,0,0,0,0,0,0,0,0,0,0,0
162546,2022,Poland,Argentina,0,1,0,1,8/6/2022,0,0,0,0,0,0,0,0,0,0,0,0,0,0,0,0,0,0,0,0
163555,2022,USA,Argentina,1,5,7,13,10/7/2022,0,0,4,4,5,3,8,16,0,1,0,1,8,1,20,29,4,2,0,6
163555,2022,France,Argentina,2,6,12,20,9/7/2022,0,1,5,6,15,5,11,31,0,4,5,9,6,1,21,28,8,1,2,11
163555,2022,Argentina,Australia,0,2,11,13,8/7/2022,0,0,2,2,7,4,4,15,1,0,0,1,8,0,5,13,5,0,1,6
163555,2022,Canada,Argentina,0,1,7,8,5/7/2022,0,0,2,2,2,1,4,7,0,0,1,1,4,1,7,12,5,1,0,6
163555,2022,Argentina,Netherlands,0,2,15,17,25/06/2022,0,0,1,1,11,7,7,25,3,7,3,13,8,2,24,34,5,2,2,9
163555,2022,Argentina,China,0,5,10,15,24/06/2022,0,0,2,2,10,6,5,21,1,3,2,6,3,1,8,12,4,4,1,9
163555,2022,Argentina,Slovenia,2,2,11,15,23/06/2022,0,0,2,2,10,7,14,31,1,1,3,5,7,1,20,28,4,1,0,5
163555,2022,Argentina,Japan,0,0,1,1,21/06/2022,0,0,0,0,3,0,2,5,0,0,0,0,0,0,3,3,1,0,0,1
163555,2022,Argentina,Italy,0,0,0,0,12/6/2022,0,0,0,0,0,0,0,0,0,0,0,0,0,0,0,0,0,0,0,0
163555,2022,Serbia,Argentina,0,0,1,1,10/6/2022,0,0,0,0,0,1,0,1,0,0,0,0,0,0,0,0,0,0,0,0
163555,2022,Germany,Argentina,0,0,0,0,9/6/2022,0,0,0,0,0,0,0,0,0,0,0,0,0,0,0,0,0,0,0,0
163555,2022,Poland,Argentina,0,0,0,0,8/6/2022,0,0,0,0,0,0,0,0,0,0,0,0,0,0,0,0,0,0,0,0
125047,2022,USA,Argentina,0,0,0,0,10/7/2022,0,0,0,0,0,0,0,0,0,0,0,0,0,0,0,0,1,0,0,1
125047,2022,France,Argentina,0,0,9,9,9/7/2022,0,0,1,1,3,0,1,4,0,1,0,1,0,0,0,0,1,0,1,2
125047,2022,Argentina,Australia,1,1,7,9,8/7/2022,1,0,1,2,3,0,4,7,3,1,3,7,0,0,0,0,0,1,0,1
125047,2022,Canada,Argentina,0,0,0,0,5/7/2022,0,0,0,0,0,0,0,0,0,0,0,0,0,0,0,0,0,0,0,0
125047,2022,Argentina,Netherlands,0,0,0,0,25/06/2022,0,0,0,0,0,0,0,0,0,0,0,0,0,0,0,0,0,0,0,0
125047,2022,Argentina,China,0,3,6,9,24/06/2022,0,0,0,0,4,2,1,7,1,5,7,13,0,0,0,0,0,1,2,3
125047,2022,Argentina,Slovenia,0,0,6,6,23/06/2022,0,0,0,0,1,0,1,2,0,0,2,2,0,0,0,0,0,1,0,1
125047,2022,Argentina,Japan,0,0,0,0,21/06/2022,0,0,0,0,0,0,0,0,0,0,0,0,0,0,0,0,0,0,0,0
125047,2022,Argentina,Italy,0,0,0,0,12/6/2022,0,0,0,0,0,0,0,0,0,0,0,0,0,0,0,0,0,0,0,0
125047,2022,Serbia,Argentina,0,1,11,12,10/6/2022,0,0,3,3,7,2,6,15,1,3,6,10,0,0,3,3,3,1,2,6
125047,2022,Germany,Argentina,0,0,0,0,9/6/2022,0,0,0,0,0,0,0,0,0,0,0,0,0,0,0,0,0,0,0,0
125047,2022,Poland,Argentina,0,1,7,8,8/6/2022,0,0,0,0,2,0,2,4,1,1,2,4,0,0,0,0,3,0,2,5
135349,2022,USA,Argentina,0,0,0,0,10/7/2022,0,0,0,0,0,0,0,0,0,0,0,0,0,0,0,0,0,0,0,0
135349,2022,France,Argentina,0,0,0,0,9/7/2022,0,0,0,0,0,0,0,0,0,0,0,0,0,0,0,0,1,0,0,1
135349,2022,Argentina,Australia,0,0,0,0,8/7/2022,0,0,0,0,0,0,0,0,0,0,0,0,0,0,0,0,0,0,0,0
135349,2022,Canada,Argentina,0,0,0,0,5/7/2022,0,0,0,0,0,0,0,0,0,0,0,0,0,0,0,0,0,0,0,0
135349,2022,Argentina,Netherlands,0,0,0,0,25/06/2022,0,0,0,0,0,0,0,0,0,0,0,0,0,0,0,0,0,0,0,0
135349,2022,Argentina,China,0,0,0,0,24/06/2022,0,0,0,0,0,0,0,0,0,0,0,0,0,0,0,0,0,0,0,0
135349,2022,Argentina,Slovenia,0,0,0,0,23/06/2022,0,0,0,0,0,0,0,0,0,0,0,0,0,0,0,0,0,0,0,0
135349,2022,Argentina,Japan,0,0,0,0,21/06/2022,0,0,0,0,0,0,0,0,0,0,0,0,0,0,0,0,0,0,0,0
135349,2022,Argentina,Italy,0,0,0,0,12/6/2022,0,0,0,0,0,0,0,0,0,0,0,0,0,0,0,0,0,0,0,0
135349,2022,Serbia,Argentina,0,0,0,0,10/6/2022,0,0,0,0,0,0,0,0,0,0,0,0,0,0,0,0,0,0,0,0
135349,2022,Germany,Argentina,0,0,0,0,9/6/2022,0,0,0,0,0,0,0,0,0,0,0,0,0,0,0,0,0,0,0,0
135349,2022,Poland,Argentina,0,0,0,0,8/6/2022,0,0,0,0,0,0,0,0,0,0,0,0,0,0,0,0,0,0,0,0
160816,2022,,,-,-,-,-,-,-,-,-,-,-,-,-,-,-,-,-,-,-,-,-,-,-,-,-,-
162543,2022,USA,Argentina,0,0,0,0,10/7/2022,0,0,0,0,0,0,0,0,0,0,0,0,0,0,0,0,0,0,0,0
162543,2022,France,Argentina,0,0,0,0,9/7/2022,0,0,0,0,0,0,0,0,0,0,0,0,0,0,0,0,0,0,0,0
162543,2022,Argentina,Australia,0,0,0,0,8/7/2022,0,0,0,0,0,0,0,0,0,0,0,0,0,0,0,0,0,0,0,0
162543,2022,Canada,Argentina,2,1,14,17,5/7/2022,0,0,1,1,6,1,5,12,2,9,8,19,0,0,0,0,1,0,2,3
162543,2022,Argentina,Netherlands,0,0,19,19,25/06/2022,1,0,0,1,6,1,3,10,0,3,6,9,0,0,0,0,2,1,1,4
162543,2022,Argentina,China,0,0,3,3,24/06/2022,0,0,0,0,1,1,2,4,0,0,2,2,0,0,0,0,1,0,0,1
162543,2022,Argentina,Slovenia,0,1,3,4,23/06/2022,0,0,0,0,4,2,2,8,1,6,4,11,0,0,1,1,0,0,0,0
162543,2022,Argentina,Japan,0,1,5,6,21/06/2022,0,0,0,0,0,0,2,2,0,2,6,8,0,0,1,1,1,0,0,1
162543,2022,Argentina,Italy,0,0,2,2,12/6/2022,0,0,0,0,0,2,1,3,0,0,1,1,0,0,2,2,0,0,0,0
162543,2022,Serbia,Argentina,1,1,14,16,10/6/2022,0,0,0,0,6,0,1,7,2,4,10,16,0,0,0,0,2,2,0,4
162543,2022,Germany,Argentina,0,1,7,8,9/6/2022,0,0,0,0,2,1,0,3,1,3,11,15,1,0,0,1,0,1,4,5
162543,2022,Poland,Argentina,0,1,2,3,8/6/2022,0,0,1,1,1,1,2,4,2,4,2,8,0,0,2,2,0,1,2,3
162542,2022,,,-,-,-,-,-,-,-,-,-,-,-,-,-,-,-,-,-,-,-,-,-,-,-,-,-
152699,2022,,,-,-,-,-,-,-,-,-,-,-,-,-,-,-,-,-,-,-,-,-,-,-,-,-,-
163557,2022,,,-,-,-,-,-,-,-,-,-,-,-,-,-,-,-,-,-,-,-,-,-,-,-,-,-
142420,2022,Argentina,Netherlands,0,0,1,1,25/06/2022,0,0,4,4,0,1,0,1,0,0,0,0,0,0,0,0,0,0,0,0
142420,2022,Argentina,China,0,0,0,0,24/06/2022,0,0,7,7,1,0,0,1,0,0,0,0,0,0,0,0,0,0,0,0
142420,2022,Argentina,Slovenia,0,0,4,4,23/06/2022,6,0,31,37,1,0,0,1,0,0,1,1,0,0,0,0,3,0,0,3
142420,2022,Argentina,Japan,0,1,0,1,21/06/2022,3,0,8,11,0,0,0,0,0,0,0,0,0,0,0,0,0,0,0,0
142420,2022,Argentina,Italy,0,1,3,4,12/6/2022,11,0,5,16,0,0,0,0,0,1,0,1,0,0,0,0,1,2,2,5
142420,2022,Serbia,Argentina,3,3,7,13,10/6/2022,29,0,17,46,2,0,0,2,1,1,1,3,0,0,0,0,5,1,2,8
142420,2022,Germany,Argentina,0,3,0,3,9/6/2022,3,0,9,12,0,0,1,1,1,0,0,1,0,0,0,0,1,2,1,4
142420,2022,Poland,Argentina,0,1,0,1,8/6/2022,0,0,6,6,0,0,0,0,0,0,2,2,0,0,0,0,0,0,0,0
144457,2022,Australia,France,0,3,4,7,10/7/2022,0,0,0,0,4,0,0,4,2,1,4,7,1,0,0,1,0,0,0,0
144457,2022,Argentina,Australia,0,1,12,13,8/7/2022,0,0,1,1,7,1,4,12,2,4,4,10,0,0,0,0,1,0,2,3
144457,2022,Germany,Australia,2,3,11,16,7/7/2022,0,0,2,2,4,2,0,6,1,2,4,7,1,0,3,4,2,4,1,7
144457,2022,Japan,Australia,0,3,11,14,6/7/2022,0,0,2,2,4,1,4,9,1,3,2,6,1,0,0,1,0,1,0,1
144457,2022,Serbia,Australia,0,1,6,7,26/06/2022,0,0,0,0,2,0,1,3,0,2,0,2,0,0,0,0,1,2,0,3
144457,2022,Poland,Australia,0,0,5,5,25/06/2022,0,0,0,0,1,3,3,7,2,2,0,4,0,0,0,0,0,0,0,0
144457,2022,Australia,Bulgaria,1,0,10,11,24/06/2022,1,0,0,1,11,0,4,15,1,3,1,5,0,0,0,0,1,1,0,2
144457,2022,Australia,Canada,1,1,13,15,21/06/2022,0,0,0,0,9,1,1,11,1,2,4,7,2,0,0,2,0,1,1,2
144457,2022,Netherlands,Australia,0,1,9,10,12/6/2022,2,0,0,2,0,0,1,1,0,2,3,5,0,1,0,1,0,1,0,1
144457,2022,Iran,Australia,1,2,9,12,12/6/2022,1,0,0,1,7,1,7,15,3,3,5,11,0,0,4,4,1,0,0,1
144457,2022,Australia,Slovenia,0,1,8,9,11/6/2022,1,0,0,1,4,0,6,10,0,1,1,2,0,0,1,1,2,1,0,3
144457,2022,Brazil,Australia,0,2,3,5,9/6/2022,0,0,0,0,3,1,3,7,0,2,4,6,2,1,1,4,0,0,0,0
144456,2022,Australia,France,1,0,4,5,10/7/2022,9,1,20,30,0,0,2,2,0,1,0,1,0,0,0,0,1,2,0,3
144456,2022,Argentina,Australia,0,0,0,0,8/7/2022,0,0,0,0,0,0,0,0,0,0,0,0,0,0,0,0,0,0,0,0
144456,2022,Germany,Australia,0,1,13,14,7/7/2022,25,1,40,66,2,0,2,4,0,2,4,6,0,0,2,2,7,1,2,10
144456,2022,Japan,Australia,0,1,10,11,6/7/2022,21,1,45,67,2,0,3,5,1,2,3,6,0,1,0,1,3,2,0,5
144456,2022,Serbia,Australia,0,2,5,7,26/06/2022,14,0,45,59,1,1,1,3,1,6,1,8,0,0,0,0,1,0,0,1
144456,2022,Poland,Australia,0,0,0,0,25/06/2022,0,0,0,0,0,0,0,0,0,0,0,0,0,0,0,0,0,0,0,0
144456,2022,Australia,Bulgaria,2,2,20,24,24/06/2022,19,2,91,112,2,1,1,4,3,2,2,7,0,0,0,0,1,4,1,6
144456,2022,Australia,Canada,1,3,8,12,21/06/2022,18,2,78,98,5,0,1,6,1,4,1,6,0,0,0,0,1,3,0,4
144456,2022,Netherlands,Australia,0,0,8,8,12/6/2022,12,1,15,28,1,1,0,2,0,1,1,2,0,0,0,0,3,0,1,4
144456,2022,Iran,Australia,0,0,0,0,12/6/2022,0,0,0,0,0,0,0,0,0,0,0,0,0,0,0,0,0,0,0,0
144456,2022,Australia,Slovenia,0,1,9,10,11/6/2022,25,2,42,69,3,1,1,5,0,1,0,1,0,1,0,1,1,1,0,2
144456,2022,Brazil,Australia,0,3,4,7,9/6/2022,20,2,51,73,4,1,2,7,0,0,4,4,0,1,1,2,8,1,2,11
174192,2022,Australia,France,0,0,0,0,10/7/2022,0,0,0,0,0,0,0,0,0,0,0,0,0,0,0,0,0,0,0,0
174192,2022,Argentina,Australia,1,2,15,18,8/7/2022,0,0,0,0,11,4,5,20,0,4,1,5,12,4,15,31,6,3,3,12
174192,2022,Germany,Australia,0,5,11,16,7/7/2022,1,0,4,5,16,3,7,26,1,3,3,7,10,3,23,36,3,0,3,6
174192,2022,Japan,Australia,0,4,8,12,6/7/2022,0,0,2,2,21,5,6,32,1,2,2,5,13,4,19,36,5,2,0,7
174192,2022,Serbia,Australia,0,3,6,9,26/06/2022,0,0,0,0,11,4,4,19,2,0,2,4,10,1,16,27,0,2,0,2
174192,2022,Poland,Australia,0,0,0,0,25/06/2022,0,0,0,0,0,0,0,0,0,0,0,0,0,0,0,0,0,0,0,0
174192,2022,Australia,Bulgaria,1,2,14,17,24/06/2022,0,1,1,2,20,7,8,35,0,2,1,3,8,3,20,31,8,4,0,12
174192,2022,Australia,Canada,0,3,11,14,21/06/2022,0,0,1,1,13,5,17,35,2,1,2,5,6,2,12,20,4,4,1,9
174192,2022,Netherlands,Australia,1,4,6,11,12/6/2022,1,0,2,3,16,2,5,23,1,6,0,7,1,5,8,14,3,0,0,3
174192,2022,Iran,Australia,0,0,0,0,12/6/2022,0,0,0,0,0,0,0,0,0,0,0,0,0,0,0,0,0,0,0,0
174192,2022,Australia,Slovenia,0,3,9,12,11/6/2022,0,0,0,0,11,2,8,21,1,0,0,1,14,0,13,27,5,4,1,10
174192,2022,Brazil,Australia,0,4,5,9,9/6/2022,0,0,1,1,15,6,10,31,3,0,2,5,1,1,10,12,1,1,0,2
160879,2022,Australia,France,0,0,0,0,10/7/2022,0,0,7,7,0,0,0,0,0,0,0,0,2,1,13,16,4,5,0,9
160879,2022,Argentina,Australia,0,0,0,0,8/7/2022,0,0,1,1,0,0,0,0,0,0,0,0,13,1,17,31,7,2,1,10
160879,2022,Germany,Australia,0,0,0,0,7/7/2022,0,0,7,7,0,0,0,0,0,0,0,0,7,1,8,16,4,5,3,12
160879,2022,Japan,Australia,0,0,0,0,6/7/2022,0,0,3,3,0,0,0,0,0,0,0,0,8,4,9,21,6,3,1,10
160879,2022,Serbia,Australia,0,0,0,0,26/06/2022,0,0,0,0,0,0,0,0,0,0,0,0,0,0,0,0,0,0,0,0
160879,2022,Poland,Australia,0,0,0,0,25/06/2022,0,0,0,0,0,0,0,0,0,0,0,0,0,2,3,5,0,0,0,0
160879,2022,Australia,Bulgaria,0,0,0,0,24/06/2022,0,0,0,0,0,0,0,0,0,0,0,0,0,0,0,0,0,0,0,0
160879,2022,Australia,Canada,0,0,0,0,21/06/2022,0,0,0,0,0,0,0,0,0,0,0,0,0,0,0,0,0,0,0,0
160879,2022,Netherlands,Australia,0,0,0,0,12/6/2022,0,0,0,0,0,0,0,0,0,0,0,0,0,0,0,0,0,0,0,0
160879,2022,Iran,Australia,0,0,0,0,12/6/2022,0,0,0,0,0,0,0,0,0,0,0,0,0,0,0,0,0,0,0,0
160879,2022,Australia,Slovenia,0,0,0,0,11/6/2022,0,0,0,0,0,0,0,0,0,0,0,0,0,0,0,0,0,0,0,0
160879,2022,Brazil,Australia,0,0,0,0,9/6/2022,0,0,0,0,0,0,0,0,0,0,0,0,0,0,0,0,0,0,0,0
139052,2022,Australia,France,0,1,1,2,10/7/2022,0,0,3,3,0,1,2,3,0,0,0,0,0,1,3,4,1,0,1,2
139052,2022,Argentina,Australia,0,3,8,11,8/7/2022,1,0,0,1,13,4,13,30,3,3,2,8,4,3,11,18,4,2,4,10
139052,2022,Germany,Australia,0,2,6,8,7/7/2022,0,0,1,1,5,1,4,10,0,0,1,1,3,0,7,10,1,2,0,3
139052,2022,Japan,Australia,0,2,11,13,6/7/2022,0,0,2,2,8,2,5,15,1,2,1,4,3,1,11,15,4,0,1,5
125036,2022,,,-,-,-,-,-,-,-,-,-,-,-,-,-,-,-,-,-,-,-,-,-,-,-,-,-
162077,2022,Serbia,Australia,0,2,9,11,26/06/2022,0,0,0,0,8,0,4,12,1,5,4,10,0,0,0,0,0,1,0,1
162077,2022,Poland,Australia,0,1,1,2,25/06/2022,0,0,0,0,0,1,3,4,1,1,1,3,0,0,0,0,0,1,0,1
162077,2022,Australia,Bulgaria,1,2,16,19,24/06/2022,0,0,0,0,11,0,5,16,3,2,7,12,0,1,3,4,2,0,1,3
162077,2022,Australia,Canada,2,1,10,13,21/06/2022,0,0,2,2,10,1,6,17,2,3,4,9,0,0,1,1,0,1,0,1
162077,2022,Netherlands,Australia,0,3,6,9,12/6/2022,0,0,0,0,5,1,2,8,2,5,3,10,0,0,0,0,0,0,0,0
162077,2022,Iran,Australia,0,0,0,0,12/6/2022,0,0,0,0,0,0,0,0,0,0,0,0,0,0,0,0,0,0,0,0
162077,2022,Australia,Slovenia,1,2,6,9,11/6/2022,0,0,1,1,5,1,4,10,1,1,2,4,0,0,0,0,1,0,0,1
162077,2022,Brazil,Australia,0,2,4,6,9/6/2022,0,0,1,1,7,0,4,11,0,1,7,8,2,0,0,2,2,0,0,2
144464,2022,Australia,France,1,1,8,10,10/7/2022,0,0,3,3,3,0,2,5,1,3,1,5,0,0,2,2,0,1,2,3
144464,2022,Argentina,Australia,0,0,13,13,8/7/2022,0,0,4,4,4,1,4,9,1,3,3,7,1,0,0,1,1,0,2,3
144464,2022,Germany,Australia,1,2,12,15,7/7/2022,0,0,5,5,7,3,1,11,3,1,4,8,0,0,2,2,2,2,0,4
144464,2022,Japan,Australia,0,0,11,11,6/7/2022,2,0,1,3,6,0,6,12,0,6,2,8,0,0,1,1,0,3,0,3
144464,2022,Serbia,Australia,0,1,3,4,26/06/2022,0,0,1,1,2,0,1,3,0,3,1,4,0,0,1,1,0,0,0,0
144464,2022,Poland,Australia,0,0,9,9,25/06/2022,0,0,1,1,5,2,3,10,1,1,1,3,2,0,2,4,0,0,0,0
144464,2022,Australia,Bulgaria,0,0,0,0,24/06/2022,0,0,0,0,0,0,0,0,0,0,0,0,0,0,0,0,0,0,0,0
144464,2022,Australia,Canada,0,0,0,0,21/06/2022,0,0,0,0,0,0,0,0,0,0,0,0,0,0,0,0,0,0,0,0
144464,2022,Netherlands,Australia,0,0,0,0,12/6/2022,0,0,0,0,0,0,0,0,0,0,0,0,0,0,0,0,0,0,0,0
144464,2022,Iran,Australia,0,1,14,15,12/6/2022,0,1,0,1,4,1,9,14,2,2,4,8,0,0,0,0,4,0,0,4
144464,2022,Australia,Slovenia,0,0,1,1,11/6/2022,0,0,0,0,1,0,0,1,0,0,0,0,0,0,0,0,0,0,0,0
144464,2022,Brazil,Australia,0,0,4,4,9/6/2022,0,0,0,0,0,0,0,0,0,0,0,0,0,0,0,0,0,0,0,0
135532,2022,Serbia,Australia,1,3,4,8,26/06/2022,0,0,0,0,3,1,8,12,2,3,1,6,4,1,9,14,0,2,0,2
135532,2022,Poland,Australia,0,0,0,0,25/06/2022,0,0,0,0,0,0,0,0,0,0,0,0,0,0,0,0,0,0,0,0
135532,2022,Australia,Bulgaria,1,4,14,19,24/06/2022,0,0,2,2,10,9,14,33,1,3,0,4,5,2,17,24,0,2,1,3
135532,2022,Australia,Canada,0,5,12,17,21/06/2022,0,0,1,1,9,2,8,19,1,2,0,3,9,3,11,23,5,0,1,6
151041,2022,,,-,-,-,-,-,-,-,-,-,-,-,-,-,-,-,-,-,-,-,-,-,-,-,-,-
144578,2022,Serbia,Australia,0,0,0,0,26/06/2022,0,0,2,2,0,0,0,0,0,0,0,0,6,0,10,16,0,2,0,2
144578,2022,Poland,Australia,0,0,0,0,25/06/2022,0,0,4,4,0,0,0,0,0,0,0,0,6,0,2,8,6,3,3,12
144578,2022,Australia,Bulgaria,0,0,0,0,24/06/2022,1,0,3,4,0,0,0,0,0,0,0,0,6,1,16,23,5,4,1,10
144578,2022,Australia,Canada,0,0,0,0,21/06/2022,0,0,6,6,0,0,0,0,0,0,0,0,12,2,11,25,11,4,4,19
144578,2022,Netherlands,Australia,0,0,0,0,12/6/2022,5,0,1,6,0,0,0,0,0,0,0,0,2,0,12,14,6,3,1,10
144578,2022,Iran,Australia,0,0,0,0,12/6/2022,7,0,2,9,0,0,0,0,0,0,0,0,8,0,8,16,12,3,2,17
144578,2022,Australia,Slovenia,0,0,0,0,11/6/2022,5,0,0,5,0,0,0,0,0,0,0,0,2,0,7,9,13,1,2,16
144578,2022,Brazil,Australia,0,0,0,0,9/6/2022,6,0,3,9,0,0,0,0,0,0,0,0,8,1,10,19,11,3,3,17
144461,2022,,,-,-,-,-,-,-,-,-,-,-,-,-,-,-,-,-,-,-,-,-,-,-,-,-,-
168641,2022,Australia,France,0,2,7,9,10/7/2022,0,1,3,4,5,2,5,12,0,0,1,1,0,0,4,4,4,1,0,5
168641,2022,Argentina,Australia,0,1,0,1,8/7/2022,0,0,0,0,0,1,0,1,0,0,0,0,0,0,0,0,0,1,0,1
168641,2022,Germany,Australia,0,3,2,5,7/7/2022,0,0,0,0,3,1,3,7,0,1,0,1,0,0,0,0,0,1,0,1
168641,2022,Japan,Australia,1,1,13,15,6/7/2022,1,0,1,2,9,3,3,15,0,1,1,2,1,2,0,3,2,3,3,8
168641,2022,Serbia,Australia,0,1,13,14,26/06/2022,0,0,0,0,9,3,1,13,0,1,1,2,0,0,3,3,0,1,0,1
168641,2022,Poland,Australia,0,1,6,7,25/06/2022,0,0,0,0,8,3,13,24,0,0,0,0,0,0,3,3,2,1,0,3
168641,2022,Australia,Bulgaria,1,4,12,17,24/06/2022,0,0,1,1,7,5,11,23,0,2,0,2,0,0,4,4,3,1,2,6
168641,2022,Australia,Canada,4,2,14,20,21/06/2022,0,0,0,0,6,6,5,17,0,0,1,1,2,0,3,5,1,1,0,2
168641,2022,Netherlands,Australia,0,1,1,2,12/6/2022,1,0,0,1,1,0,2,3,0,0,2,2,0,0,0,0,4,0,0,4
168641,2022,Iran,Australia,0,3,8,11,12/6/2022,0,0,0,0,2,2,7,11,2,3,1,6,1,1,8,10,3,2,0,5
168641,2022,Australia,Slovenia,0,1,3,4,11/6/2022,0,0,0,0,5,2,1,8,0,2,0,2,0,0,0,0,1,1,1,3
168641,2022,Brazil,Australia,1,4,4,9,9/6/2022,1,0,0,1,3,5,5,13,2,1,4,7,0,0,1,1,5,1,0,6
162264,2022,Serbia,Australia,0,0,0,0,26/06/2022,0,0,0,0,0,0,0,0,0,0,0,0,0,0,0,0,0,0,0,0
162264,2022,Poland,Australia,0,0,0,0,25/06/2022,0,0,0,0,0,0,0,0,0,0,0,0,0,0,0,0,0,0,0,0
162264,2022,Australia,Bulgaria,0,0,0,0,24/06/2022,0,0,0,0,0,0,0,0,0,0,0,0,0,0,0,0,0,0,0,0
162264,2022,Australia,Canada,0,0,0,0,21/06/2022,0,0,0,0,0,0,0,0,0,0,0,0,0,0,0,0,0,0,0,0
162264,2022,Netherlands,Australia,0,4,3,7,12/6/2022,0,0,0,0,6,3,3,12,1,3,2,6,0,0,0,0,0,0,0,0
162264,2022,Iran,Australia,1,4,10,15,12/6/2022,0,0,1,1,15,8,9,32,1,3,2,6,0,0,0,0,3,3,1,7
162264,2022,Australia,Slovenia,0,2,2,4,11/6/2022,0,0,0,0,3,3,4,10,0,1,2,3,0,0,0,0,3,1,0,4
162264,2022,Brazil,Australia,0,0,0,0,9/6/2022,0,0,0,0,0,0,0,0,0,0,0,0,0,0,0,0,0,0,0,0
172376,2022,Australia,France,0,0,0,0,10/7/2022,0,0,0,0,0,0,0,0,0,0,0,0,0,0,0,0,0,0,0,0
172376,2022,Argentina,Australia,0,0,0,0,8/7/2022,0,0,0,0,0,0,0,0,0,0,0,0,0,0,0,0,0,0,0,0
172376,2022,Germany,Australia,0,0,0,0,7/7/2022,0,0,0,0,0,0,0,0,0,0,0,0,0,0,0,0,0,0,0,0
172376,2022,Japan,Australia,0,0,0,0,6/7/2022,0,0,0,0,0,0,0,0,0,0,0,0,0,0,0,0,0,0,0,0
172376,2022,Netherlands,Australia,0,0,0,0,12/6/2022,0,0,0,0,0,0,0,0,0,0,0,0,0,0,0,0,0,0,0,0
172376,2022,Iran,Australia,0,0,0,0,12/6/2022,0,0,0,0,0,0,0,0,0,0,0,0,0,0,0,0,0,0,0,0
172376,2022,Australia,Slovenia,0,0,0,0,11/6/2022,0,0,0,0,0,0,0,0,0,0,0,0,0,0,0,0,0,0,0,0
172376,2022,Brazil,Australia,0,0,0,0,9/6/2022,0,0,0,0,0,0,0,0,0,0,0,0,0,0,0,0,0,0,0,0
181281,2022,Australia,France,0,0,0,0,10/7/2022,,,,,0,0,0,0,0,0,0,0,0,0,0,0,0,0,0,0
181281,2022,Argentina,Australia,0,0,0,0,8/7/2022,,,,,0,0,0,0,0,0,0,0,0,0,0,0,0,0,0,0
181281,2022,Germany,Australia,0,0,0,0,7/7/2022,,,,,0,0,0,0,0,0,0,0,0,0,0,0,0,0,0,0
181281,2022,Japan,Australia,0,0,0,0,6/7/2022,,,,,0,0,0,0,0,0,0,0,0,0,0,0,0,0,0,0
132958,2022,,,-,-,-,-,-,-,-,-,-,-,-,-,-,-,-,-,-,-,-,-,-,-,-,-,-
186917,2022,,,-,-,-,-,-,-,-,-,-,-,-,-,-,-,-,-,-,-,-,-,-,-,-,-,-
158841,2022,Australia,France,0,2,4,6,10/7/2022,4,0,9,13,1,0,0,1,0,1,0,1,0,0,1,1,2,0,0,2
158841,2022,Argentina,Australia,2,4,9,15,8/7/2022,32,1,51,84,0,0,1,1,0,2,2,4,0,0,0,0,0,3,1,4
158841,2022,Germany,Australia,0,0,0,0,7/7/2022,0,0,0,0,0,0,0,0,0,0,0,0,0,0,0,0,0,0,0,0
158841,2022,Japan,Australia,0,0,0,0,6/7/2022,1,0,1,2,0,0,0,0,0,0,0,0,0,0,0,0,0,0,1,1
158841,2022,Serbia,Australia,0,0,0,0,26/06/2022,0,0,0,0,0,0,0,0,0,0,0,0,0,0,0,0,0,0,0,0
158841,2022,Poland,Australia,1,2,4,7,25/06/2022,20,0,55,75,0,0,2,2,0,1,0,1,0,0,0,0,1,2,0,3
158841,2022,Australia,Bulgaria,0,0,0,0,24/06/2022,0,0,0,0,0,0,0,0,0,0,0,0,0,0,0,0,0,0,0,0
158841,2022,Australia,Canada,0,0,0,0,21/06/2022,0,0,0,0,0,0,0,0,0,0,0,0,0,0,0,0,0,0,0,0
158841,2022,Netherlands,Australia,0,2,3,5,12/6/2022,8,1,13,22,0,0,0,0,0,1,1,2,0,1,0,1,1,1,0,2
158841,2022,Iran,Australia,0,2,12,14,12/6/2022,44,0,46,90,1,0,1,2,0,2,4,6,0,0,0,0,3,1,1,5
158841,2022,Australia,Slovenia,0,1,0,1,11/6/2022,0,0,1,1,0,0,0,0,0,0,0,0,0,0,0,0,0,0,0,0
158841,2022,Brazil,Australia,0,0,0,0,9/6/2022,0,0,0,0,0,0,0,0,0,0,0,0,0,0,0,0,0,0,0,0
178207,2022,Australia,France,0,3,5,8,10/7/2022,0,0,4,4,4,7,3,14,0,1,0,1,0,1,9,10,3,3,1,7
178207,2022,Argentina,Australia,0,0,0,0,8/7/2022,0,0,0,0,0,0,0,0,0,0,0,0,0,0,0,0,0,0,0,0
178207,2022,Germany,Australia,0,0,0,0,7/7/2022,0,0,0,0,0,0,0,0,0,0,0,0,0,0,0,0,0,0,0,0
178207,2022,Japan,Australia,0,0,0,0,6/7/2022,0,0,0,0,0,0,0,0,0,0,0,0,0,0,0,0,0,0,0,0
178207,2022,Serbia,Australia,0,0,0,0,26/06/2022,0,0,0,0,0,0,0,0,0,0,0,0,0,0,0,0,0,0,0,0
178207,2022,Poland,Australia,0,0,1,1,25/06/2022,0,0,0,0,0,2,0,2,0,0,0,0,0,0,0,0,0,0,0,0
178207,2022,Australia,Bulgaria,0,0,1,1,24/06/2022,0,0,0,0,0,0,0,0,0,0,0,0,0,0,0,0,0,0,0,0
178207,2022,Australia,Canada,0,1,0,1,21/06/2022,0,0,0,0,0,0,0,0,0,0,0,0,0,0,0,0,0,0,0,0
178207,2022,Netherlands,Australia,0,0,0,0,12/6/2022,0,0,0,0,0,0,0,0,0,0,0,0,0,0,0,0,0,0,0,0
178207,2022,Iran,Australia,0,0,1,1,12/6/2022,0,0,0,0,0,0,0,0,0,0,0,0,0,0,0,0,0,0,0,0
178207,2022,Australia,Slovenia,0,1,0,1,11/6/2022,0,0,0,0,0,0,0,0,0,0,0,0,0,0,0,0,0,0,0,0
178207,2022,Brazil,Australia,0,1,2,3,9/6/2022,0,0,0,0,0,0,0,0,0,0,0,0,0,0,0,0,0,0,0,0
172333,2022,,,-,-,-,-,-,-,-,-,-,-,-,-,-,-,-,-,-,-,-,-,-,-,-,-,-
162870,2022,Australia,France,0,0,2,2,10/7/2022,0,0,0,0,2,1,1,4,0,2,1,3,1,3,4,8,1,0,2,3
162870,2022,Argentina,Australia,0,0,1,1,8/7/2022,0,0,0,0,0,1,0,1,0,0,0,0,0,0,0,0,0,0,0,0
162870,2022,Germany,Australia,0,1,4,5,7/7/2022,0,0,0,0,3,2,1,6,0,0,1,1,2,1,4,7,1,1,0,2
162870,2022,Japan,Australia,0,0,1,1,6/7/2022,0,0,0,0,1,0,0,1,0,0,1,1,2,1,0,3,0,1,0,1
162870,2022,Serbia,Australia,0,0,1,1,26/06/2022,0,0,0,0,1,0,0,1,0,0,1,1,0,0,2,2,0,0,0,0
162870,2022,Poland,Australia,0,0,10,10,25/06/2022,0,1,0,1,6,4,9,19,0,0,0,0,4,1,14,19,0,1,0,1
162870,2022,Australia,Bulgaria,0,0,0,0,24/06/2022,0,0,0,0,0,0,0,0,0,0,0,0,0,0,0,0,0,0,0,0
162870,2022,Australia,Canada,0,0,1,1,21/06/2022,0,0,0,0,2,2,0,4,0,0,0,0,0,0,2,2,1,0,0,1
162870,2022,Netherlands,Australia,0,0,6,6,12/6/2022,0,0,0,0,4,0,4,8,0,1,0,1,5,1,10,16,2,1,0,3
162870,2022,Iran,Australia,0,2,3,5,12/6/2022,0,0,0,0,7,10,5,22,1,1,0,2,15,2,14,31,6,3,0,9
162870,2022,Australia,Slovenia,0,0,4,4,11/6/2022,0,0,1,1,1,1,1,3,0,1,0,1,1,1,4,6,0,0,1,1
162870,2022,Brazil,Australia,0,1,8,9,9/6/2022,1,0,1,2,3,6,6,15,0,3,0,3,3,1,20,24,8,1,1,10
169335,2022,Australia,France,0,0,3,3,10/7/2022,0,0,3,3,2,1,2,5,0,2,2,4,0,0,9,9,1,1,0,2
169335,2022,Argentina,Australia,0,0,0,0,8/7/2022,0,0,0,0,0,0,0,0,0,0,0,0,0,0,0,0,0,0,0,0
169335,2022,Germany,Australia,0,0,0,0,7/7/2022,0,0,0,0,0,0,0,0,0,0,0,0,0,0,0,0,0,0,0,0
169335,2022,Japan,Australia,0,0,0,0,6/7/2022,0,0,0,0,0,0,0,0,0,0,0,0,0,0,0,0,0,0,0,0
169335,2022,Serbia,Australia,0,0,0,0,26/06/2022,0,0,0,0,0,0,0,0,0,0,0,0,0,0,0,0,0,0,0,0
169335,2022,Poland,Australia,0,3,7,10,25/06/2022,0,0,0,0,7,3,5,15,0,1,2,3,5,1,20,26,0,0,1,1
169335,2022,Australia,Bulgaria,0,0,0,0,24/06/2022,0,0,0,0,0,0,0,0,0,0,0,0,0,0,0,0,0,0,0,0
169335,2022,Australia,Canada,0,0,0,0,21/06/2022,0,0,0,0,0,0,0,0,0,0,0,0,0,0,0,0,0,0,0,0
169335,2022,Netherlands,Australia,0,0,2,2,12/6/2022,0,0,0,0,1,1,1,3,0,0,0,0,2,1,8,11,2,0,1,3
169335,2022,Iran,Australia,0,1,3,4,12/6/2022,0,0,0,0,4,1,3,8,0,0,1,1,3,2,10,15,0,0,0,0
169335,2022,Australia,Slovenia,1,1,7,9,11/6/2022,0,0,0,0,3,3,3,9,1,1,1,3,4,1,9,14,0,1,0,1
169335,2022,Brazil,Australia,0,1,1,2,9/6/2022,0,0,0,0,0,1,5,6,0,1,0,1,0,0,2,2,0,1,0,1
162265,2022,Australia,France,0,0,3,3,10/7/2022,0,0,1,1,2,3,3,8,0,2,1,3,0,0,0,0,1,2,0,3
162265,2022,Argentina,Australia,0,4,7,11,8/7/2022,0,0,0,0,11,6,3,20,1,1,4,6,0,0,0,0,2,0,1,3
162265,2022,Germany,Australia,1,4,3,8,7/7/2022,0,0,2,2,8,3,9,20,0,2,5,7,0,0,0,0,2,2,1,5
162265,2022,Japan,Australia,0,0,1,1,6/7/2022,1,0,0,1,0,0,0,0,0,0,0,0,0,0,0,0,0,0,0,0
189191,2022,,,-,-,-,-,-,-,-,-,-,-,-,-,-,-,-,-,-,-,-,-,-,-,-,-,-
116099,2022,USA,Brazil,0,3,8,11,20/07/2022,29,0,63,92,0,0,0,0,0,3,1,4,0,0,0,0,3,1,1,5
116099,2022,Brazil,Japan,1,2,12,15,10/7/2022,30,0,35,65,0,0,1,1,1,2,2,5,0,0,0,0,2,0,2,4
116099,2022,France,Brazil,0,0,4,4,8/7/2022,2,0,9,11,0,0,1,1,0,0,0,0,0,0,1,1,1,0,0,1
116099,2022,Canada,Brazil,0,1,9,10,7/7/2022,11,0,50,61,1,0,0,1,0,1,2,3,0,0,0,0,6,2,1,9
116099,2022,Brazil,Germany,0,2,16,18,6/7/2022,37,1,44,82,1,0,0,1,1,1,2,4,0,0,0,0,8,0,4,12
116099,2022,Bulgaria,Brazil,1,0,11,12,26/06/2022,20,0,40,60,1,0,0,1,1,4,1,6,0,0,0,0,0,1,0,1
116099,2022,Iran,Brazil,3,1,13,17,24/06/2022,23,0,38,61,1,0,0,1,0,3,1,4,0,0,1,1,0,3,0,3
116099,2022,Serbia,Brazil,2,1,10,13,23/06/2022,21,1,47,69,0,0,0,0,0,0,0,0,0,0,0,0,2,2,0,4
116099,2022,Brazil,Poland,0,0,8,8,22/06/2022,21,0,52,73,0,0,1,1,0,2,1,3,0,0,1,1,4,1,3,8
116099,2022,Brazil,China,1,2,8,11,12/6/2022,33,1,38,72,0,0,0,0,0,2,2,4,0,0,0,0,3,2,0,5
116099,2022,USA,Brazil,0,2,9,11,11/6/2022,28,1,38,67,1,0,0,1,0,2,4,6,0,0,1,1,4,4,1,9
116099,2022,Brazil,Slovenia,0,1,13,14,10/6/2022,43,0,28,71,0,0,0,0,0,5,3,8,0,0,1,1,4,1,2,7
116099,2022,Brazil,Australia,0,0,11,11,9/6/2022,30,1,31,62,0,0,1,1,0,0,5,5,0,0,0,0,10,1,1,12
174334,2022,Brazil,Japan,0,0,0,0,10/7/2022,0,0,0,0,0,0,0,0,0,0,0,0,0,0,0,0,0,0,0,0
174334,2022,France,Brazil,0,0,0,0,8/7/2022,0,0,0,0,0,0,0,0,0,0,0,0,0,0,0,0,0,0,0,0
174334,2022,Canada,Brazil,0,0,0,0,7/7/2022,0,0,0,0,0,0,0,0,0,0,0,0,0,0,0,0,0,0,0,0
174334,2022,Brazil,Germany,0,0,0,0,6/7/2022,0,0,0,0,0,0,0,0,0,0,0,0,0,0,0,0,0,0,0,0
136955,2022,,,-,-,-,-,-,-,-,-,-,-,-,-,-,-,-,-,-,-,-,-,-,-,-,-,-
124456,2022,Brazil,China,0,0,0,0,12/6/2022,1,0,1,2,0,0,2,2,0,1,0,1,0,0,0,0,0,0,0,0
124456,2022,USA,Brazil,0,0,0,0,11/6/2022,0,0,0,0,3,1,1,5,0,0,2,2,0,0,0,0,0,0,0,0
124456,2022,Brazil,Slovenia,0,0,0,0,10/6/2022,0,0,0,0,0,0,0,0,0,1,0,1,0,0,0,0,0,0,0,0
124456,2022,Brazil,Australia,0,0,0,0,9/6/2022,0,0,0,0,0,0,0,0,0,0,0,0,0,0,0,0,0,0,0,0
161942,2022,,,-,-,-,-,-,-,-,-,-,-,-,-,-,-,-,-,-,-,-,-,-,-,-,-,-
174908,2022,USA,Brazil,0,0,5,5,20/07/2022,0,0,0,0,1,1,3,5,0,1,0,1,0,0,0,0,2,0,0,2
174908,2022,Brazil,Japan,0,0,1,1,10/7/2022,0,0,0,0,3,0,2,5,0,1,0,1,3,0,4,7,0,0,0,0
174908,2022,France,Brazil,1,1,8,10,8/7/2022,0,0,4,4,6,0,4,10,0,3,1,4,3,6,4,13,4,2,1,7
174908,2022,Canada,Brazil,0,0,0,0,7/7/2022,0,0,0,0,0,0,0,0,0,0,0,0,0,0,2,2,0,0,0,0
174908,2022,Brazil,Germany,0,0,0,0,6/7/2022,0,0,1,1,0,0,0,0,0,0,1,1,0,0,0,0,0,0,0,0
174908,2022,Bulgaria,Brazil,0,0,0,0,26/06/2022,0,0,0,0,0,0,0,0,0,0,0,0,0,1,1,2,0,0,0,0
174908,2022,Iran,Brazil,0,0,0,0,24/06/2022,0,0,0,0,0,1,0,1,0,0,0,0,1,0,0,1,1,0,0,1
174908,2022,Serbia,Brazil,0,0,0,0,23/06/2022,0,0,0,0,1,0,0,1,0,0,0,0,2,0,3,5,0,0,0,0
174908,2022,Brazil,Poland,0,0,0,0,22/06/2022,0,0,0,0,0,1,0,1,0,0,0,0,0,0,1,1,0,0,0,0
174908,2022,Brazil,China,0,2,7,9,12/6/2022,3,0,1,4,8,2,3,13,0,1,2,3,13,1,17,31,3,1,0,4
174908,2022,USA,Brazil,0,3,9,12,11/6/2022,1,0,0,1,2,2,6,10,0,1,0,1,6,2,10,18,2,1,1,4
174908,2022,Brazil,Slovenia,3,3,13,19,10/6/2022,0,0,0,0,8,0,6,14,2,1,0,3,4,2,16,22,3,1,2,6
174908,2022,Brazil,Australia,1,2,11,14,9/6/2022,3,0,1,4,5,2,4,11,0,4,0,4,5,0,6,11,6,3,4,13
135380,2022,,,-,-,-,-,-,-,-,-,-,-,-,-,-,-,-,-,-,-,-,-,-,-,-,-,-
112869,2022,,,-,-,-,-,-,-,-,-,-,-,-,-,-,-,-,-,-,-,-,-,-,-,-,-,-
118928,2022,USA,Brazil,0,4,7,11,20/07/2022,0,0,1,1,18,7,12,37,0,1,0,1,10,1,19,30,6,2,1,9
118928,2022,Brazil,Japan,0,3,5,8,10/7/2022,0,0,1,1,7,2,4,13,0,4,0,4,3,1,8,12,2,2,0,4
118928,2022,France,Brazil,0,1,10,11,8/7/2022,0,0,5,5,5,3,11,19,0,4,2,6,3,3,12,18,1,1,2,4
118928,2022,Canada,Brazil,1,3,11,15,7/7/2022,0,0,1,1,13,0,6,19,1,2,1,4,2,5,6,13,0,0,1,1
118928,2022,Brazil,Germany,1,3,12,16,6/7/2022,0,0,6,6,19,2,8,29,1,6,4,11,2,0,17,19,3,4,0,7
118928,2022,Bulgaria,Brazil,1,2,7,10,26/06/2022,0,0,1,1,11,2,4,17,0,3,0,3,3,2,16,21,1,2,0,3
118928,2022,Iran,Brazil,1,1,13,15,24/06/2022,0,0,0,0,11,3,5,19,1,3,0,4,1,2,10,13,4,1,0,5
118928,2022,Serbia,Brazil,1,2,9,12,23/06/2022,0,0,1,1,8,0,7,15,2,4,1,7,1,1,13,15,0,2,1,3
118928,2022,Brazil,Poland,1,2,15,18,22/06/2022,0,0,2,2,8,5,9,22,1,3,1,5,3,5,23,31,4,2,2,8
164313,2022,,,-,-,-,-,-,-,-,-,-,-,-,-,-,-,-,-,-,-,-,-,-,-,-,-,-
142721,2022,USA,Brazil,0,0,0,0,20/07/2022,0,0,0,0,0,0,0,0,0,0,0,0,1,0,1,2,0,0,0,0
142721,2022,Brazil,Japan,0,0,0,0,10/7/2022,0,0,1,1,0,0,0,0,0,0,0,0,0,0,1,1,1,0,0,1
142721,2022,France,Brazil,0,1,2,3,8/7/2022,0,0,1,1,3,1,1,5,0,0,1,1,1,0,2,3,4,1,1,6
142721,2022,Canada,Brazil,0,0,0,0,7/7/2022,0,0,0,0,0,0,0,0,0,0,0,0,0,0,0,0,0,0,0,0
142721,2022,Brazil,Germany,1,0,0,1,6/7/2022,0,0,0,0,0,0,0,0,0,0,0,0,0,0,0,0,0,0,0,0
142721,2022,Bulgaria,Brazil,0,0,0,0,26/06/2022,0,0,0,0,0,0,0,0,0,0,0,0,0,0,0,0,0,0,0,0
142721,2022,Iran,Brazil,0,0,0,0,24/06/2022,0,0,0,0,0,0,0,0,0,0,0,0,0,0,2,2,0,0,0,0
142721,2022,Serbia,Brazil,0,0,0,0,23/06/2022,0,0,0,0,0,0,0,0,0,0,0,0,0,0,0,0,0,0,0,0
142721,2022,Brazil,Poland,0,1,5,6,22/06/2022,0,0,1,1,6,2,7,15,0,0,0,0,1,2,2,5,1,0,0,1
142721,2022,Brazil,China,0,4,7,11,12/6/2022,0,0,0,0,4,4,4,12,0,4,2,6,8,1,8,17,1,2,3,6
142721,2022,USA,Brazil,2,3,9,14,11/6/2022,2,0,1,3,10,2,7,19,1,2,4,7,17,1,13,31,4,1,3,8
142721,2022,Brazil,Slovenia,4,3,11,18,10/6/2022,0,0,1,1,9,2,6,17,2,3,0,5,3,1,13,17,5,1,0,6
142721,2022,Brazil,Australia,1,1,7,9,9/6/2022,2,0,1,3,3,1,10,14,3,1,2,6,4,1,9,14,5,0,1,6
119872,2022,USA,Brazil,0,2,5,7,20/07/2022,0,0,0,0,1,0,6,7,0,1,1,2,0,0,0,0,3,1,0,4
119872,2022,Brazil,Japan,2,3,12,17,10/7/2022,0,0,0,0,4,1,5,10,2,7,7,16,0,0,1,1,2,0,0,2
119872,2022,France,Brazil,2,0,10,12,8/7/2022,0,0,0,0,1,0,2,3,1,4,5,10,0,0,0,0,2,1,1,4
119872,2022,Canada,Brazil,3,0,17,20,7/7/2022,0,0,1,1,7,0,2,9,0,3,6,9,1,0,0,1,4,1,1,6
119872,2022,Brazil,Germany,1,1,16,18,6/7/2022,0,0,1,1,10,0,3,13,1,10,5,16,1,0,0,1,2,0,0,2
119872,2022,Bulgaria,Brazil,1,4,9,14,26/06/2022,0,0,0,0,8,1,1,10,2,1,2,5,0,0,2,2,0,1,2,3
119872,2022,Iran,Brazil,1,3,8,12,24/06/2022,0,0,1,1,9,0,2,11,4,3,5,12,0,0,0,0,0,0,0,0
119872,2022,Serbia,Brazil,0,0,0,0,23/06/2022,0,0,0,0,0,0,0,0,0,0,0,0,0,0,0,0,0,0,0,0
119872,2022,Brazil,Poland,0,2,1,3,22/06/2022,0,0,0,0,3,1,2,6,0,1,1,2,0,0,0,0,0,0,0,0
119872,2022,Brazil,China,0,0,0,0,12/6/2022,0,0,0,0,0,0,0,0,0,0,0,0,0,0,0,0,0,0,0,0
119872,2022,USA,Brazil,0,2,3,5,11/6/2022,0,0,0,0,4,1,1,6,0,1,1,2,0,0,0,0,0,0,0,0
119872,2022,Brazil,Slovenia,0,0,0,0,10/6/2022,0,0,0,0,0,0,0,0,0,0,0,0,0,0,0,0,0,0,0,0
119872,2022,Brazil,Australia,0,0,0,0,9/6/2022,0,0,0,0,0,0,0,0,0,0,0,0,0,0,0,0,0,0,0,0
151789,2022,Brazil,China,0,0,0,0,12/6/2022,0,0,0,0,0,0,0,0,0,0,0,0,0,0,0,0,0,0,0,0
151789,2022,USA,Brazil,0,1,4,5,11/6/2022,0,0,0,0,7,2,5,14,0,0,1,1,1,0,9,10,0,1,0,1
151789,2022,Brazil,Slovenia,0,0,0,0,10/6/2022,0,0,1,1,0,0,0,0,0,0,0,0,0,0,0,0,0,0,0,0
151789,2022,Brazil,Australia,0,1,0,1,9/6/2022,0,0,0,0,0,1,0,1,0,0,0,0,0,0,0,0,0,0,0,0
142744,2022,USA,Brazil,0,0,4,4,20/07/2022,3,0,18,21,0,0,0,0,0,2,1,3,0,0,0,0,0,0,0,0
142744,2022,Brazil,Japan,0,0,1,1,10/7/2022,0,0,0,0,0,0,0,0,0,0,0,0,0,0,0,0,0,1,0,1
142744,2022,France,Brazil,0,1,5,6,8/7/2022,10,0,33,43,1,1,0,2,0,0,0,0,0,0,0,0,4,0,0,4
142744,2022,Canada,Brazil,0,0,0,0,7/7/2022,0,0,1,1,0,0,0,0,0,0,0,0,0,0,0,0,0,0,0,0
142744,2022,Brazil,Germany,1,0,2,3,6/7/2022,2,0,3,5,0,0,0,0,0,0,0,0,0,0,0,0,1,1,0,2
142744,2022,Bulgaria,Brazil,0,0,2,2,26/06/2022,2,0,1,3,0,0,0,0,0,0,0,0,0,0,0,0,0,0,0,0
142744,2022,Iran,Brazil,0,1,1,2,24/06/2022,5,0,9,14,0,0,0,0,0,0,0,0,0,0,0,0,0,0,0,0
142744,2022,Serbia,Brazil,0,0,0,0,23/06/2022,0,0,0,0,0,0,0,0,0,0,0,0,0,0,0,0,0,0,0,0
142744,2022,Brazil,Poland,0,0,4,4,22/06/2022,8,0,17,25,0,0,0,0,0,1,2,3,0,0,0,0,1,0,0,1
142744,2022,Brazil,China,0,0,1,1,12/6/2022,1,1,1,3,0,0,0,0,0,0,0,0,0,0,0,0,1,1,0,2
142744,2022,USA,Brazil,0,1,4,5,11/6/2022,11,0,15,26,0,0,0,0,0,0,2,2,0,0,0,0,1,1,0,2
142744,2022,Brazil,Slovenia,0,0,0,0,10/6/2022,1,0,5,6,0,0,0,0,0,0,0,0,0,0,0,0,0,0,0,0
142744,2022,Brazil,Australia,0,0,2,2,9/6/2022,1,0,0,1,0,0,0,0,0,0,0,0,0,0,0,0,0,0,0,0
161939,2022,USA,Brazil,0,0,0,0,20/07/2022,0,0,2,2,0,0,0,0,0,0,0,0,0,0,0,0,1,3,0,4
161939,2022,Brazil,Japan,0,0,0,0,10/7/2022,0,0,0,0,0,0,0,0,0,0,0,0,0,0,0,0,3,1,0,4
161939,2022,France,Brazil,0,0,0,0,8/7/2022,0,0,0,0,0,0,0,0,0,0,0,0,0,0,0,0,1,0,0,1
161939,2022,Canada,Brazil,0,0,0,0,7/7/2022,0,0,0,0,0,0,0,0,0,0,0,0,0,0,0,0,0,0,0,0
161939,2022,Brazil,Germany,0,0,0,0,6/7/2022,0,0,0,0,0,0,0,0,0,0,0,0,0,0,0,0,0,0,0,0
161939,2022,Bulgaria,Brazil,0,0,0,0,26/06/2022,0,0,0,0,0,0,0,0,0,0,0,0,0,0,1,1,0,0,1,1
161939,2022,Iran,Brazil,0,0,0,0,24/06/2022,0,0,0,0,0,0,0,0,0,0,0,0,0,0,0,0,0,0,0,0
161939,2022,Serbia,Brazil,0,0,0,0,23/06/2022,0,0,0,0,0,0,0,0,0,0,0,0,0,0,0,0,0,0,0,0
161939,2022,Brazil,Poland,0,0,0,0,22/06/2022,1,1,1,3,0,0,0,0,0,0,0,0,1,3,11,15,4,5,1,10
161939,2022,Brazil,China,0,0,0,0,12/6/2022,1,0,0,1,0,0,0,0,0,0,0,0,0,0,0,0,3,3,0,6
161939,2022,USA,Brazil,0,0,0,0,11/6/2022,2,0,1,3,0,0,0,0,0,0,0,0,1,0,5,6,7,1,2,10
161939,2022,Brazil,Slovenia,0,0,0,0,10/6/2022,1,0,0,1,0,0,0,0,0,0,0,0,0,0,1,1,7,2,1,10
161939,2022,Brazil,Australia,0,0,0,0,9/6/2022,2,0,0,2,0,0,0,0,0,0,0,0,0,0,0,0,1,1,0,2
116081,2022,USA,Brazil,0,2,6,8,20/07/2022,0,0,0,0,8,0,2,10,0,4,2,6,0,0,1,1,0,2,0,2
116081,2022,Iran,Brazil,0,0,0,0,24/06/2022,0,0,0,0,0,0,0,0,0,0,0,0,0,0,0,0,0,0,0,0
116081,2022,Serbia,Brazil,0,4,3,7,23/06/2022,0,0,0,0,2,0,6,8,1,5,3,9,0,0,0,0,0,1,0,1
116081,2022,Brazil,Poland,0,3,9,12,22/06/2022,0,0,0,0,3,0,1,4,2,3,3,8,0,0,0,0,1,0,1,2
116081,2022,Brazil,China,3,2,18,23,12/6/2022,0,0,1,1,8,2,0,10,1,3,1,5,0,0,0,0,1,1,1,3
116081,2022,USA,Brazil,0,5,9,14,11/6/2022,0,0,0,0,5,2,2,9,4,4,4,12,0,0,0,0,1,0,0,1
116081,2022,Brazil,Slovenia,1,4,14,19,10/6/2022,0,0,0,0,9,2,5,16,2,2,3,7,0,0,0,0,2,0,4,6
116081,2022,Brazil,Australia,1,3,15,19,9/6/2022,0,0,0,0,3,1,5,9,1,5,2,8,0,0,0,0,4,1,0,5
118916,2022,USA,Brazil,0,0,0,0,20/07/2022,1,0,1,2,0,0,0,0,0,0,0,0,16,0,7,23,6,2,1,9
118916,2022,Brazil,Japan,0,0,0,0,10/7/2022,1,0,0,1,0,0,0,0,0,0,0,0,4,0,6,10,2,2,2,6
118916,2022,France,Brazil,0,0,0,0,8/7/2022,0,0,7,7,0,0,0,0,0,0,0,0,3,1,10,14,5,2,0,7
118916,2022,Canada,Brazil,0,0,0,0,7/7/2022,0,0,1,1,0,0,0,0,0,0,0,0,3,0,10,13,11,2,1,14
118916,2022,Brazil,Germany,0,0,0,0,6/7/2022,0,0,5,5,0,0,0,0,0,0,0,0,5,2,8,15,13,3,1,17
118916,2022,Bulgaria,Brazil,0,0,0,0,26/06/2022,0,0,1,1,0,0,0,0,0,0,0,0,4,0,6,10,5,4,0,9
118916,2022,Iran,Brazil,0,0,0,0,24/06/2022,1,0,3,4,0,0,0,0,0,0,0,0,4,2,9,15,3,0,0,3
118916,2022,Serbia,Brazil,0,0,0,0,23/06/2022,1,0,3,4,0,0,0,0,0,0,0,0,5,0,4,9,5,2,1,8
118916,2022,Brazil,Poland,0,0,0,0,22/06/2022,0,0,4,4,0,0,0,0,0,0,0,0,3,1,2,6,1,1,1,3
118916,2022,Brazil,China,0,0,0,0,12/6/2022,1,0,0,1,0,0,0,0,0,0,0,0,5,1,11,17,3,1,0,4
118916,2022,USA,Brazil,0,0,0,0,11/6/2022,2,0,0,2,0,0,0,0,0,0,0,0,4,2,9,15,4,0,0,4
118916,2022,Brazil,Slovenia,0,0,0,0,10/6/2022,0,0,0,0,0,0,0,0,0,0,0,0,8,3,8,19,5,1,0,6
118916,2022,Brazil,Australia,0,0,0,0,9/6/2022,2,0,0,2,0,0,0,0,0,0,0,0,7,0,4,11,5,0,0,5
136468,2022,USA,Brazil,1,1,16,18,20/07/2022,0,0,0,0,15,4,8,27,0,3,1,4,12,3,9,24,8,4,2,14
136468,2022,Brazil,Japan,1,4,9,14,10/7/2022,0,0,6,6,7,4,3,14,1,1,2,4,9,2,13,24,10,1,3,14
136468,2022,France,Brazil,0,0,0,0,8/7/2022,0,0,0,0,0,0,0,0,0,0,0,0,0,0,0,0,0,0,0,0
136468,2022,Canada,Brazil,0,1,8,9,7/7/2022,0,0,6,6,4,1,10,15,0,1,2,3,3,0,12,15,4,2,2,8
136468,2022,Brazil,Germany,2,3,14,19,6/7/2022,0,0,4,4,13,5,6,24,0,3,5,8,11,1,17,29,4,4,0,8
136468,2022,Bulgaria,Brazil,1,3,10,14,26/06/2022,0,0,1,1,8,3,1,12,2,0,2,4,1,0,11,12,3,4,1,8
136468,2022,Iran,Brazil,0,3,6,9,24/06/2022,0,0,2,2,15,2,5,22,0,2,2,4,11,0,15,26,1,1,1,3
136468,2022,Serbia,Brazil,2,1,10,13,23/06/2022,1,0,0,1,10,2,7,19,2,2,0,4,4,2,10,16,2,3,1,6
136468,2022,Brazil,Poland,0,2,7,9,22/06/2022,0,0,2,2,3,2,8,13,1,0,0,1,3,1,16,20,1,1,0,2
136954,2022,USA,Brazil,0,0,0,0,20/07/2022,0,0,0,0,0,0,0,0,0,0,0,0,0,0,0,0,0,0,0,0
136954,2022,Brazil,Japan,0,0,0,0,10/7/2022,0,0,0,0,0,0,0,0,0,0,0,0,0,0,0,0,0,0,0,0
136954,2022,France,Brazil,0,0,4,4,8/7/2022,0,0,0,0,1,0,0,1,0,1,0,1,0,0,0,0,0,0,0,0
136954,2022,Canada,Brazil,0,0,0,0,7/7/2022,0,0,0,0,0,0,0,0,0,0,0,0,0,0,0,0,0,0,0,0
136954,2022,Brazil,Germany,0,0,0,0,6/7/2022,0,0,0,0,0,0,0,0,0,0,0,0,0,0,0,0,0,0,0,0
136954,2022,Bulgaria,Brazil,0,0,0,0,26/06/2022,0,0,0,0,0,0,0,0,0,0,0,0,0,0,0,0,0,0,0,0
136954,2022,Iran,Brazil,0,0,0,0,24/06/2022,0,0,0,0,0,0,0,0,0,0,0,0,0,0,0,0,0,0,0,0
136954,2022,Serbia,Brazil,0,0,2,2,23/06/2022,0,0,0,0,0,0,0,0,1,1,0,2,0,0,0,0,0,0,0,0
136954,2022,Brazil,Poland,0,0,0,0,22/06/2022,0,0,0,0,0,0,0,0,0,0,0,0,0,0,0,0,0,0,0,0
136954,2022,Brazil,China,0,0,0,0,12/6/2022,0,0,0,0,0,0,0,0,0,0,0,0,0,0,0,0,0,0,0,0
136954,2022,USA,Brazil,0,0,0,0,11/6/2022,0,0,0,0,0,0,0,0,0,0,0,0,0,0,0,0,0,0,0,0
136954,2022,Brazil,Slovenia,0,0,0,0,10/6/2022,0,0,0,0,0,0,0,0,0,0,0,0,0,0,0,0,0,0,0,0
136954,2022,Brazil,Australia,0,0,0,0,9/6/2022,0,0,0,0,0,0,0,0,0,0,0,0,0,0,0,0,0,0,0,0
161930,2022,USA,Brazil,0,0,0,0,20/07/2022,0,0,0,0,0,0,0,0,0,0,0,0,0,0,0,0,0,0,0,0
161930,2022,Brazil,Japan,0,0,0,0,10/7/2022,0,0,0,0,0,0,0,0,0,0,0,0,0,0,0,0,0,0,0,0
161930,2022,France,Brazil,0,0,2,2,8/7/2022,0,0,1,1,0,0,0,0,0,0,0,0,0,0,0,0,0,0,0,0
161930,2022,Canada,Brazil,0,0,3,3,7/7/2022,0,0,0,0,0,0,0,0,0,0,0,0,0,0,0,0,0,0,0,0
161930,2022,Brazil,Germany,0,0,0,0,6/7/2022,0,0,1,1,0,0,0,0,0,0,0,0,0,0,2,2,0,0,0,0
136947,2022,Iran,Brazil,0,2,1,3,24/06/2022,0,0,1,1,3,1,2,6,0,2,0,2,0,0,0,0,1,1,0,2
136947,2022,Serbia,Brazil,3,3,11,17,23/06/2022,0,0,0,0,10,3,9,22,0,0,1,1,0,0,0,0,2,1,0,3
136947,2022,Brazil,Poland,0,6,5,11,22/06/2022,0,0,1,1,19,4,11,34,0,3,2,5,0,1,0,1,1,2,2,5
136947,2022,Brazil,China,0,3,9,12,12/6/2022,0,0,1,1,16,5,8,29,3,1,4,8,0,0,0,0,4,2,0,6
136947,2022,USA,Brazil,1,4,11,16,11/6/2022,2,0,0,2,21,4,9,34,1,5,2,8,0,0,0,0,5,2,2,9
136947,2022,Brazil,Slovenia,0,2,11,13,10/6/2022,1,0,0,1,16,3,9,28,2,6,3,11,0,0,0,0,5,0,0,5
136947,2022,Brazil,Australia,2,1,8,11,9/6/2022,0,0,0,0,13,2,11,26,3,3,3,9,0,0,0,0,4,0,0,4
161911,2022,,,-,-,-,-,-,-,-,-,-,-,-,-,-,-,-,-,-,-,-,-,-,-,-,-,-
136956,2022,USA,Brazil,0,3,9,12,20/07/2022,0,0,1,1,7,1,2,10,2,3,3,8,1,0,0,1,1,2,1,4
136956,2022,Brazil,Japan,0,0,9,9,10/7/2022,0,0,0,0,4,1,3,8,1,5,6,12,0,0,1,1,0,0,1,1
136956,2022,France,Brazil,1,0,6,7,8/7/2022,0,0,1,1,6,2,4,12,1,6,3,10,0,1,2,3,2,1,2,5
136956,2022,Canada,Brazil,0,0,7,7,7/7/2022,0,0,1,1,7,0,1,8,3,4,6,13,0,0,1,1,3,2,0,5
136956,2022,Brazil,Germany,0,3,10,13,6/7/2022,0,0,1,1,7,1,4,12,3,2,8,13,1,0,1,2,3,1,1,5
136956,2022,Bulgaria,Brazil,0,0,11,11,26/06/2022,0,0,0,0,6,0,3,9,4,0,2,6,1,0,2,3,0,0,0,0
136956,2022,Iran,Brazil,0,3,10,13,24/06/2022,0,0,0,0,6,1,0,7,2,2,1,5,1,0,0,1,1,2,1,4
136956,2022,Serbia,Brazil,0,2,9,11,23/06/2022,0,0,0,0,5,1,0,6,1,3,4,8,0,0,1,1,0,0,0,0
136956,2022,Brazil,Poland,0,1,8,9,22/06/2022,0,0,0,0,6,0,7,13,1,6,5,12,0,0,0,0,1,1,0,2
136956,2022,Brazil,China,0,0,9,9,12/6/2022,1,1,0,2,11,3,2,16,2,0,2,4,0,0,0,0,1,0,0,1
136956,2022,USA,Brazil,0,1,8,9,11/6/2022,0,0,0,0,3,0,2,5,2,3,3,8,0,0,0,0,2,0,0,2
136956,2022,Brazil,Slovenia,0,1,11,12,10/6/2022,1,0,1,2,5,1,3,9,3,2,6,11,0,0,0,0,2,0,0,2
136956,2022,Brazil,Australia,0,0,7,7,9/6/2022,0,0,0,0,5,0,6,11,4,5,10,19,0,0,0,0,2,0,1,3
161946,2022,Brazil,China,0,0,1,1,12/6/2022,0,0,0,0,0,1,0,1,0,0,0,0,1,1,1,3,0,0,1,1
161946,2022,USA,Brazil,0,0,0,0,11/6/2022,0,0,0,0,0,0,0,0,0,0,0,0,0,0,0,0,0,0,0,0
161946,2022,Brazil,Slovenia,0,0,0,0,10/6/2022,0,0,0,0,0,0,0,0,0,0,0,0,0,0,0,0,0,0,0,0
161946,2022,Brazil,Australia,0,0,0,0,9/6/2022,0,0,0,0,0,0,0,0,0,0,0,0,0,0,0,0,0,0,0,0
174902,2022,USA,Brazil,1,4,7,12,20/07/2022,0,0,0,0,11,3,7,21,1,2,5,8,0,0,0,0,5,3,0,8
174902,2022,Brazil,Japan,0,1,7,8,10/7/2022,0,0,2,2,17,4,5,26,2,1,2,5,0,0,0,0,0,0,2,2
174902,2022,France,Brazil,1,2,4,7,8/7/2022,0,0,0,0,8,2,7,17,0,4,5,9,0,0,0,0,1,1,0,2
174902,2022,Canada,Brazil,0,1,8,9,7/7/2022,0,0,1,1,11,3,8,22,1,3,3,7,0,0,0,0,3,2,1,6
174902,2022,Brazil,Germany,0,2,9,11,6/7/2022,0,0,0,0,13,5,5,23,0,3,5,8,0,0,1,1,4,2,1,7
174902,2022,Bulgaria,Brazil,0,2,8,10,26/06/2022,0,0,0,0,10,4,5,19,0,1,3,4,0,0,1,1,0,1,0,1
174902,2022,Iran,Brazil,0,5,3,8,24/06/2022,0,0,0,0,5,2,5,12,0,1,1,2,0,0,0,0,1,0,0,1
174902,2022,Serbia,Brazil,0,0,0,0,23/06/2022,0,0,0,0,0,0,0,0,0,0,0,0,0,0,0,0,0,0,0,0
174902,2022,Brazil,Poland,0,0,0,0,22/06/2022,0,0,0,0,0,1,0,1,0,0,0,0,0,0,0,0,0,0,0,0
174445,2022,China,Bulgaria,0,4,13,17,9/7/2022,0,0,0,0,15,6,1,22,0,0,0,0,0,0,0,0,0,0,1,1
174445,2022,Bulgaria,Netherlands,2,3,8,13,8/7/2022,0,0,2,2,10,4,4,18,0,1,0,1,0,0,0,0,4,0,0,4
174445,2022,Bulgaria,Slovenia,0,0,0,0,7/7/2022,0,0,0,0,0,0,0,0,0,0,0,0,0,0,0,0,0,0,0,0
174445,2022,Bulgaria,Italy,0,2,0,2,5/7/2022,0,0,0,0,2,2,2,6,0,0,0,0,0,0,0,0,0,0,0,0
174445,2022,Bulgaria,Brazil,0,0,2,2,26/06/2022,0,0,0,0,1,0,1,2,0,0,1,1,0,0,0,0,0,0,0,0
174445,2022,USA,Bulgaria,0,0,0,0,25/06/2022,0,0,0,0,0,0,0,0,0,0,0,0,0,0,0,0,0,0,0,0
174445,2022,Australia,Bulgaria,0,0,1,1,24/06/2022,0,0,0,0,1,2,2,5,0,0,0,0,0,0,0,0,0,0,0,0
174445,2022,Iran,Bulgaria,0,0,0,0,21/06/2022,0,0,0,0,0,0,0,0,0,0,0,0,0,0,0,0,0,0,0,0
174445,2022,Bulgaria,Canada,0,0,0,0,12/6/2022,0,0,0,0,0,0,0,0,0,0,0,0,0,0,0,0,0,0,0,0
174445,2022,Bulgaria,Poland,0,2,1,3,11/6/2022,0,0,0,0,2,4,5,11,1,1,2,4,1,0,0,1,2,2,0,4
174445,2022,Bulgaria,Germany,0,1,2,3,10/6/2022,0,0,2,2,5,4,8,17,0,2,1,3,0,0,0,0,1,0,0,1
174445,2022,Bulgaria,Serbia,0,0,0,0,7/6/2022,0,0,0,0,1,0,0,1,0,0,0,0,0,0,0,0,0,0,0,0
180588,2022,China,Bulgaria,1,1,8,10,9/7/2022,0,0,0,0,4,0,3,7,0,3,0,3,0,0,1,1,0,1,0,1
180588,2022,Bulgaria,Netherlands,0,0,0,0,8/7/2022,0,0,0,0,0,0,0,0,0,0,0,0,0,0,0,0,0,0,0,0
180588,2022,Bulgaria,Slovenia,0,2,0,2,7/7/2022,0,0,0,0,0,1,0,1,0,0,0,0,0,0,0,0,0,0,0,0
180588,2022,Bulgaria,Italy,0,0,4,4,5/7/2022,0,0,0,0,3,2,3,8,0,0,1,1,0,0,1,1,1,0,0,1
180588,2022,Bulgaria,Brazil,0,2,5,7,26/06/2022,0,0,0,0,6,0,1,7,1,1,3,5,0,0,0,0,0,2,1,3
180588,2022,USA,Bulgaria,1,4,9,14,25/06/2022,0,0,0,0,3,0,2,5,1,2,3,6,0,0,1,1,1,0,0,1
180588,2022,Australia,Bulgaria,1,1,7,9,24/06/2022,0,0,0,0,2,1,1,4,1,1,0,2,0,0,0,0,0,0,0,0
180588,2022,Iran,Bulgaria,0,0,0,0,21/06/2022,0,0,0,0,0,0,0,0,0,0,0,0,0,0,0,0,0,0,0,0
180588,2022,Bulgaria,Canada,0,0,0,0,12/6/2022,0,0,0,0,0,0,0,0,0,0,0,0,0,0,0,0,0,0,0,0
180588,2022,Bulgaria,Poland,0,2,6,8,11/6/2022,0,0,0,0,3,0,1,4,0,1,2,3,0,0,1,1,1,1,2,4
180588,2022,Bulgaria,Germany,0,0,0,0,10/6/2022,0,0,0,0,0,0,0,0,0,0,0,0,0,0,0,0,0,0,0,0
180588,2022,Bulgaria,Serbia,0,0,0,0,7/6/2022,0,0,0,0,0,0,0,0,0,0,0,0,0,0,0,0,0,0,0,0
173067,2022,China,Bulgaria,0,0,9,9,9/7/2022,0,0,0,0,5,0,1,6,2,2,0,4,0,0,1,1,0,0,0,0
173067,2022,Bulgaria,Netherlands,0,0,17,17,8/7/2022,1,0,0,1,5,2,1,8,2,3,0,5,0,0,0,0,0,0,0,0
173067,2022,Bulgaria,Slovenia,0,0,12,12,7/7/2022,0,0,0,0,7,0,1,8,1,4,0,5,0,0,1,1,0,1,1,2
173067,2022,Bulgaria,Italy,0,1,6,7,5/7/2022,0,0,0,0,2,1,0,3,0,0,0,0,0,0,0,0,1,1,0,2
173067,2022,Bulgaria,Brazil,1,0,11,12,26/06/2022,0,0,0,0,1,1,3,5,3,2,2,7,1,0,3,4,2,0,0,2
173067,2022,USA,Bulgaria,0,1,4,5,25/06/2022,0,0,0,0,4,0,1,5,0,1,1,2,0,0,2,2,0,0,0,0
173067,2022,Australia,Bulgaria,0,0,6,6,24/06/2022,0,0,1,1,5,3,5,13,2,2,0,4,0,0,0,0,0,0,0,0
173067,2022,Iran,Bulgaria,1,0,13,14,21/06/2022,0,0,0,0,5,3,2,10,1,5,3,9,0,0,2,2,1,0,0,1
173067,2022,Bulgaria,Canada,1,1,14,16,12/6/2022,0,0,2,2,9,0,1,10,1,1,4,6,1,0,2,3,1,0,0,1
173067,2022,Bulgaria,Poland,0,0,9,9,11/6/2022,1,0,2,3,9,0,2,11,4,4,7,15,0,0,1,1,3,2,0,5
173067,2022,Bulgaria,Germany,0,0,13,13,10/6/2022,0,0,0,0,5,1,2,8,0,6,4,10,0,0,0,0,0,0,0,0
173067,2022,Bulgaria,Serbia,0,0,1,1,7/6/2022,0,0,0,0,1,0,0,1,0,2,0,2,0,0,0,0,0,0,0,0
156676,2022,China,Bulgaria,0,3,8,11,9/7/2022,0,1,2,3,10,3,4,17,0,2,0,2,2,1,21,24,0,2,0,2
156676,2022,Bulgaria,Netherlands,2,1,7,10,8/7/2022,0,0,0,0,17,1,15,33,1,3,0,4,1,1,17,19,0,0,0,0
156676,2022,Bulgaria,Slovenia,2,3,9,14,7/7/2022,0,1,0,1,12,2,11,25,1,3,0,4,6,2,21,29,1,2,0,3
156676,2022,Bulgaria,Italy,1,3,8,12,5/7/2022,0,0,0,0,13,5,6,24,0,1,1,2,2,0,10,12,0,1,0,1
156676,2022,Bulgaria,Brazil,0,1,7,8,26/06/2022,0,0,1,1,12,3,7,22,0,1,0,1,11,0,11,22,3,0,0,3
156676,2022,USA,Bulgaria,2,4,11,17,25/06/2022,1,0,1,2,9,5,13,27,0,2,1,3,9,2,16,27,2,0,0,2
156676,2022,Australia,Bulgaria,3,5,13,21,24/06/2022,0,0,0,0,11,6,11,28,0,3,0,3,13,1,15,29,3,2,0,5
156676,2022,Iran,Bulgaria,4,2,11,17,21/06/2022,0,0,2,2,10,2,5,17,0,3,2,5,8,0,8,16,0,0,1,1
156676,2022,Bulgaria,Canada,0,1,6,7,12/6/2022,0,0,0,0,4,4,5,13,0,1,0,1,3,1,10,14,0,1,0,1
156676,2022,Bulgaria,Poland,0,2,1,3,11/6/2022,0,0,0,0,1,0,4,5,0,1,0,1,3,1,5,9,1,0,0,1
156676,2022,Bulgaria,Germany,1,5,13,19,10/6/2022,0,0,3,3,13,4,9,26,4,2,2,8,3,1,20,24,7,2,1,10
156676,2022,Bulgaria,Serbia,0,4,4,8,7/6/2022,0,0,0,0,5,5,8,18,1,3,0,4,3,0,11,14,1,1,0,2
132035,2022,China,Bulgaria,0,1,11,12,9/7/2022,0,0,0,0,7,0,3,10,4,5,1,10,0,1,0,1,0,1,1,2
132035,2022,Bulgaria,Netherlands,0,2,8,10,8/7/2022,0,0,0,0,6,0,4,10,6,5,0,11,0,0,0,0,2,1,0,3
132035,2022,Bulgaria,Slovenia,1,2,8,11,7/7/2022,0,0,1,1,4,3,2,9,3,4,0,7,0,0,0,0,0,1,0,1
132035,2022,Bulgaria,Italy,0,0,9,9,5/7/2022,0,0,0,0,2,0,2,4,2,1,0,3,0,0,1,1,2,1,0,3
132035,2022,Bulgaria,Brazil,0,0,0,0,26/06/2022,0,0,0,0,0,0,0,0,0,0,0,0,0,0,0,0,0,0,0,0
132035,2022,USA,Bulgaria,0,1,7,8,25/06/2022,1,0,0,1,4,0,3,7,2,4,3,9,0,0,1,1,1,0,0,1
132035,2022,Australia,Bulgaria,0,1,10,11,24/06/2022,0,0,1,1,10,0,5,15,7,2,10,19,0,0,1,1,1,0,0,1
132035,2022,Iran,Bulgaria,0,0,11,11,21/06/2022,0,0,0,0,4,1,1,6,6,8,2,16,1,1,0,2,3,0,0,3
132035,2022,Bulgaria,Canada,0,0,0,0,12/6/2022,0,0,0,0,0,0,0,0,0,0,0,0,0,0,0,0,0,0,0,0
132035,2022,Bulgaria,Poland,0,0,0,0,11/6/2022,0,0,0,0,0,0,0,0,0,0,0,0,0,0,0,0,0,0,0,0
132035,2022,Bulgaria,Germany,0,1,9,10,10/6/2022,0,0,0,0,1,1,0,2,0,5,0,5,0,0,0,0,0,0,0,0
132035,2022,Bulgaria,Serbia,2,1,18,21,7/6/2022,0,0,2,2,6,1,2,9,5,4,3,12,0,0,3,3,2,2,2,6
162124,2022,,,-,-,-,-,-,-,-,-,-,-,-,-,-,-,-,-,-,-,-,-,-,-,-,-,-
136489,2022,China,Bulgaria,1,1,5,7,9/7/2022,6,0,15,21,0,1,0,1,0,0,0,0,0,0,0,0,1,1,0,2
136489,2022,Bulgaria,Netherlands,0,0,3,3,8/7/2022,0,0,0,0,0,0,0,0,0,0,0,0,0,0,0,0,0,0,0,0
136489,2022,Bulgaria,Slovenia,0,0,4,4,7/7/2022,6,0,8,14,0,0,1,1,0,1,0,1,0,0,0,0,0,1,0,1
136489,2022,Bulgaria,Italy,0,0,0,0,5/7/2022,0,0,0,0,0,0,0,0,0,0,0,0,0,0,0,0,0,0,0,0
136489,2022,Bulgaria,Brazil,0,2,10,12,26/06/2022,19,2,51,72,2,1,0,3,0,3,0,3,0,0,0,0,1,1,0,2
136489,2022,USA,Bulgaria,0,0,2,2,25/06/2022,1,0,9,10,0,0,0,0,0,0,0,0,0,0,0,0,0,0,0,0
136489,2022,Australia,Bulgaria,1,1,5,7,24/06/2022,1,0,4,5,0,0,0,0,0,0,1,1,0,0,0,0,0,0,0,0
136489,2022,Iran,Bulgaria,0,0,0,0,21/06/2022,0,0,0,0,0,0,0,0,0,0,0,0,0,0,0,0,0,0,0,0
136489,2022,Bulgaria,Canada,0,0,1,1,12/6/2022,1,0,0,1,0,0,0,0,0,1,1,2,0,0,0,0,0,0,0,0
136489,2022,Bulgaria,Poland,0,0,5,5,11/6/2022,13,0,6,19,0,0,0,0,0,0,0,0,0,0,0,0,0,2,0,2
136489,2022,Bulgaria,Germany,0,0,1,1,10/6/2022,0,0,0,0,0,0,0,0,0,0,0,0,0,0,0,0,0,0,0,0
136489,2022,Bulgaria,Serbia,0,0,1,1,7/6/2022,7,0,3,10,0,0,1,1,0,0,0,0,0,0,0,0,0,0,1,1
137012,2022,China,Bulgaria,0,1,8,9,9/7/2022,13,0,49,62,0,2,0,2,0,2,0,2,0,0,0,0,1,0,0,1
137012,2022,Bulgaria,Netherlands,1,0,15,16,8/7/2022,19,2,77,98,0,0,1,1,2,2,0,4,0,0,0,0,0,1,1,2
137012,2022,Bulgaria,Slovenia,0,1,10,11,7/7/2022,16,0,64,80,1,0,0,1,1,1,0,2,0,0,0,0,0,1,0,1
137012,2022,Bulgaria,Italy,0,1,8,9,5/7/2022,11,1,71,83,0,0,0,0,0,0,0,0,0,0,0,0,0,0,0,0
137012,2022,Bulgaria,Brazil,0,0,0,0,26/06/2022,0,0,0,0,0,0,0,0,0,0,0,0,0,0,0,0,0,0,0,0
137012,2022,USA,Bulgaria,0,1,11,12,25/06/2022,22,1,63,86,0,0,1,1,0,1,1,2,0,0,1,1,1,1,1,3
137012,2022,Australia,Bulgaria,0,1,14,15,24/06/2022,40,1,61,102,2,1,1,4,2,4,3,9,0,0,0,0,1,1,1,3
137012,2022,Iran,Bulgaria,0,3,10,13,21/06/2022,19,0,50,69,1,0,0,1,0,0,5,5,0,0,0,0,5,1,0,6
137012,2022,Bulgaria,Canada,0,2,10,12,12/6/2022,54,0,36,90,1,0,2,3,1,7,3,11,0,0,1,1,8,4,4,16
137012,2022,Bulgaria,Poland,0,2,7,9,11/6/2022,24,0,26,50,0,0,1,1,0,0,2,2,0,0,1,1,4,3,1,8
137012,2022,Bulgaria,Germany,0,1,15,16,10/6/2022,37,2,59,98,3,0,1,4,1,3,1,5,0,0,0,0,6,4,3,13
137012,2022,Bulgaria,Serbia,0,1,11,12,7/6/2022,46,1,31,78,1,0,0,1,1,0,1,2,0,0,1,1,2,5,4,11
181285,2022,,,-,-,-,-,-,-,-,-,-,-,-,-,-,-,-,-,-,-,-,-,-,-,-,-,-
152619,2022,Bulgaria,Canada,0,1,14,15,12/6/2022,0,0,1,1,4,1,6,11,2,6,6,14,2,0,0,2,3,3,1,7
152619,2022,Bulgaria,Poland,1,0,3,4,11/6/2022,0,0,0,0,1,0,2,3,0,2,3,5,0,1,0,1,0,0,1,1
152619,2022,Bulgaria,Germany,0,2,7,9,10/6/2022,0,0,2,2,5,1,3,9,1,4,8,13,1,0,0,1,2,0,1,3
152619,2022,Bulgaria,Serbia,1,2,7,10,7/6/2022,0,0,1,1,5,1,5,11,5,8,11,24,0,0,0,0,1,1,1,3
174484,2022,,,-,-,-,-,-,-,-,-,-,-,-,-,-,-,-,-,-,-,-,-,-,-,-,-,-
180587,2022,,,-,-,-,-,-,-,-,-,-,-,-,-,-,-,-,-,-,-,-,-,-,-,-,-,-
168269,2022,China,Bulgaria,0,1,1,2,9/7/2022,0,0,2,2,1,1,2,4,1,1,0,2,1,0,5,6,1,0,0,1
168269,2022,Bulgaria,Netherlands,0,0,0,0,8/7/2022,0,0,0,0,0,0,0,0,0,0,0,0,0,0,0,0,0,0,0,0
168269,2022,Bulgaria,Slovenia,0,2,5,7,7/7/2022,0,0,1,1,4,6,5,15,0,1,0,1,0,0,1,1,0,0,0,0
168269,2022,Bulgaria,Italy,0,0,0,0,5/7/2022,0,0,0,0,0,2,1,3,0,0,0,0,0,0,1,1,0,0,0,0
168269,2022,Bulgaria,Brazil,1,3,1,5,26/06/2022,0,0,0,0,6,3,5,14,2,2,1,5,5,0,10,15,0,1,0,1
168269,2022,USA,Bulgaria,0,0,0,0,25/06/2022,0,0,0,0,0,0,0,0,0,0,0,0,0,0,0,0,0,0,0,0
168269,2022,Australia,Bulgaria,0,2,7,9,24/06/2022,0,0,0,0,4,0,4,8,2,3,1,6,0,0,0,0,2,0,0,2
168269,2022,Iran,Bulgaria,0,0,0,0,21/06/2022,0,0,0,0,0,0,0,0,0,0,0,0,0,0,0,0,0,0,0,0
168269,2022,Bulgaria,Canada,3,1,6,10,12/6/2022,1,0,1,2,12,3,7,22,0,5,2,7,1,0,12,13,0,0,1,1
168269,2022,Bulgaria,Poland,1,1,3,5,11/6/2022,1,0,0,1,2,2,6,10,1,0,1,2,1,2,4,7,1,0,1,2
168269,2022,Bulgaria,Germany,0,0,0,0,10/6/2022,0,0,0,0,0,0,0,0,0,0,0,0,0,0,0,0,0,0,0,0
168269,2022,Bulgaria,Serbia,0,1,5,6,7/6/2022,0,0,0,0,8,0,2,10,0,0,0,0,0,2,13,15,0,0,1,1
150277,2022,China,Bulgaria,0,0,0,0,9/7/2022,0,0,0,0,0,0,0,0,0,0,0,0,0,0,0,0,0,0,0,0
150277,2022,Bulgaria,Netherlands,0,2,7,9,8/7/2022,0,0,1,1,1,2,5,8,1,1,0,2,0,0,1,1,0,0,0,0
150277,2022,Bulgaria,Slovenia,1,2,3,6,7/7/2022,0,0,1,1,6,3,7,16,0,1,0,1,0,0,1,1,1,0,0,1
150277,2022,Bulgaria,Italy,1,2,5,8,5/7/2022,0,0,0,0,4,5,9,18,0,1,0,1,0,1,2,3,0,0,0,0
150277,2022,Bulgaria,Brazil,0,4,5,9,26/06/2022,0,0,0,0,6,3,7,16,2,2,0,4,1,0,2,3,2,2,0,4
150277,2022,USA,Bulgaria,0,2,9,11,25/06/2022,0,0,0,0,13,6,8,27,2,3,3,8,1,0,1,2,3,1,0,4
150277,2022,Australia,Bulgaria,0,1,4,5,24/06/2022,0,0,0,0,5,7,3,15,0,1,4,5,0,0,0,0,2,1,0,3
150277,2022,Iran,Bulgaria,1,2,8,11,21/06/2022,1,0,0,1,4,3,5,12,1,2,0,3,0,0,0,0,1,0,0,1
150277,2022,Bulgaria,Canada,1,4,15,20,12/6/2022,0,0,2,2,9,6,7,22,3,4,5,12,1,0,2,3,5,2,1,8
150277,2022,Bulgaria,Poland,0,2,2,4,11/6/2022,0,0,2,2,6,2,2,10,0,2,5,7,0,0,0,0,2,1,0,3
150277,2022,Bulgaria,Germany,0,2,6,8,10/6/2022,0,0,0,0,5,5,3,13,1,3,3,7,0,0,2,2,1,2,0,3
150277,2022,Bulgaria,Serbia,0,3,8,11,7/6/2022,0,0,2,2,13,2,7,22,2,6,2,10,0,0,1,1,2,9,1,12
118484,2022,China,Bulgaria,0,0,0,0,9/7/2022,0,0,5,5,0,0,0,0,0,0,0,0,4,3,9,16,5,2,2,9
118484,2022,Bulgaria,Netherlands,0,0,0,0,8/7/2022,0,0,1,1,0,0,0,0,0,0,0,0,5,2,13,20,4,3,2,9
118484,2022,Bulgaria,Slovenia,0,0,0,0,7/7/2022,0,0,1,1,0,0,0,0,0,0,0,0,1,0,22,23,2,0,0,2
118484,2022,Bulgaria,Italy,0,0,0,0,5/7/2022,0,0,1,1,0,0,0,0,0,0,0,0,3,3,10,16,2,0,2,4
118484,2022,Bulgaria,Brazil,0,0,0,0,26/06/2022,0,0,2,2,0,0,0,0,0,0,0,0,2,1,7,10,2,0,0,2
118484,2022,USA,Bulgaria,0,0,0,0,25/06/2022,0,0,2,2,0,0,0,0,0,0,0,0,1,1,12,14,2,4,0,6
118484,2022,Australia,Bulgaria,0,0,0,0,24/06/2022,2,0,5,7,0,0,0,0,0,0,0,0,6,1,14,21,4,2,5,11
118484,2022,Iran,Bulgaria,0,0,0,0,21/06/2022,1,0,3,4,0,0,0,0,0,0,0,0,9,0,9,18,3,2,0,5
174444,2022,China,Bulgaria,0,0,0,0,9/7/2022,0,0,0,0,0,0,0,0,0,0,0,0,0,0,0,0,0,0,0,0
174444,2022,Bulgaria,Netherlands,0,0,0,0,8/7/2022,0,0,0,0,0,0,0,0,0,0,0,0,0,0,0,0,0,0,0,0
174444,2022,Bulgaria,Slovenia,0,0,0,0,7/7/2022,0,0,0,0,0,0,0,0,0,0,0,0,0,0,0,0,0,0,0,0
174444,2022,Bulgaria,Italy,0,0,0,0,5/7/2022,0,0,0,0,0,0,0,0,0,0,0,0,0,0,0,0,0,0,0,0
174444,2022,Bulgaria,Canada,0,0,0,0,12/6/2022,0,0,0,0,0,0,0,0,0,0,0,0,0,0,0,0,0,0,0,0
174444,2022,Bulgaria,Poland,0,0,0,0,11/6/2022,0,0,0,0,0,0,0,0,0,0,0,0,0,0,0,0,0,0,0,0
174444,2022,Bulgaria,Germany,0,0,0,0,10/6/2022,0,0,0,0,0,0,0,0,0,0,0,0,0,0,0,0,0,0,0,0
174444,2022,Bulgaria,Serbia,0,0,0,0,7/6/2022,0,0,0,0,0,0,0,0,0,0,0,0,0,0,0,0,0,0,0,0
164812,2022,China,Bulgaria,1,1,3,5,9/7/2022,0,0,0,0,2,1,1,4,0,1,0,1,0,0,8,8,1,0,0,1
164812,2022,Bulgaria,Netherlands,0,0,0,0,8/7/2022,0,0,0,0,0,0,0,0,0,0,0,0,0,0,2,2,0,0,1,1
164812,2022,Bulgaria,Slovenia,0,0,0,0,7/7/2022,0,0,0,0,1,0,0,1,0,0,0,0,0,0,3,3,0,1,0,1
164812,2022,Bulgaria,Italy,0,0,0,0,5/7/2022,0,0,0,0,0,0,0,0,0,0,0,0,0,0,0,0,0,0,0,0
164812,2022,Bulgaria,Brazil,0,0,2,2,26/06/2022,0,0,0,0,0,0,0,0,0,0,0,0,0,0,1,1,0,0,0,0
164812,2022,USA,Bulgaria,0,0,0,0,25/06/2022,0,0,0,0,0,0,0,0,0,0,0,0,1,0,1,2,0,0,0,0
164812,2022,Australia,Bulgaria,0,0,0,0,24/06/2022,0,0,0,0,1,0,0,1,0,0,1,1,2,0,2,4,0,0,0,0
164812,2022,Iran,Bulgaria,0,0,0,0,21/06/2022,0,0,0,0,0,0,0,0,0,0,0,0,0,0,0,0,0,0,0,0
164812,2022,Bulgaria,Canada,0,0,0,0,12/6/2022,0,0,0,0,0,0,0,0,0,0,0,0,0,0,0,0,0,0,0,0
164812,2022,Bulgaria,Poland,0,2,2,4,11/6/2022,0,0,2,2,4,4,2,10,1,1,1,3,7,1,9,17,1,0,0,1
164812,2022,Bulgaria,Germany,0,0,0,0,10/6/2022,0,0,0,0,0,0,0,0,0,0,0,0,1,0,1,2,1,1,0,2
164812,2022,Bulgaria,Serbia,0,0,0,0,7/6/2022,0,0,0,0,0,0,0,0,0,0,0,0,0,0,1,1,0,0,0,0
136483,2022,,,-,-,-,-,-,-,-,-,-,-,-,-,-,-,-,-,-,-,-,-,-,-,-,-,-
168268,2022,China,Bulgaria,0,0,0,0,9/7/2022,0,0,0,0,0,0,0,0,0,0,0,0,0,0,0,0,0,0,0,0
168268,2022,Bulgaria,Netherlands,0,0,0,0,8/7/2022,0,0,0,0,0,0,0,0,0,0,0,0,0,0,0,0,0,0,0,0
168268,2022,Bulgaria,Slovenia,0,0,0,0,7/7/2022,0,0,0,0,0,0,0,0,0,0,0,0,0,0,0,0,0,0,0,0
168268,2022,Bulgaria,Italy,0,0,0,0,5/7/2022,0,0,0,0,0,0,0,0,0,0,0,0,0,0,0,0,0,0,0,0
168268,2022,Bulgaria,Brazil,0,0,0,0,26/06/2022,0,0,0,0,0,0,0,0,0,0,0,0,0,0,0,0,0,0,0,0
168268,2022,USA,Bulgaria,0,0,0,0,25/06/2022,0,0,0,0,0,0,0,0,0,0,0,0,0,0,0,0,0,0,0,0
168268,2022,Australia,Bulgaria,0,0,0,0,24/06/2022,0,0,0,0,0,0,0,0,0,0,0,0,0,0,0,0,0,0,0,0
168268,2022,Iran,Bulgaria,0,0,0,0,21/06/2022,0,0,0,0,0,0,0,0,0,0,0,0,0,0,0,0,0,0,0,0
162123,2022,,,-,-,-,-,-,-,-,-,-,-,-,-,-,-,-,-,-,-,-,-,-,-,-,-,-
180586,2022,China,Bulgaria,0,0,10,10,9/7/2022,0,0,1,1,11,2,7,20,0,2,0,2,1,2,24,27,2,0,0,2
180586,2022,Bulgaria,Netherlands,0,4,14,18,8/7/2022,0,0,1,1,14,3,7,24,0,3,0,3,4,3,24,31,0,2,0,2
180586,2022,Bulgaria,Slovenia,0,6,9,15,7/7/2022,0,0,0,0,10,6,7,23,3,3,0,6,2,1,22,25,1,0,0,1
180586,2022,Bulgaria,Italy,0,2,6,8,5/7/2022,0,0,0,0,11,2,5,18,0,0,0,0,5,2,24,31,0,1,0,1
180586,2022,Bulgaria,Brazil,1,0,6,7,26/06/2022,0,0,0,0,4,2,2,8,0,1,0,1,1,3,3,7,0,0,0,0
180586,2022,USA,Bulgaria,3,3,10,16,25/06/2022,0,0,0,0,14,4,14,32,0,4,0,4,10,5,12,27,2,3,0,5
180586,2022,Australia,Bulgaria,2,2,12,16,24/06/2022,2,0,0,2,12,4,9,25,3,3,3,9,9,5,25,39,4,2,1,7
180586,2022,Iran,Bulgaria,0,4,5,9,21/06/2022,0,0,1,1,20,4,7,31,0,2,1,3,6,0,13,19,0,1,1,2
180586,2022,Bulgaria,Canada,2,3,12,17,12/6/2022,0,0,7,7,13,6,13,32,2,5,3,10,5,3,22,30,8,1,1,10
180586,2022,Bulgaria,Poland,0,0,8,8,11/6/2022,0,0,2,2,8,0,11,19,1,2,1,4,4,0,13,17,5,0,1,6
180586,2022,Bulgaria,Germany,1,6,10,17,10/6/2022,0,0,0,0,21,4,8,33,3,3,4,10,10,4,21,35,3,2,1,6
180586,2022,Bulgaria,Serbia,0,1,16,17,7/6/2022,0,0,1,1,12,6,7,25,1,4,0,5,5,3,27,35,1,2,5,8
173009,2022,Bulgaria,Brazil,0,0,0,0,26/06/2022,0,0,0,0,0,0,0,0,0,0,0,0,0,0,0,0,0,0,0,0
173009,2022,USA,Bulgaria,0,0,0,0,25/06/2022,0,0,0,0,0,0,0,0,0,0,0,0,0,0,0,0,0,0,0,0
173009,2022,Australia,Bulgaria,0,0,0,0,24/06/2022,0,0,0,0,0,0,0,0,0,0,0,0,0,0,0,0,0,0,0,0
173009,2022,Iran,Bulgaria,0,0,0,0,21/06/2022,0,0,0,0,0,0,0,0,0,0,0,0,0,0,0,0,0,0,0,0
173009,2022,Bulgaria,Canada,0,0,0,0,12/6/2022,1,1,5,7,0,0,0,0,0,0,0,0,8,3,12,23,3,3,3,9
173009,2022,Bulgaria,Poland,0,0,0,0,11/6/2022,0,0,5,5,0,0,0,0,0,0,0,0,3,1,5,9,3,1,2,6
173009,2022,Bulgaria,Germany,0,0,0,0,10/6/2022,0,0,2,2,0,0,0,0,0,0,0,0,5,0,22,27,7,2,0,9
173009,2022,Bulgaria,Serbia,0,0,0,0,7/6/2022,0,1,3,4,0,0,0,0,0,0,0,0,2,3,10,15,1,7,4,12
181806,2022,,,-,-,-,-,-,-,-,-,-,-,-,-,-,-,-,-,-,-,-,-,-,-,-,-,-
174446,2022,,,-,-,-,-,-,-,-,-,-,-,-,-,-,-,-,-,-,-,-,-,-,-,-,-,-
135372,2022,,,-,-,-,-,-,-,-,-,-,-,-,-,-,-,-,-,-,-,-,-,-,-,-,-,-
168941,2022,,,-,-,-,-,-,-,-,-,-,-,-,-,-,-,-,-,-,-,-,-,-,-,-,-,-
168922,2022,,,-,-,-,-,-,-,-,-,-,-,-,-,-,-,-,-,-,-,-,-,-,-,-,-,-
162249,2022,Bulgaria,Canada,0,0,0,0,12/6/2022,0,0,0,0,0,0,0,0,0,0,0,0,0,0,0,0,0,0,0,0
162249,2022,Canada,Italy,0,0,0,0,11/6/2022,0,0,0,0,0,0,0,0,0,0,0,0,0,0,0,0,0,0,0,0
162249,2022,France,Canada,0,0,0,0,10/6/2022,0,2,2,4,0,0,0,0,0,0,0,0,2,4,12,18,6,2,2,10
162249,2022,Canada,Germany,0,0,0,0,7/6/2022,0,0,0,0,0,0,0,0,0,0,0,0,0,0,0,0,0,0,0,0
136291,2022,Canada,USA,0,0,0,0,9/7/2022,0,0,0,0,0,0,0,0,0,0,0,0,0,0,0,0,0,0,0,0
136291,2022,Japan,Canada,0,0,0,0,8/7/2022,0,0,0,0,0,0,0,0,0,0,0,0,0,0,0,0,0,0,0,0
136291,2022,Canada,Brazil,0,0,0,0,7/7/2022,0,0,0,0,0,0,0,0,0,0,0,0,0,0,0,0,0,0,0,0
136291,2022,Canada,Argentina,0,0,5,5,5/7/2022,0,0,0,0,0,0,0,0,0,0,0,0,0,0,0,0,0,1,0,1
136291,2022,Australia,Canada,0,2,3,5,21/06/2022,0,0,0,0,4,1,8,13,0,1,0,1,7,2,8,17,0,0,1,1
136291,2022,Bulgaria,Canada,0,5,13,18,12/6/2022,1,0,8,9,14,6,2,22,1,1,3,5,1,2,25,28,4,0,4,8
136291,2022,Canada,Italy,0,1,10,11,11/6/2022,0,0,5,5,5,4,9,18,1,0,0,1,2,0,10,12,4,0,0,4
136291,2022,France,Canada,0,0,4,4,10/6/2022,0,0,0,0,0,0,0,0,0,0,0,0,0,0,0,0,0,0,0,0
136291,2022,Canada,Germany,2,4,10,16,7/6/2022,0,0,6,6,10,2,3,15,0,2,1,3,4,2,11,17,3,1,0,4
157327,2022,Canada,USA,0,0,0,0,9/7/2022,0,0,0,0,1,0,0,1,0,0,0,0,0,1,2,3,0,0,1,1
157327,2022,Japan,Canada,0,3,3,6,8/7/2022,2,0,4,6,4,3,5,12,0,0,0,0,3,1,5,9,2,0,2,4
157327,2022,Canada,Brazil,2,3,6,11,7/7/2022,0,0,3,3,8,9,8,25,1,3,2,6,3,2,14,19,6,1,4,11
157327,2022,Canada,Argentina,0,3,14,17,5/7/2022,0,1,1,2,19,5,13,37,1,3,2,6,4,0,18,22,3,1,3,7
157327,2022,Canada,Iran,1,5,6,12,25/06/2022,0,0,3,3,11,3,11,25,1,0,0,1,1,2,13,16,3,1,0,4
157327,2022,Serbia,Canada,4,6,9,19,24/06/2022,0,0,3,3,14,5,7,26,1,2,0,3,2,1,26,29,0,2,0,2
157327,2022,Poland,Canada,0,1,2,3,23/06/2022,0,0,0,0,0,0,0,0,0,0,0,0,0,0,0,0,0,0,0,0
157327,2022,Australia,Canada,2,3,6,11,21/06/2022,0,0,0,0,3,2,10,15,0,1,0,1,4,1,16,21,1,1,1,3
140042,2022,,,-,-,-,-,-,-,-,-,-,-,-,-,-,-,-,-,-,-,-,-,-,-,-,-,-
140061,2022,Canada,USA,0,2,7,9,9/7/2022,1,0,4,5,7,4,15,26,0,3,1,4,5,1,8,14,2,1,1,4
140061,2022,Japan,Canada,2,2,9,13,8/7/2022,1,0,4,5,17,6,14,37,1,3,4,8,10,2,22,34,11,4,1,16
140061,2022,Canada,Brazil,0,0,0,0,7/7/2022,0,0,0,0,0,0,0,0,0,0,0,0,0,0,0,0,0,0,0,0
140061,2022,Canada,Argentina,2,6,5,13,5/7/2022,0,0,1,1,10,9,12,31,0,5,3,8,6,1,25,32,11,2,1,14
140061,2022,Canada,Iran,2,4,8,14,25/06/2022,0,0,2,2,14,2,11,27,2,3,0,5,4,1,16,21,4,3,0,7
140061,2022,Serbia,Canada,3,1,14,18,24/06/2022,0,0,2,2,18,5,13,36,1,7,2,10,5,1,16,22,0,1,0,1
140061,2022,Poland,Canada,0,0,0,0,23/06/2022,0,0,0,0,0,0,0,0,0,0,0,0,0,0,1,1,0,0,0,0
140061,2022,Australia,Canada,1,1,14,16,21/06/2022,0,0,0,0,19,0,16,35,3,1,3,7,3,2,12,17,2,1,2,5
140061,2022,Bulgaria,Canada,2,1,20,23,12/6/2022,0,0,2,2,21,4,16,41,2,5,1,8,4,1,32,37,7,0,6,13
140061,2022,Canada,Italy,0,2,7,9,11/6/2022,0,0,4,4,6,3,16,25,0,4,0,4,5,1,12,18,4,0,1,5
140061,2022,France,Canada,2,2,8,12,10/6/2022,0,0,0,0,10,7,7,24,0,3,2,5,2,1,10,13,6,2,3,11
140061,2022,Canada,Germany,1,1,9,11,7/6/2022,0,0,3,3,17,8,9,34,0,3,2,5,1,1,10,12,3,0,3,6
143745,2022,Canada,Iran,1,2,4,7,25/06/2022,16,0,24,40,0,0,1,1,0,2,0,2,0,0,0,0,1,0,0,1
143745,2022,Serbia,Canada,0,1,14,15,24/06/2022,24,2,64,90,0,1,1,2,0,1,0,1,0,0,0,0,2,1,0,3
143745,2022,Poland,Canada,1,1,7,9,23/06/2022,9,1,58,68,0,0,0,0,0,2,1,3,0,0,0,0,1,1,0,2
143745,2022,Australia,Canada,0,0,12,12,21/06/2022,29,0,59,88,1,0,0,1,0,1,3,4,0,0,0,0,1,0,0,1
143745,2022,Bulgaria,Canada,0,3,11,14,12/6/2022,53,2,44,99,3,0,3,6,3,2,8,13,0,0,0,0,6,1,0,7
143745,2022,Canada,Italy,0,0,2,2,11/6/2022,0,0,25,25,0,0,0,0,0,1,0,1,0,0,0,0,0,0,0,0
143745,2022,France,Canada,1,1,7,9,10/6/2022,28,0,31,59,1,0,2,3,2,2,2,6,0,0,0,0,5,1,1,7
143745,2022,Canada,Germany,1,0,2,3,7/6/2022,2,0,8,10,0,0,0,0,0,0,0,0,0,0,0,0,0,1,0,1
124553,2022,Canada,USA,0,0,1,1,9/7/2022,0,0,5,5,0,0,0,0,0,0,0,0,0,0,0,0,0,2,1,3
124553,2022,Japan,Canada,0,1,8,9,8/7/2022,26,1,26,53,2,0,1,3,0,2,1,3,0,0,0,0,7,1,1,9
124553,2022,Canada,Brazil,2,1,7,10,7/7/2022,24,2,40,66,0,0,1,1,0,0,5,5,0,0,0,0,3,1,1,5
124553,2022,Canada,Argentina,0,0,0,0,5/7/2022,0,0,0,0,0,0,0,0,0,0,0,0,0,0,0,0,0,0,0,0
124553,2022,Bulgaria,Canada,0,0,0,0,12/6/2022,0,0,0,0,0,0,0,0,0,0,0,0,0,0,0,0,0,0,0,0
124553,2022,Canada,Italy,0,0,3,3,11/6/2022,0,0,40,40,0,0,0,0,0,0,1,1,0,0,2,2,4,2,0,6
124553,2022,France,Canada,0,0,0,0,10/6/2022,0,0,0,0,0,0,0,0,0,0,0,0,0,0,0,0,0,0,0,0
124553,2022,Canada,Germany,0,1,3,4,7/6/2022,18,1,34,53,0,0,0,0,0,3,1,4,0,0,0,0,5,2,1,8
140428,2022,Canada,USA,0,0,3,3,9/7/2022,0,0,0,0,7,2,6,15,0,0,2,2,0,0,2,2,5,1,1,7
140428,2022,Japan,Canada,0,3,3,6,8/7/2022,0,0,1,1,4,0,6,10,1,1,4,6,0,0,3,3,4,1,0,5
140428,2022,Canada,Brazil,0,0,2,2,7/7/2022,0,0,0,0,0,0,0,0,0,0,0,0,0,0,0,0,0,1,0,1
140428,2022,Canada,Argentina,1,8,7,16,5/7/2022,0,0,2,2,13,0,7,20,2,5,8,15,0,1,2,3,4,0,1,5
140428,2022,Canada,Iran,0,3,6,9,25/06/2022,0,0,0,0,8,2,3,13,0,0,0,0,0,0,2,2,3,1,0,4
140428,2022,Serbia,Canada,1,5,13,19,24/06/2022,1,0,0,1,13,2,6,21,3,3,0,6,0,1,6,7,4,1,2,7
140428,2022,Poland,Canada,0,0,0,0,23/06/2022,0,0,0,0,0,0,0,0,0,0,0,0,0,0,0,0,0,0,0,0
140428,2022,Australia,Canada,2,2,14,18,21/06/2022,0,0,0,0,13,4,7,24,1,2,3,6,0,0,2,2,2,0,0,2
140428,2022,Bulgaria,Canada,4,4,11,19,12/6/2022,0,0,1,1,11,4,9,24,2,3,2,7,0,1,0,1,6,2,0,8
140428,2022,Canada,Italy,0,3,3,6,11/6/2022,0,0,2,2,3,5,8,16,0,2,0,2,2,0,4,6,4,0,0,4
140428,2022,France,Canada,1,2,9,12,10/6/2022,0,1,3,4,5,1,4,10,1,0,5,6,0,0,8,8,4,1,2,7
140428,2022,Canada,Germany,0,0,13,13,7/6/2022,0,0,0,0,6,3,5,14,0,2,4,6,0,1,3,4,6,2,2,10
157324,2022,Canada,USA,0,0,6,6,9/7/2022,0,0,1,1,2,1,1,4,0,6,3,9,0,0,0,0,1,2,2,5
157324,2022,Japan,Canada,0,3,5,8,8/7/2022,0,0,0,0,7,3,2,12,0,5,2,7,4,2,4,10,0,0,0,0
157324,2022,Canada,Brazil,0,0,0,0,7/7/2022,0,0,0,0,0,0,0,0,0,0,0,0,0,0,0,0,0,0,0,0
157324,2022,Canada,Argentina,0,1,10,11,5/7/2022,0,0,0,0,3,2,1,6,0,6,5,11,0,0,0,0,1,2,0,3
157324,2022,Canada,Iran,0,1,8,9,25/06/2022,0,0,1,1,3,2,5,10,0,6,2,8,0,0,0,0,1,0,0,1
157324,2022,Serbia,Canada,0,0,0,0,24/06/2022,0,0,0,0,0,0,0,0,0,0,0,0,0,0,0,0,0,0,0,0
157324,2022,Poland,Canada,0,2,4,6,23/06/2022,0,0,0,0,3,0,2,5,1,3,2,6,2,0,0,2,0,0,0,0
157324,2022,Australia,Canada,1,2,5,8,21/06/2022,0,0,0,0,2,1,3,6,2,2,0,4,0,0,1,1,0,0,1,1
157324,2022,Bulgaria,Canada,0,0,0,0,12/6/2022,0,0,0,0,0,0,0,0,0,0,0,0,0,0,0,0,0,0,0,0
157324,2022,Canada,Italy,0,0,7,7,11/6/2022,0,0,0,0,2,0,1,3,5,0,1,6,0,1,1,2,1,1,0,2
157324,2022,France,Canada,1,3,3,7,10/6/2022,0,0,0,0,4,1,4,9,3,4,2,9,0,0,2,2,0,0,1,1
157324,2022,Canada,Germany,0,3,2,5,7/6/2022,0,0,0,0,0,1,0,1,1,2,3,6,1,0,1,2,0,0,1,1
136296,2022,Canada,USA,0,0,9,9,9/7/2022,1,0,0,1,2,0,2,4,0,8,1,9,0,0,4,4,3,0,2,5
136296,2022,Japan,Canada,0,0,0,0,8/7/2022,0,0,0,0,0,0,0,0,0,0,0,0,0,0,0,0,0,0,0,0
136296,2022,Canada,Brazil,0,0,9,9,7/7/2022,0,0,3,3,1,2,3,6,0,5,1,6,1,0,3,4,1,1,0,2
136296,2022,Canada,Argentina,0,0,2,2,5/7/2022,0,0,0,0,2,0,0,2,0,1,1,2,0,0,1,1,1,0,0,1
136296,2022,Canada,Iran,0,0,0,0,25/06/2022,0,0,0,0,0,0,0,0,0,0,0,0,0,0,0,0,0,0,0,0
136296,2022,Serbia,Canada,0,1,5,6,24/06/2022,0,0,0,0,2,0,1,3,2,2,6,10,0,0,2,2,0,0,0,0
136296,2022,Poland,Canada,0,0,2,2,23/06/2022,0,0,0,0,2,0,2,4,0,5,0,5,1,0,1,2,0,1,0,1
136296,2022,Australia,Canada,0,1,5,6,21/06/2022,0,0,0,0,4,1,0,5,0,3,0,3,0,0,0,0,0,1,0,1
136296,2022,Bulgaria,Canada,0,0,15,15,12/6/2022,1,0,1,2,9,2,1,12,2,8,7,17,0,1,2,3,5,0,1,6
136296,2022,Canada,Italy,0,0,1,1,11/6/2022,0,0,0,0,0,0,0,0,0,0,0,0,0,0,0,0,0,0,0,0
136296,2022,France,Canada,0,1,5,6,10/6/2022,0,0,0,0,2,3,2,7,0,3,6,9,0,0,0,0,0,0,0,0
136296,2022,Canada,Germany,0,0,5,5,7/6/2022,0,0,0,0,1,0,1,2,1,2,5,8,0,0,0,0,0,0,0,0
157588,2022,,,-,-,-,-,-,-,-,-,-,-,-,-,-,-,-,-,-,-,-,-,-,-,-,-,-
168918,2022,,,-,-,-,-,-,-,-,-,-,-,-,-,-,-,-,-,-,-,-,-,-,-,-,-,-
153661,2022,Canada,Iran,0,0,0,0,25/06/2022,0,0,0,0,0,0,0,0,0,0,0,0,0,0,0,0,0,0,0,0
153661,2022,Serbia,Canada,0,0,0,0,24/06/2022,0,0,0,0,0,0,0,0,0,0,0,0,0,0,0,0,0,0,0,0
153661,2022,Poland,Canada,0,0,4,4,23/06/2022,0,0,0,0,0,0,0,0,0,1,0,1,0,0,0,0,0,1,0,1
153661,2022,Australia,Canada,0,0,0,0,21/06/2022,0,0,0,0,0,0,0,0,0,0,0,0,0,0,0,0,0,0,0,0
153661,2022,Bulgaria,Canada,0,0,0,0,12/6/2022,0,0,0,0,0,0,0,0,0,0,0,0,0,0,0,0,0,0,0,0
153661,2022,Canada,Italy,0,1,3,4,11/6/2022,0,0,0,0,2,1,1,4,0,1,0,1,0,0,1,1,0,0,0,0
153661,2022,France,Canada,0,1,1,2,10/6/2022,0,0,1,1,2,0,1,3,1,1,2,4,0,0,0,0,0,0,0,0
153661,2022,Canada,Germany,0,0,0,0,7/6/2022,0,0,0,0,0,0,0,0,0,0,0,0,0,0,0,0,0,0,0,0
183276,2022,,,-,-,-,-,-,-,-,-,-,-,-,-,-,-,-,-,-,-,-,-,-,-,-,-,-
140057,2022,Canada,USA,0,0,0,0,9/7/2022,0,0,0,0,0,0,0,0,0,0,0,0,0,0,0,0,0,0,0,0
140057,2022,Japan,Canada,0,0,0,0,8/7/2022,0,0,0,0,0,0,0,0,0,0,0,0,1,2,7,10,2,2,0,4
140057,2022,Canada,Brazil,0,0,0,0,7/7/2022,0,0,0,0,0,0,0,0,0,0,0,0,0,0,0,0,0,0,0,0
140057,2022,Canada,Argentina,0,0,0,0,5/7/2022,1,0,3,4,0,0,0,0,0,0,0,0,2,2,14,18,4,4,3,11
140057,2022,Canada,Iran,0,0,0,0,25/06/2022,0,0,2,2,0,0,0,0,0,0,0,0,5,1,17,23,1,5,2,8
140057,2022,Serbia,Canada,0,0,0,0,24/06/2022,1,0,3,4,0,0,0,0,0,0,0,0,7,0,13,20,3,1,0,4
140057,2022,Poland,Canada,0,5,4,9,23/06/2022,0,0,1,1,9,5,9,23,0,3,1,4,1,0,11,12,0,2,0,2
140057,2022,Australia,Canada,0,0,0,0,21/06/2022,2,0,0,2,0,0,0,0,0,0,0,0,2,1,4,7,5,1,0,6
140057,2022,Bulgaria,Canada,0,0,0,0,12/6/2022,0,0,0,0,0,0,0,0,0,0,0,0,0,0,0,0,0,0,0,0
140057,2022,Canada,Italy,0,0,0,0,11/6/2022,0,0,0,0,0,0,0,0,0,0,0,0,0,0,0,0,0,0,0,0
140057,2022,France,Canada,0,2,2,4,10/6/2022,0,0,0,0,3,3,5,11,0,2,0,2,0,0,7,7,1,1,2,4
140057,2022,Canada,Germany,0,0,0,0,7/6/2022,0,0,0,0,0,0,0,0,0,0,0,0,0,0,0,0,0,0,0,0
168925,2022,Canada,USA,0,0,0,0,9/7/2022,0,0,5,5,0,0,0,0,0,0,0,0,7,1,12,20,5,3,0,8
168925,2022,Japan,Canada,0,0,0,0,8/7/2022,0,0,2,2,0,0,0,0,0,0,0,0,1,0,3,4,3,1,1,5
168925,2022,Canada,Brazil,0,0,0,0,7/7/2022,0,0,5,5,0,0,0,0,0,0,0,0,4,0,11,15,7,3,4,14
168925,2022,Canada,Argentina,0,0,0,0,5/7/2022,1,0,0,1,0,0,0,0,0,0,0,0,0,0,1,1,5,3,0,8
168925,2022,Canada,Iran,0,0,0,0,25/06/2022,0,0,0,0,0,0,0,0,0,0,0,0,0,0,0,0,0,0,0,0
168925,2022,Serbia,Canada,0,0,0,0,24/06/2022,0,0,0,0,0,0,0,0,0,0,0,0,0,0,0,0,0,0,0,0
168925,2022,Poland,Canada,0,0,0,0,23/06/2022,0,0,1,1,0,0,0,0,0,0,0,0,1,1,11,13,3,1,0,4
168925,2022,Australia,Canada,0,0,0,0,21/06/2022,0,0,0,0,0,0,0,0,0,0,0,0,3,1,3,7,0,0,1,1
168925,2022,Bulgaria,Canada,0,0,0,0,12/6/2022,0,1,1,2,0,0,0,0,0,0,0,0,1,2,12,15,7,2,6,15
168925,2022,Canada,Italy,0,0,0,0,11/6/2022,0,0,4,4,0,0,0,0,0,0,0,0,2,0,14,16,4,2,0,6
168925,2022,France,Canada,0,0,0,0,10/6/2022,0,0,0,0,0,0,0,0,0,0,0,0,0,0,0,0,0,0,0,0
168925,2022,Canada,Germany,0,0,0,0,7/6/2022,0,1,3,4,0,0,0,0,0,0,0,0,3,4,17,24,5,3,1,9
168914,2022,Canada,USA,1,0,5,6,9/7/2022,0,0,0,0,7,3,4,14,0,0,1,1,0,0,1,1,0,1,0,1
168914,2022,Japan,Canada,5,2,6,13,8/7/2022,0,0,1,1,5,3,4,12,0,1,2,3,0,0,1,1,2,2,1,5
168914,2022,Canada,Brazil,1,2,7,10,7/7/2022,0,0,2,2,12,2,3,17,0,2,1,3,1,1,3,5,2,0,2,4
168914,2022,Canada,Argentina,0,0,0,0,5/7/2022,0,0,0,0,0,0,0,0,0,0,0,0,0,0,0,0,0,0,0,0
168914,2022,Canada,Iran,0,2,1,3,25/06/2022,0,0,0,0,0,0,0,0,0,0,0,0,0,0,0,0,0,0,0,0
168914,2022,Serbia,Canada,0,2,7,9,24/06/2022,0,0,0,0,0,0,0,0,0,0,0,0,0,0,0,0,1,0,0,1
168914,2022,Poland,Canada,2,3,5,10,23/06/2022,0,0,0,0,2,1,10,13,0,1,0,1,0,0,4,4,2,1,0,3
168914,2022,Australia,Canada,0,1,2,3,21/06/2022,0,0,0,0,2,2,0,4,0,1,0,1,0,0,1,1,0,0,0,0
168914,2022,Bulgaria,Canada,0,2,2,4,12/6/2022,0,0,0,0,0,0,0,0,0,0,0,0,0,0,0,0,1,0,0,1
168914,2022,Canada,Italy,0,0,4,4,11/6/2022,0,0,0,0,1,0,1,2,1,1,0,2,0,0,0,0,2,0,0,2
168914,2022,France,Canada,0,1,0,1,10/6/2022,0,0,0,0,0,0,0,0,0,0,0,0,0,0,0,0,0,0,0,0
168914,2022,Canada,Germany,0,1,2,3,7/6/2022,0,0,0,0,1,0,3,4,0,1,0,1,0,0,0,0,0,1,0,1
157332,2022,Canada,USA,0,4,8,12,9/7/2022,18,0,42,60,1,0,2,3,1,2,0,3,0,0,1,1,4,2,2,8
157332,2022,Japan,Canada,0,0,3,3,8/7/2022,18,0,17,35,0,0,0,0,0,2,2,4,0,0,0,0,3,3,2,8
157332,2022,Canada,Brazil,0,0,0,0,7/7/2022,1,0,6,7,0,0,0,0,0,0,0,0,0,0,0,0,0,0,1,1
157332,2022,Canada,Argentina,0,3,13,16,5/7/2022,32,1,64,97,1,1,0,2,0,1,5,6,0,0,0,0,5,3,0,8
157332,2022,Canada,Iran,0,2,1,3,25/06/2022,6,0,26,32,0,0,0,0,0,1,0,1,0,0,0,0,1,0,1,2
157332,2022,Australia,Canada,0,0,0,0,21/06/2022,7,0,7,14,0,0,0,0,0,0,0,0,0,0,0,0,0,0,0,0
169578,2022,Canada,USA,0,0,0,0,9/7/2022,0,0,0,0,0,0,0,0,0,0,0,0,0,0,0,0,0,0,0,0
169578,2022,Japan,Canada,1,1,9,11,8/7/2022,0,0,0,0,2,1,6,9,1,5,5,11,2,0,0,2,1,0,1,2
169578,2022,Canada,Brazil,0,1,5,6,7/7/2022,0,0,0,0,7,2,3,12,0,5,4,9,0,0,0,0,1,0,1,2
169578,2022,Canada,Argentina,0,0,10,10,5/7/2022,0,0,0,0,5,3,2,10,1,3,5,9,0,0,0,0,1,1,0,2
169578,2022,Canada,Iran,0,0,6,6,25/06/2022,0,0,0,0,3,1,1,5,0,2,0,2,0,0,0,0,0,0,0,0
169578,2022,Serbia,Canada,0,6,8,14,24/06/2022,0,0,0,0,7,2,3,12,2,7,2,11,0,0,3,3,0,1,0,1
169578,2022,Poland,Canada,0,0,0,0,23/06/2022,0,0,0,0,0,0,0,0,0,0,0,0,0,0,0,0,0,0,0,0
169578,2022,Australia,Canada,1,3,8,12,21/06/2022,0,0,0,0,5,2,2,9,1,4,1,6,3,1,0,4,0,1,0,1
169578,2022,Bulgaria,Canada,0,3,6,9,12/6/2022,0,0,1,1,8,0,3,11,4,9,3,16,0,0,1,1,0,1,1,2
169578,2022,Canada,Italy,0,1,5,6,11/6/2022,0,0,0,0,6,0,1,7,2,4,0,6,0,1,2,3,0,0,0,0
169578,2022,France,Canada,0,0,0,0,10/6/2022,0,0,0,0,0,0,0,0,0,0,0,0,0,0,0,0,0,0,0,0
169578,2022,Canada,Germany,0,1,5,6,7/6/2022,0,0,1,1,2,2,0,4,2,4,3,9,1,0,2,3,1,0,0,1
148397,2022,,,-,-,-,-,-,-,-,-,-,-,-,-,-,-,-,-,-,-,-,-,-,-,-,-,-
162251,2022,,,-,-,-,-,-,-,-,-,-,-,-,-,-,-,-,-,-,-,-,-,-,-,-,-,-
168908,2022,Canada,USA,0,0,0,0,9/7/2022,0,0,0,0,0,0,0,0,0,0,0,0,0,0,0,0,0,0,0,0
168908,2022,Japan,Canada,0,2,11,13,8/7/2022,0,0,2,2,9,2,5,16,1,0,1,2,0,0,8,8,1,1,1,3
168908,2022,Canada,Brazil,0,2,4,6,7/7/2022,0,0,3,3,8,0,8,16,0,2,3,5,6,1,16,23,3,3,0,6
168908,2022,Canada,Argentina,0,0,2,2,5/7/2022,0,0,0,0,0,0,0,0,0,0,0,0,0,0,0,0,0,0,0,0
168908,2022,Canada,Iran,0,1,0,1,25/06/2022,0,0,0,0,0,0,0,0,0,0,0,0,0,0,0,0,0,0,0,0
168908,2022,Serbia,Canada,0,3,2,5,24/06/2022,0,0,0,0,0,0,0,0,0,0,0,0,0,0,0,0,0,0,0,0
168908,2022,Poland,Canada,0,1,3,4,23/06/2022,0,0,0,0,6,5,3,14,1,0,0,1,2,2,11,15,0,0,0,0
168908,2022,Australia,Canada,0,2,2,4,21/06/2022,0,0,0,0,0,0,0,0,0,0,0,0,0,0,0,0,0,0,0,0
168908,2022,Bulgaria,Canada,1,2,4,7,12/6/2022,0,0,0,0,0,0,0,0,0,0,0,0,0,0,0,0,0,0,0,0
168908,2022,Canada,Italy,0,0,7,7,11/6/2022,0,0,2,2,2,1,3,6,0,2,0,2,0,0,1,1,0,1,0,1
168908,2022,France,Canada,0,1,4,5,10/6/2022,0,0,1,1,1,0,2,3,0,1,0,1,2,1,6,9,0,1,0,1
168908,2022,Canada,Germany,0,0,3,3,7/6/2022,0,0,0,0,0,0,0,0,0,0,0,0,0,0,0,0,1,0,0,1
182679,2022,Canada,USA,1,3,4,8,9/7/2022,1,0,4,5,7,3,6,16,0,2,0,2,5,2,9,16,2,1,4,7
182679,2022,Japan,Canada,0,0,0,0,8/7/2022,0,0,0,0,0,0,0,0,0,0,1,1,0,0,0,0,0,0,0,0
182679,2022,Canada,Brazil,0,1,0,1,7/7/2022,1,0,1,2,0,1,2,3,0,1,3,4,0,0,1,1,0,0,0,0
182679,2022,Canada,Argentina,0,0,0,0,5/7/2022,0,0,0,0,0,0,0,0,0,0,0,0,0,0,0,0,0,0,0,0
182679,2022,Canada,Iran,0,2,0,2,25/06/2022,0,0,0,0,1,0,1,2,0,1,0,1,0,0,0,0,0,0,1,1
182679,2022,Serbia,Canada,0,1,0,1,24/06/2022,0,0,0,0,0,0,0,0,0,0,0,0,0,0,0,0,0,0,0,0
182679,2022,Poland,Canada,0,2,3,5,23/06/2022,0,0,0,0,6,1,3,10,0,0,0,0,1,1,9,11,1,0,0,1
122004,2022,,,-,-,-,-,-,-,-,-,-,-,-,-,-,-,-,-,-,-,-,-,-,-,-,-,-
142855,2022,,,-,-,-,-,-,-,-,-,-,-,-,-,-,-,-,-,-,-,-,-,-,-,-,-,-
174158,2022,,,-,-,-,-,-,-,-,-,-,-,-,-,-,-,-,-,-,-,-,-,-,-,-,-,-
174295,2022,China,Serbia,0,0,0,0,10/7/2022,0,0,0,0,0,0,0,0,0,0,0,0,8,4,23,35,2,0,1,3
174295,2022,China,Bulgaria,0,0,0,0,9/7/2022,0,0,1,1,0,0,0,0,0,0,0,0,1,1,10,12,1,2,0,3
174295,2022,Poland,China,0,0,0,0,7/7/2022,0,0,0,0,0,0,0,0,0,0,0,0,4,5,8,17,1,1,0,2
174295,2022,Netherlands,China,0,0,0,0,6/7/2022,0,0,3,3,0,0,0,0,0,0,0,0,2,5,9,16,3,2,1,6
174295,2022,Italy,China,0,0,0,0,26/06/2022,1,0,5,6,0,0,0,0,0,0,0,0,1,1,4,6,6,2,1,9
174295,2022,Argentina,China,0,0,0,0,24/06/2022,0,0,7,7,0,0,0,0,0,0,0,0,7,1,23,31,13,2,2,17
174295,2022,China,Germany,0,0,0,0,23/06/2022,0,0,0,0,0,0,0,0,0,0,0,0,0,0,0,0,0,0,0,0
174295,2022,Brazil,China,0,0,0,0,12/6/2022,1,0,0,1,0,0,0,0,0,0,0,0,6,1,14,21,6,1,1,8
174295,2022,Slovenia,China,0,0,0,0,11/6/2022,3,0,2,5,0,0,0,0,0,0,0,0,3,0,12,15,3,3,1,7
174295,2022,Japan,China,0,0,0,0,9/6/2022,3,0,1,4,0,0,0,0,0,0,0,0,5,1,12,18,3,2,0,5
174295,2022,China,Iran,0,0,0,0,7/6/2022,0,0,0,0,0,0,0,0,0,0,0,0,0,0,0,0,0,0,0,0
153610,2022,China,Serbia,0,5,3,8,10/7/2022,0,0,0,0,11,5,5,21,0,0,0,0,1,1,18,20,1,1,2,4
153610,2022,China,Bulgaria,0,1,1,2,9/7/2022,0,0,0,0,0,0,0,0,0,0,0,0,0,0,0,0,0,0,0,0
153610,2022,Poland,China,1,2,3,6,7/7/2022,0,0,0,0,0,0,0,0,0,0,0,0,0,0,0,0,0,0,0,0
153610,2022,Netherlands,China,0,0,2,2,6/7/2022,0,0,1,1,0,2,0,2,0,1,0,1,4,2,6,12,0,0,0,0
153610,2022,Italy,China,0,0,0,0,26/06/2022,0,0,0,0,0,0,0,0,0,0,0,0,0,0,0,0,0,0,0,0
153610,2022,Argentina,China,0,1,6,7,24/06/2022,0,0,0,0,0,0,1,1,0,0,0,0,0,0,0,0,0,0,0,0
153610,2022,China,Germany,0,0,0,0,23/06/2022,0,0,0,0,0,0,0,0,0,0,0,0,0,0,0,0,0,0,0,0
153610,2022,Brazil,China,0,0,0,0,12/6/2022,0,0,0,0,0,0,0,0,0,0,0,0,0,0,0,0,0,0,0,0
153610,2022,Slovenia,China,0,0,1,1,11/6/2022,0,0,0,0,0,0,0,0,0,0,0,0,0,0,0,0,0,0,0,0
153610,2022,Japan,China,0,0,1,1,9/6/2022,0,0,0,0,0,0,0,0,0,0,0,0,0,0,0,0,0,0,0,0
153610,2022,China,Iran,0,0,0,0,7/6/2022,0,0,0,0,0,0,0,0,0,0,0,0,0,0,0,0,0,0,0,0
152518,2022,China,Serbia,0,4,9,13,10/7/2022,0,0,0,0,8,2,5,15,0,2,0,2,1,1,20,22,4,0,2,6
152518,2022,China,Bulgaria,0,2,10,12,9/7/2022,0,0,1,1,9,1,3,13,1,1,0,2,1,1,22,24,3,1,1,5
152518,2022,Poland,China,0,4,5,9,7/7/2022,0,0,1,1,5,1,5,11,0,0,0,0,1,6,7,14,0,1,0,1
152518,2022,Netherlands,China,0,1,5,6,6/7/2022,0,0,0,0,1,1,2,4,0,1,0,1,1,0,5,6,1,0,0,1
152518,2022,Italy,China,0,1,8,9,26/06/2022,0,0,2,2,1,1,6,8,0,1,1,2,3,3,15,21,9,3,0,12
152518,2022,Argentina,China,0,1,11,12,24/06/2022,0,0,1,1,9,2,6,17,0,2,0,2,5,0,5,10,7,2,0,9
152518,2022,China,Germany,0,0,0,0,23/06/2022,0,0,0,0,0,0,0,0,0,0,0,0,0,0,0,0,0,0,0,0
152518,2022,Brazil,China,1,2,11,14,12/6/2022,2,0,0,2,4,2,2,8,1,1,0,2,4,1,11,16,4,0,0,4
152518,2022,Slovenia,China,0,2,10,12,11/6/2022,0,0,2,2,4,1,4,9,2,1,1,4,5,1,19,25,5,0,1,6
152518,2022,Japan,China,0,3,11,14,9/6/2022,1,0,0,1,3,5,8,16,1,3,1,5,6,3,9,18,1,0,0,1
152518,2022,China,Iran,2,1,12,15,7/6/2022,0,0,3,3,13,5,8,26,1,1,0,2,3,3,4,10,2,2,2,6
142593,2022,China,Serbia,0,0,14,14,10/7/2022,14,1,63,78,0,0,0,0,0,2,0,2,0,0,0,0,0,1,2,3
142593,2022,China,Bulgaria,1,0,13,14,9/7/2022,23,0,61,84,2,0,1,3,1,2,0,3,1,0,0,1,2,1,0,3
142593,2022,Poland,China,1,3,3,7,7/7/2022,15,0,41,56,1,0,0,1,1,1,0,2,0,0,0,0,0,2,0,2
142593,2022,Netherlands,China,0,1,8,9,6/7/2022,12,1,46,59,3,0,1,4,2,4,0,6,0,0,1,1,2,3,1,6
142593,2022,Italy,China,1,1,9,11,26/06/2022,5,0,47,52,1,0,0,1,0,0,3,3,0,0,0,0,4,2,2,8
142593,2022,Argentina,China,0,3,7,10,24/06/2022,12,0,59,71,0,0,0,0,2,2,0,4,0,0,1,1,2,2,2,6
142593,2022,China,Germany,0,0,0,0,23/06/2022,0,0,0,0,0,0,0,0,0,0,0,0,0,0,0,0,0,0,0,0
142593,2022,Brazil,China,0,1,13,14,12/6/2022,26,0,46,72,1,0,0,1,3,2,3,8,0,0,0,0,2,1,1,4
142593,2022,Slovenia,China,0,3,8,11,11/6/2022,17,1,30,48,0,0,2,2,0,2,2,4,0,0,0,0,2,0,2,4
142593,2022,Japan,China,0,2,7,9,9/6/2022,8,1,24,33,0,0,0,0,0,2,2,4,0,0,0,0,2,1,0,3
142593,2022,China,Iran,0,2,6,8,7/6/2022,18,1,20,39,0,0,0,0,0,2,1,3,0,0,0,0,4,1,0,5
168272,2022,China,Serbia,0,0,0,0,10/7/2022,0,0,0,0,0,0,0,0,0,0,0,0,0,0,0,0,1,0,0,1
168272,2022,China,Bulgaria,0,0,0,0,9/7/2022,0,0,0,0,0,0,0,0,0,0,0,0,4,0,3,7,2,2,1,5
168272,2022,Poland,China,0,0,0,0,7/7/2022,0,0,1,1,0,0,0,0,0,0,0,0,2,0,7,9,2,0,0,2
168272,2022,Netherlands,China,0,0,0,0,6/7/2022,0,0,0,0,0,0,0,0,0,0,0,0,0,0,0,0,0,0,0,0
168272,2022,Italy,China,0,0,0,0,26/06/2022,0,0,0,0,0,0,0,0,0,0,0,0,0,0,0,0,0,0,0,0
168272,2022,Argentina,China,0,0,0,0,24/06/2022,0,0,0,0,0,0,0,0,0,0,0,0,0,0,0,0,0,0,0,0
168272,2022,China,Germany,0,0,0,0,23/06/2022,0,0,0,0,0,0,0,0,0,0,0,0,0,0,0,0,0,0,0,0
168272,2022,Brazil,China,0,0,0,0,12/6/2022,1,0,0,1,0,0,0,0,0,0,0,0,0,0,0,0,0,0,0,0
168272,2022,Slovenia,China,0,0,0,0,11/6/2022,0,0,0,0,0,0,0,0,0,0,0,0,0,0,0,0,0,0,0,0
168272,2022,Japan,China,0,0,0,0,9/6/2022,3,0,0,3,0,0,0,0,0,0,0,0,0,0,0,0,2,2,0,4
168272,2022,China,Iran,0,0,0,0,7/6/2022,0,1,2,3,0,0,0,0,0,0,0,0,6,5,16,27,3,1,2,6
181103,2022,China,Serbia,1,1,11,13,10/7/2022,0,0,0,0,5,4,2,11,5,5,1,11,0,0,0,0,0,0,0,0
181103,2022,China,Bulgaria,2,3,15,20,9/7/2022,0,0,1,1,9,0,1,10,2,7,0,9,0,0,2,2,0,0,0,0
181103,2022,Poland,China,0,0,0,0,7/7/2022,0,0,0,0,0,0,0,0,0,0,0,0,0,0,0,0,0,0,0,0
181103,2022,Netherlands,China,0,0,0,0,6/7/2022,0,0,0,0,0,0,0,0,0,0,0,0,0,0,0,0,0,0,0,0
181103,2022,Italy,China,0,1,7,8,26/06/2022,0,0,2,2,4,2,2,8,2,5,1,8,0,0,1,1,1,0,0,1
181103,2022,Argentina,China,1,3,9,13,24/06/2022,0,0,3,3,4,1,3,8,1,4,4,9,0,0,0,0,0,0,0,0
181103,2022,China,Germany,0,0,0,0,23/06/2022,0,0,0,0,0,0,0,0,0,0,0,0,0,0,0,0,0,0,0,0
181103,2022,Brazil,China,0,2,7,9,12/6/2022,0,0,0,0,4,1,0,5,3,4,3,10,0,0,0,0,1,1,0,2
181103,2022,Slovenia,China,0,3,9,12,11/6/2022,0,1,0,1,6,3,1,10,2,7,4,13,0,0,0,0,1,0,0,1
181103,2022,Japan,China,0,4,9,13,9/6/2022,0,0,0,0,6,2,3,11,3,10,2,15,0,1,0,1,1,0,0,1
181103,2022,China,Iran,0,4,10,14,7/6/2022,0,2,0,2,5,1,1,7,3,5,2,10,0,0,1,1,0,0,1,1
158965,2022,Brazil,China,0,0,0,0,12/6/2022,0,0,0,0,0,0,0,0,0,0,0,0,0,0,0,0,0,0,0,0
158965,2022,Slovenia,China,0,0,0,0,11/6/2022,0,0,0,0,0,0,0,0,0,0,0,0,0,0,0,0,0,0,0,0
158965,2022,Japan,China,0,2,2,4,9/6/2022,13,0,15,28,1,0,2,3,0,0,0,0,0,0,0,0,2,0,0,2
158965,2022,China,Iran,1,1,1,3,7/6/2022,3,0,4,7,0,0,0,0,0,0,0,0,0,0,0,0,0,0,0,0
152526,2022,China,Serbia,0,0,0,0,10/7/2022,0,0,0,0,0,0,0,0,0,0,0,0,0,0,0,0,0,0,0,0
152526,2022,China,Bulgaria,0,0,0,0,9/7/2022,0,0,0,0,0,0,0,0,0,1,0,1,0,0,0,0,0,0,0,0
152526,2022,Poland,China,0,1,7,8,7/7/2022,0,0,1,1,4,0,0,4,4,1,0,5,0,0,1,1,0,0,0,0
152526,2022,Netherlands,China,0,0,8,8,6/7/2022,0,0,0,0,3,0,1,4,1,4,0,5,0,0,0,0,0,1,0,1
152526,2022,Italy,China,0,0,2,2,26/06/2022,0,0,0,0,0,0,0,0,0,0,1,1,0,0,0,0,1,0,0,1
152526,2022,Argentina,China,0,2,8,10,24/06/2022,0,0,1,1,5,1,4,10,3,2,4,9,0,0,0,0,2,1,0,3
152526,2022,China,Germany,0,0,0,0,23/06/2022,0,0,0,0,0,0,0,0,0,0,0,0,0,0,0,0,0,0,0,0
152526,2022,Brazil,China,0,0,0,0,12/6/2022,0,0,0,0,0,0,0,0,0,0,0,0,0,0,0,0,0,0,0,0
152526,2022,Slovenia,China,0,0,0,0,11/6/2022,0,0,0,0,0,0,0,0,0,0,0,0,0,0,0,0,0,0,0,0
152526,2022,Japan,China,0,0,0,0,9/6/2022,0,0,0,0,0,0,0,0,0,0,0,0,0,0,0,0,0,0,0,0
152526,2022,China,Iran,0,0,0,0,7/6/2022,0,0,0,0,0,0,0,0,0,0,0,0,0,0,0,0,0,0,0,0
142581,2022,,,-,-,-,-,-,-,-,-,-,-,-,-,-,-,-,-,-,-,-,-,-,-,-,-,-
152511,2022,,,-,-,-,-,-,-,-,-,-,-,-,-,-,-,-,-,-,-,-,-,-,-,-,-,-
173184,2022,,,-,-,-,-,-,-,-,-,-,-,-,-,-,-,-,-,-,-,-,-,-,-,-,-,-
168175,2022,China,Serbia,0,4,9,13,10/7/2022,0,0,1,1,7,0,2,9,2,1,0,3,0,0,0,0,0,1,0,1
168175,2022,China,Bulgaria,3,3,12,18,9/7/2022,0,0,1,1,10,1,2,13,1,6,0,7,0,1,1,2,0,0,0,0
168175,2022,Poland,China,0,1,9,10,7/7/2022,0,0,0,0,5,0,1,6,3,3,0,6,0,0,0,0,1,0,0,1
168175,2022,Netherlands,China,0,1,8,9,6/7/2022,0,0,0,0,3,2,4,9,1,3,0,4,0,0,3,3,2,1,0,3
168175,2022,Italy,China,2,1,8,11,26/06/2022,0,0,0,0,2,3,4,9,0,2,3,5,0,0,0,0,1,0,0,1
168175,2022,China,Germany,0,0,0,0,23/06/2022,0,0,0,0,0,0,0,0,0,0,0,0,0,0,0,0,0,0,0,0
168175,2022,Brazil,China,1,1,16,18,12/6/2022,0,0,0,0,3,2,2,7,1,3,1,5,0,0,0,0,0,0,1,1
168175,2022,Slovenia,China,0,1,12,13,11/6/2022,0,0,0,0,6,3,3,12,4,6,1,11,0,0,0,0,1,0,0,1
168175,2022,Japan,China,0,1,13,14,9/6/2022,0,0,0,0,7,1,0,8,3,5,7,15,0,0,1,1,1,0,0,1
168175,2022,China,Iran,0,1,10,11,7/6/2022,0,0,3,3,2,0,3,5,1,2,3,6,0,0,1,1,2,0,0,2
174297,2022,China,Serbia,0,1,3,4,10/7/2022,4,0,15,19,0,0,0,0,0,0,0,0,0,0,0,0,0,0,0,0
174297,2022,China,Bulgaria,0,0,0,0,9/7/2022,0,0,0,0,0,0,0,0,0,0,0,0,0,0,0,0,0,0,0,0
174297,2022,Poland,China,0,0,0,0,7/7/2022,0,0,0,0,0,0,0,0,0,0,0,0,0,0,0,0,0,0,0,0
174297,2022,Netherlands,China,0,0,0,0,6/7/2022,0,0,3,3,0,0,0,0,0,0,0,0,0,0,0,0,0,0,0,0
174297,2022,Italy,China,0,0,3,3,26/06/2022,4,0,12,16,0,0,0,0,1,0,0,1,0,0,0,0,1,0,0,1
174297,2022,Argentina,China,0,1,1,2,24/06/2022,2,0,12,14,1,0,1,2,0,0,1,1,0,0,0,0,3,0,0,3
174297,2022,China,Germany,0,0,0,0,23/06/2022,0,0,0,0,0,0,0,0,0,0,0,0,0,0,0,0,0,0,0,0
174297,2022,Brazil,China,0,0,0,0,12/6/2022,0,0,0,0,0,0,0,0,0,0,0,0,0,0,0,0,0,0,0,0
174297,2022,Slovenia,China,0,0,4,4,11/6/2022,17,2,16,35,0,0,0,0,0,2,3,5,0,0,0,0,3,0,0,3
174297,2022,Japan,China,0,1,1,2,9/6/2022,4,0,5,9,0,0,0,0,0,0,0,0,0,0,0,0,0,0,0,0
174297,2022,China,Iran,0,0,0,0,7/6/2022,0,0,0,0,0,0,0,0,0,0,0,0,0,0,0,0,0,0,0,0
152513,2022,China,Serbia,0,2,2,4,10/7/2022,0,0,0,0,4,3,4,11,0,0,0,0,0,0,0,0,1,0,0,1
152513,2022,China,Bulgaria,0,5,4,9,9/7/2022,0,0,0,0,14,3,2,19,1,1,0,2,0,0,0,0,2,0,0,2
152513,2022,Poland,China,0,0,0,0,7/7/2022,0,0,0,0,0,0,0,0,0,0,0,0,0,0,0,0,0,0,0,0
152513,2022,Netherlands,China,0,0,0,0,6/7/2022,0,0,0,0,0,0,0,0,0,0,0,0,0,0,0,0,0,0,0,0
152513,2022,Italy,China,0,1,2,3,26/06/2022,0,0,1,1,2,4,4,10,0,0,0,0,0,0,0,0,0,0,1,1
152513,2022,Argentina,China,0,3,8,11,24/06/2022,0,0,2,2,14,7,8,29,0,1,1,2,0,0,0,0,2,0,1,3
152513,2022,China,Germany,0,0,0,0,23/06/2022,0,0,0,0,0,0,0,0,0,0,0,0,0,0,0,0,0,0,0,0
162272,2022,China,Serbia,0,0,0,0,10/7/2022,0,0,0,0,0,0,0,0,0,0,0,0,0,0,0,0,0,0,0,0
162272,2022,China,Bulgaria,0,0,0,0,9/7/2022,0,0,0,0,0,0,0,0,0,0,0,0,0,0,0,0,0,0,0,0
162272,2022,Poland,China,0,0,0,0,7/7/2022,0,0,0,0,0,0,0,0,0,0,0,0,0,0,0,0,0,0,0,0
162272,2022,Netherlands,China,0,0,4,4,6/7/2022,0,0,0,0,1,0,3,4,0,1,0,1,1,1,6,8,1,0,0,1
162272,2022,Italy,China,0,0,0,0,26/06/2022,0,0,0,0,0,0,0,0,0,0,0,0,0,0,0,0,0,0,0,0
162272,2022,Argentina,China,0,2,3,5,24/06/2022,0,0,1,1,0,0,1,1,0,1,0,1,1,1,3,5,0,1,0,1
162272,2022,China,Germany,0,0,0,0,23/06/2022,0,0,0,0,0,0,0,0,0,0,0,0,0,0,0,0,0,0,0,0
162272,2022,Brazil,China,0,0,0,0,12/6/2022,0,0,0,0,0,0,0,0,0,0,0,0,0,0,0,0,0,0,0,0
162272,2022,Slovenia,China,0,0,0,0,11/6/2022,0,0,0,0,0,0,0,0,0,0,0,0,0,0,0,0,0,0,0,0
162272,2022,Japan,China,0,0,0,0,9/6/2022,0,0,0,0,0,0,0,0,0,0,0,0,0,1,1,2,0,0,0,0
162272,2022,China,Iran,0,0,0,0,7/6/2022,0,0,0,0,0,0,0,0,0,0,0,0,0,0,0,0,0,0,0,0
182707,2022,China,Serbia,0,3,3,6,10/7/2022,0,0,1,1,5,4,5,14,0,0,1,1,0,0,0,0,0,1,1,2
182707,2022,China,Bulgaria,0,1,3,4,9/7/2022,0,0,0,0,2,3,5,10,1,1,0,2,0,0,0,0,0,0,0,0
182707,2022,Poland,China,0,2,7,9,7/7/2022,0,0,0,0,9,1,9,19,0,0,0,0,0,0,0,0,1,1,0,2
182707,2022,Netherlands,China,0,2,5,7,6/7/2022,0,0,0,0,11,5,4,20,1,0,0,1,0,0,0,0,3,0,0,3
182707,2022,Italy,China,0,0,5,5,26/06/2022,0,0,1,1,10,3,5,18,1,1,2,4,0,0,0,0,2,1,0,3
182707,2022,Argentina,China,0,1,3,4,24/06/2022,0,0,0,0,4,1,4,9,0,2,0,2,0,0,0,0,0,0,0,0
182707,2022,China,Germany,0,0,0,0,23/06/2022,0,0,0,0,0,0,0,0,0,0,0,0,0,0,0,0,0,0,0,0
182707,2022,Brazil,China,0,3,8,11,12/6/2022,0,0,1,1,9,3,6,18,0,1,0,1,0,0,0,0,4,0,0,4
182707,2022,Slovenia,China,1,2,14,17,11/6/2022,3,0,2,5,13,2,11,26,1,3,0,4,0,0,1,1,5,0,1,6
182707,2022,Japan,China,0,2,10,12,9/6/2022,0,0,0,0,7,1,7,15,1,1,2,4,0,0,0,0,2,1,0,3
182707,2022,China,Iran,0,3,9,12,7/6/2022,0,0,0,0,9,5,8,22,1,0,1,2,0,0,0,0,3,0,0,3
189181,2022,,,-,-,-,-,-,-,-,-,-,-,-,-,-,-,-,-,-,-,-,-,-,-,-,-,-
153096,2022,China,Serbia,0,0,0,0,10/7/2022,0,0,0,0,0,0,0,0,0,0,0,0,0,0,0,0,0,0,0,0
153096,2022,China,Bulgaria,0,0,0,0,9/7/2022,0,0,0,0,0,0,0,0,0,0,0,0,0,0,0,0,0,0,0,0
153096,2022,Poland,China,0,0,0,0,7/7/2022,0,0,0,0,0,0,0,0,0,0,0,0,0,0,0,0,0,0,0,0
153096,2022,Netherlands,China,0,0,0,0,6/7/2022,0,0,0,0,0,0,0,0,0,0,0,0,0,0,0,0,0,0,0,0
153096,2022,Italy,China,0,0,0,0,26/06/2022,0,0,0,0,0,0,0,0,0,0,0,0,0,0,0,0,0,0,0,0
153096,2022,Argentina,China,0,0,2,2,24/06/2022,0,0,0,0,0,0,1,1,0,3,1,4,0,0,0,0,0,1,0,1
153096,2022,China,Germany,0,0,0,0,23/06/2022,0,0,0,0,0,0,0,0,0,0,0,0,0,0,0,0,0,0,0,0
153096,2022,Brazil,China,0,1,0,1,12/6/2022,0,0,0,0,0,0,0,0,0,0,0,0,0,0,0,0,0,0,0,0
153096,2022,Slovenia,China,0,0,0,0,11/6/2022,0,0,0,0,0,0,0,0,0,0,0,0,0,0,0,0,0,0,0,0
153096,2022,Japan,China,0,0,0,0,9/6/2022,0,0,0,0,0,0,0,0,0,0,0,0,0,0,0,0,0,0,0,0
153096,2022,China,Iran,0,0,1,1,7/6/2022,0,0,0,0,1,0,1,2,0,1,1,2,0,0,0,0,0,0,0,0
168271,2022,China,Serbia,1,1,5,7,10/7/2022,0,0,0,0,8,4,3,15,0,0,0,0,1,0,8,9,1,0,0,1
168271,2022,China,Bulgaria,1,1,19,21,9/7/2022,0,0,3,3,16,6,4,26,1,5,0,6,5,0,26,31,2,1,1,4
168271,2022,Poland,China,0,3,7,10,7/7/2022,0,0,0,0,10,6,3,19,0,0,0,0,5,1,18,24,1,1,1,3
168271,2022,Netherlands,China,0,0,9,9,6/7/2022,0,0,1,1,11,9,8,28,1,2,0,3,6,2,12,20,3,0,0,3
168271,2022,Italy,China,0,2,5,7,26/06/2022,0,0,0,0,11,3,10,24,0,6,3,9,6,3,22,31,1,1,0,2
168271,2022,Argentina,China,1,1,14,16,24/06/2022,0,0,2,2,17,3,9,29,0,4,2,6,8,1,19,28,5,2,2,9
168271,2022,China,Germany,0,0,0,0,23/06/2022,0,0,0,0,0,0,0,0,0,0,0,0,0,0,0,0,0,0,0,0
168271,2022,Brazil,China,2,1,9,12,12/6/2022,0,0,0,0,22,5,13,40,1,7,3,11,5,2,20,27,5,0,0,5
168271,2022,Slovenia,China,2,0,14,16,11/6/2022,0,0,1,1,18,7,11,36,0,6,1,7,11,1,26,38,4,4,0,8
168271,2022,Japan,China,0,3,10,13,9/6/2022,0,0,0,0,13,3,10,26,2,2,1,5,7,2,20,29,5,1,2,8
168271,2022,China,Iran,2,0,11,13,7/6/2022,0,0,2,2,14,3,2,19,0,1,0,1,5,6,28,39,4,2,1,7
181102,2022,,,-,-,-,-,-,-,-,-,-,-,-,-,-,-,-,-,-,-,-,-,-,-,-,-,-
162470,2022,,,-,-,-,-,-,-,-,-,-,-,-,-,-,-,-,-,-,-,-,-,-,-,-,-,-
174159,2022,,,-,-,-,-,-,-,-,-,-,-,-,-,-,-,-,-,-,-,-,-,-,-,-,-,-
152494,2022,France,USA,0,3,9,12,24/07/2022,0,0,0,0,5,1,2,8,1,2,4,7,0,0,1,1,0,0,1,1
152494,2022,Italy,France,0,3,5,8,23/07/2022,0,0,0,0,5,0,0,5,3,1,2,6,1,0,0,1,1,0,0,1
152494,2022,France,Japan,0,5,5,10,21/07/2022,0,0,0,0,5,0,1,6,1,3,0,4,1,0,1,2,2,0,0,2
152494,2022,Australia,France,0,0,0,0,10/7/2022,0,0,0,0,0,0,0,0,0,0,0,0,0,0,0,0,0,0,0,0
152494,2022,France,Argentina,0,0,0,0,9/7/2022,0,0,0,0,0,0,0,0,0,0,0,0,0,0,0,0,0,0,0,0
152494,2022,France,Brazil,1,1,8,10,8/7/2022,0,0,0,0,7,0,6,13,3,4,6,13,0,0,2,2,2,0,1,3
152494,2022,France,USA,2,9,6,17,7/7/2022,0,0,2,2,8,2,3,13,2,3,3,8,1,0,1,2,4,1,3,8
152494,2022,Germany,France,0,0,0,0,26/06/2022,0,0,0,0,0,0,0,0,0,0,0,0,0,0,0,0,0,0,0,0
152494,2022,Japan,France,1,3,7,11,25/06/2022,0,1,2,3,6,0,6,12,0,2,6,8,0,0,3,3,4,0,0,4
152494,2022,France,Netherlands,1,2,4,7,23/06/2022,0,0,1,1,10,0,2,12,1,4,1,6,0,0,1,1,2,0,0,2
152494,2022,France,Poland,1,3,6,10,12/6/2022,0,0,0,0,4,1,1,6,1,3,5,9,0,0,1,1,2,0,2,4
152494,2022,France,Canada,0,4,3,7,10/6/2022,0,0,0,0,9,2,1,12,5,1,5,11,0,0,0,0,1,0,1,2
152494,2022,Serbia,France,0,1,9,10,9/6/2022,0,0,1,1,9,1,2,12,0,9,8,17,0,0,0,0,1,2,0,3
152494,2022,France,Italy,1,3,5,9,8/6/2022,0,0,0,0,7,0,6,13,3,3,7,13,0,1,2,3,1,1,0,2
119792,2022,France,USA,0,0,0,0,24/07/2022,1,0,10,11,0,0,0,0,0,0,0,0,5,0,15,20,12,3,0,15
119792,2022,Italy,France,0,0,0,0,23/07/2022,0,0,5,5,0,0,0,0,0,0,0,0,6,0,7,13,6,0,2,8
119792,2022,France,Japan,0,0,0,0,21/07/2022,0,0,5,5,0,0,0,0,0,0,0,0,5,1,2,8,3,1,2,6
119791,2022,Germany,France,3,7,12,22,26/06/2022,18,0,56,74,0,0,0,0,0,1,4,5,0,0,0,0,4,2,0,6
119791,2022,Japan,France,0,0,0,0,25/06/2022,3,0,5,8,1,0,0,1,0,0,0,0,0,0,0,0,0,0,1,1
119791,2022,France,Netherlands,0,0,0,0,23/06/2022,1,0,0,1,0,0,0,0,0,0,0,0,0,0,0,0,0,0,0,0
119791,2022,France,Poland,0,1,1,2,12/6/2022,0,0,0,0,0,0,0,0,0,0,0,0,0,0,0,0,0,0,0,0
119791,2022,France,Canada,0,2,11,13,10/6/2022,31,0,33,64,0,0,1,1,1,0,1,2,0,0,0,0,4,1,1,6
119791,2022,Serbia,France,1,1,2,4,9/6/2022,0,0,0,0,0,0,0,0,0,0,0,0,0,0,0,0,0,0,0,0
119791,2022,France,Italy,0,0,1,1,8/6/2022,0,0,0,0,0,0,0,0,0,0,0,0,0,0,0,0,0,1,0,1
142694,2022,France,USA,0,0,16,16,24/07/2022,1,0,1,2,17,2,9,28,0,5,1,6,0,0,1,1,2,1,2,5
142694,2022,Italy,France,3,4,6,13,23/07/2022,0,1,0,1,12,3,8,23,1,1,0,2,0,0,0,0,5,4,1,10
142694,2022,France,Japan,0,2,9,11,21/07/2022,0,0,0,0,18,2,6,26,1,1,3,5,0,0,0,0,4,0,1,5
142694,2022,Australia,France,0,0,0,0,10/7/2022,0,0,0,0,0,0,0,0,0,0,0,0,0,0,0,0,0,0,0,0
142694,2022,France,Argentina,2,2,7,11,9/7/2022,0,0,2,2,8,2,10,20,1,1,3,5,0,0,0,0,1,1,1,3
142694,2022,France,Brazil,3,6,4,13,8/7/2022,0,0,1,1,16,1,11,28,0,2,2,4,0,0,0,0,2,1,2,5
142694,2022,France,USA,1,2,4,7,7/7/2022,0,0,0,0,4,4,2,10,0,2,1,3,0,0,0,0,0,1,0,1
142694,2022,Germany,France,0,0,0,0,26/06/2022,0,0,0,0,0,0,0,0,0,0,0,0,0,0,0,0,0,0,0,0
142694,2022,Japan,France,1,2,9,12,25/06/2022,0,0,2,2,10,1,14,25,3,1,1,5,0,0,0,0,6,2,0,8
142694,2022,France,Netherlands,0,1,1,2,23/06/2022,0,0,0,0,0,0,0,0,0,0,0,0,0,0,0,0,0,0,0,0
142694,2022,France,Poland,0,2,10,12,12/6/2022,0,0,3,3,16,5,16,37,2,2,1,5,0,0,0,0,1,3,0,4
142694,2022,France,Canada,1,3,13,17,10/6/2022,0,0,0,0,7,2,12,21,0,2,0,2,0,0,0,0,2,0,6,8
142694,2022,Serbia,France,0,0,0,0,9/6/2022,0,0,0,0,0,0,0,0,0,0,0,0,0,0,0,0,0,0,0,0
142694,2022,France,Italy,0,0,12,12,8/6/2022,0,1,0,1,7,4,10,21,2,1,6,9,0,0,0,0,2,1,2,5
142691,2022,Australia,France,0,0,0,0,10/7/2022,0,0,0,0,0,0,0,0,0,0,0,0,0,0,0,0,0,0,0,0
142691,2022,France,Argentina,0,0,0,0,9/7/2022,0,0,0,0,0,0,0,0,0,0,0,0,8,0,21,29,6,7,3,16
142691,2022,France,Brazil,0,0,0,0,8/7/2022,0,0,0,0,0,0,0,0,0,0,0,0,0,0,0,0,0,0,0,0
142691,2022,France,USA,0,0,0,0,7/7/2022,0,0,0,0,0,0,0,0,0,0,0,0,0,0,0,0,0,0,1,1
142691,2022,Germany,France,0,0,0,0,26/06/2022,0,0,2,2,0,0,0,0,0,0,0,0,2,1,13,16,4,1,0,5
142691,2022,Japan,France,0,0,0,0,25/06/2022,0,0,0,0,0,0,0,0,0,0,0,0,0,0,0,0,0,0,0,0
142691,2022,France,Netherlands,0,0,0,0,23/06/2022,0,0,0,0,0,0,0,0,0,0,0,0,0,0,0,0,0,0,0,0
142691,2022,France,Poland,0,0,0,0,12/6/2022,0,0,0,0,0,0,0,0,0,0,0,0,0,0,0,0,0,0,0,0
142691,2022,France,Canada,0,0,0,0,10/6/2022,0,0,5,5,0,0,0,0,0,0,0,0,2,0,9,11,8,4,1,13
142691,2022,Serbia,France,0,0,0,0,9/6/2022,0,0,0,0,0,0,0,0,0,0,0,0,0,0,0,0,0,0,0,0
142691,2022,France,Italy,0,0,0,0,8/6/2022,0,0,0,0,0,0,0,0,0,0,0,0,0,0,0,0,0,0,0,0
119804,2022,France,USA,0,0,0,0,24/07/2022,1,1,7,9,0,0,0,0,0,0,0,0,0,0,0,0,0,0,0,0
119804,2022,Italy,France,0,0,0,0,23/07/2022,0,0,0,0,0,0,0,0,0,0,0,0,0,0,0,0,0,0,0,0
119804,2022,France,Japan,0,0,0,0,21/07/2022,0,0,0,0,0,0,0,0,0,0,0,0,0,0,0,0,0,0,0,0
119804,2022,Australia,France,0,0,0,0,10/7/2022,0,0,0,0,0,0,0,0,0,0,0,0,0,0,0,0,0,0,0,0
119804,2022,France,Argentina,0,1,6,7,9/7/2022,14,0,58,72,0,0,0,0,0,2,4,6,0,0,0,0,4,3,2,9
119804,2022,France,Brazil,0,0,0,0,8/7/2022,0,0,0,0,0,0,0,0,0,0,0,0,0,0,0,0,0,0,0,0
119804,2022,France,USA,0,0,9,9,7/7/2022,23,0,53,76,0,0,1,1,0,0,3,3,0,0,0,0,4,2,5,11
119804,2022,Germany,France,0,0,0,0,26/06/2022,0,0,0,0,0,0,0,0,0,0,0,0,0,0,0,0,0,0,0,0
119804,2022,Japan,France,0,0,7,7,25/06/2022,16,0,43,59,0,0,0,0,0,1,0,1,0,0,0,0,5,1,1,7
119804,2022,France,Netherlands,0,1,13,14,23/06/2022,14,0,38,52,0,0,0,0,1,2,5,8,0,0,0,0,3,1,0,4
124518,2022,France,Poland,0,0,0,0,12/6/2022,0,0,0,0,0,0,0,0,0,0,0,0,0,0,0,0,0,0,0,0
124518,2022,France,Canada,0,0,0,0,10/6/2022,0,0,0,0,0,0,0,0,0,0,0,0,0,0,0,0,0,0,0,0
124518,2022,Serbia,France,0,0,0,0,9/6/2022,0,0,0,0,0,0,0,0,0,0,0,0,0,0,0,0,0,0,0,0
124518,2022,France,Italy,0,2,1,3,8/6/2022,0,0,0,0,2,2,3,7,0,2,0,2,0,0,4,4,2,2,0,4
119800,2022,France,USA,0,6,12,18,24/07/2022,0,0,5,5,21,5,13,39,1,2,0,3,10,1,20,31,5,1,1,7
119800,2022,Italy,France,4,4,5,13,23/07/2022,0,0,3,3,10,2,5,17,0,4,2,6,9,1,10,20,7,2,0,9
119800,2022,France,Japan,0,0,0,0,21/07/2022,0,0,0,0,0,0,0,0,0,0,0,0,0,0,0,0,0,0,0,0
119800,2022,Australia,France,0,2,7,9,10/7/2022,0,1,1,2,4,0,1,5,0,1,0,1,3,0,9,12,4,0,0,4
119800,2022,France,Argentina,0,2,4,6,9/7/2022,0,0,1,1,0,0,0,0,0,0,0,0,0,0,0,0,3,0,0,3
119800,2022,France,Brazil,2,5,4,11,8/7/2022,0,0,4,4,12,0,8,20,0,3,1,4,5,0,12,17,3,0,1,4
119800,2022,France,USA,1,4,15,20,7/7/2022,0,1,17,18,16,3,9,28,2,1,0,3,3,2,16,21,11,4,2,17
119800,2022,Germany,France,0,4,11,15,26/06/2022,1,0,2,3,16,4,7,27,2,1,0,3,4,0,4,8,9,1,2,12
119800,2022,Japan,France,0,0,0,0,25/06/2022,0,0,0,0,0,0,0,0,0,0,0,0,0,0,0,0,0,0,0,0
119800,2022,France,Netherlands,1,1,9,11,23/06/2022,0,0,4,4,7,1,5,13,0,1,1,2,5,0,4,9,4,0,0,4
119800,2022,France,Poland,0,4,9,13,12/6/2022,0,1,4,5,8,6,8,22,0,6,1,7,4,0,10,14,7,0,3,10
119800,2022,France,Canada,2,1,1,4,10/6/2022,0,0,0,0,0,0,1,1,0,0,0,0,0,0,0,0,1,0,0,1
119800,2022,Serbia,France,3,6,8,17,9/6/2022,1,0,7,8,11,4,13,28,2,6,1,9,9,0,14,23,5,3,1,9
119800,2022,France,Italy,1,2,15,18,8/6/2022,0,0,7,7,11,3,4,18,1,3,0,4,6,0,10,16,5,2,4,11
136851,2022,France,USA,3,2,16,21,24/07/2022,14,0,64,78,2,0,0,2,0,5,3,8,0,0,0,0,5,2,0,7
136851,2022,Italy,France,2,1,9,12,23/07/2022,15,0,46,61,1,0,0,1,0,1,2,3,0,0,0,0,5,3,0,8
136851,2022,France,Japan,2,4,6,12,21/07/2022,18,1,37,56,2,0,1,3,0,0,2,2,0,0,0,0,6,3,0,9
136851,2022,Australia,France,0,3,8,11,10/7/2022,18,0,42,60,2,0,3,5,3,1,3,7,0,0,0,0,0,3,2,5
136851,2022,France,Argentina,0,1,1,2,9/7/2022,5,0,12,17,0,0,1,1,1,0,0,1,0,0,0,0,1,1,0,2
136851,2022,France,Brazil,1,3,7,11,8/7/2022,24,1,50,75,1,1,0,2,1,1,2,4,0,0,1,1,1,1,2,4
136851,2022,France,USA,0,0,0,0,7/7/2022,4,0,17,21,0,0,1,1,0,0,1,1,0,0,0,0,0,1,0,1
136851,2022,France,Poland,6,3,9,18,12/6/2022,42,2,43,87,3,0,1,4,2,1,5,8,0,0,1,1,7,2,3,12
136851,2022,France,Canada,0,0,0,0,10/6/2022,0,0,0,0,0,0,0,0,0,0,0,0,0,0,0,0,0,0,0,0
136851,2022,Serbia,France,1,4,12,17,9/6/2022,53,0,38,91,3,0,1,4,2,1,5,8,0,0,0,0,2,1,2,5
136851,2022,France,Italy,0,3,12,15,8/6/2022,48,0,25,73,3,0,2,5,0,2,1,3,0,0,0,0,4,2,3,9
142710,2022,France,USA,0,0,0,0,24/07/2022,0,0,0,0,0,1,1,2,0,0,0,0,0,0,0,0,0,0,0,0
142710,2022,Italy,France,0,0,0,0,23/07/2022,0,0,0,0,0,0,0,0,0,0,0,0,0,0,0,0,0,0,0,0
142710,2022,France,Japan,0,0,0,0,21/07/2022,0,0,0,0,0,0,0,0,0,0,0,0,0,0,0,0,0,0,0,0
142710,2022,Australia,France,2,3,13,18,10/7/2022,0,0,0,0,16,3,6,25,1,0,0,1,0,0,0,0,4,2,0,6
142710,2022,France,Argentina,0,3,5,8,9/7/2022,0,0,2,2,13,1,7,21,0,4,1,5,0,0,0,0,5,2,2,9
142710,2022,France,Brazil,0,0,0,0,8/7/2022,0,0,0,0,0,0,0,0,0,0,0,0,0,0,0,0,0,0,0,0
142710,2022,France,USA,1,6,7,14,7/7/2022,0,0,1,1,13,6,12,31,0,0,5,5,0,0,1,1,7,1,4,12
142710,2022,Germany,France,1,7,5,13,26/06/2022,0,0,0,0,14,6,7,27,1,5,1,7,0,0,0,0,6,2,1,9
142710,2022,Japan,France,0,1,4,5,25/06/2022,0,0,1,1,3,0,3,6,0,1,0,1,0,0,0,0,3,0,0,3
142710,2022,France,Netherlands,0,3,11,14,23/06/2022,0,0,0,0,11,1,5,17,4,2,4,10,0,0,0,0,3,1,0,4
142710,2022,France,Poland,0,0,0,0,12/6/2022,0,0,0,0,0,0,0,0,0,0,0,0,0,0,0,0,0,0,0,0
142710,2022,France,Canada,0,0,0,0,10/6/2022,0,0,0,0,0,0,0,0,0,0,0,0,0,0,0,0,0,0,0,0
142710,2022,Serbia,France,2,2,14,18,9/6/2022,0,0,1,1,19,4,22,45,3,3,2,8,0,0,0,0,6,5,0,11
142710,2022,France,Italy,0,0,0,0,8/6/2022,0,0,0,0,0,0,0,0,0,0,0,0,0,0,0,0,0,0,0,0
164029,2022,,,-,-,-,-,-,-,-,-,-,-,-,-,-,-,-,-,-,-,-,-,-,-,-,-,-
125073,2022,France,USA,1,3,5,9,24/07/2022,0,0,0,0,4,2,6,12,3,5,1,9,0,0,0,0,2,0,0,2
125073,2022,Italy,France,0,1,6,7,23/07/2022,0,0,0,0,5,0,3,8,0,3,2,5,0,0,0,0,2,1,0,3
125073,2022,France,Japan,0,3,10,13,21/07/2022,0,0,0,0,3,0,2,5,3,4,3,10,0,0,0,0,1,0,0,1
125073,2022,Australia,France,0,4,7,11,10/7/2022,0,0,0,0,6,1,5,12,1,5,2,8,0,0,1,1,1,0,1,2
125073,2022,France,Argentina,0,0,0,0,9/7/2022,0,0,0,0,0,0,0,0,0,0,0,0,0,0,0,0,0,0,0,0
125073,2022,France,Brazil,2,1,8,11,8/7/2022,0,0,1,1,4,1,1,6,1,2,2,5,0,0,1,1,4,0,2,6
125073,2022,France,USA,0,2,3,5,7/7/2022,0,0,1,1,4,1,7,12,1,0,4,5,0,0,0,0,0,1,1,2
125073,2022,Germany,France,0,0,0,0,26/06/2022,0,0,0,0,0,0,0,0,0,0,0,0,0,0,0,0,0,0,0,0
125073,2022,Japan,France,0,2,5,7,25/06/2022,0,0,1,1,4,0,2,6,3,5,6,14,0,0,0,0,2,0,0,2
125073,2022,France,Netherlands,0,2,7,9,23/06/2022,0,0,0,0,4,0,1,5,6,4,1,11,0,0,0,0,1,1,1,3
136855,2022,France,USA,0,0,0,0,24/07/2022,0,0,0,0,0,0,0,0,0,0,0,0,0,0,0,0,0,0,0,0
136855,2022,Italy,France,0,0,0,0,23/07/2022,0,0,0,0,0,0,0,0,0,0,0,0,0,0,0,0,0,0,0,0
136855,2022,France,Japan,0,0,0,0,21/07/2022,0,0,0,0,0,0,0,0,0,0,0,0,0,0,0,0,0,0,0,0
136855,2022,Australia,France,0,0,0,0,10/7/2022,0,0,0,0,0,0,0,0,0,0,0,0,0,0,0,0,0,0,0,0
136855,2022,France,Argentina,0,2,8,10,9/7/2022,0,0,2,2,3,1,4,8,0,5,7,12,0,0,0,0,3,0,0,3
136855,2022,France,Brazil,0,0,0,0,8/7/2022,0,0,0,0,0,0,0,0,0,0,0,0,0,0,0,0,0,0,0,0
136855,2022,France,USA,0,0,0,0,7/7/2022,0,0,0,0,0,0,0,0,0,0,0,0,0,0,0,0,0,0,0,0
136855,2022,Germany,France,0,1,10,11,26/06/2022,0,0,1,1,1,2,2,5,3,2,3,8,0,1,1,2,5,0,0,5
136855,2022,Japan,France,0,0,0,0,25/06/2022,0,0,0,0,0,0,0,0,1,0,1,2,0,0,0,0,0,0,0,0
136855,2022,France,Netherlands,0,0,0,0,23/06/2022,0,0,0,0,0,0,0,0,0,0,0,0,0,0,0,0,0,0,0,0
136855,2022,France,Poland,0,0,1,1,12/6/2022,0,0,0,0,1,0,0,1,0,1,0,1,0,0,0,0,0,0,0,0
136855,2022,France,Canada,0,0,7,7,10/6/2022,0,0,1,1,5,0,5,10,0,4,8,12,0,0,0,0,2,1,0,3
136855,2022,Serbia,France,0,0,0,0,9/6/2022,0,0,0,0,0,0,0,0,0,0,0,0,0,0,0,0,0,0,0,0
136855,2022,France,Italy,0,0,0,0,8/6/2022,0,0,0,0,0,0,0,0,0,0,0,0,0,0,0,0,0,0,0,0
142677,2022,,,-,-,-,-,-,-,-,-,-,-,-,-,-,-,-,-,-,-,-,-,-,-,-,-,-
132948,2022,France,USA,0,3,13,16,24/07/2022,0,0,3,3,10,2,5,17,1,6,0,7,11,0,18,29,5,3,1,9
132948,2022,Italy,France,2,3,12,17,23/07/2022,0,0,1,1,13,0,4,17,0,4,1,5,8,1,7,16,3,2,0,5
132948,2022,France,Japan,0,2,8,10,21/07/2022,0,0,1,1,6,1,7,14,1,1,2,4,13,0,8,21,3,1,0,4
132948,2022,Australia,France,3,5,7,15,10/7/2022,0,0,2,2,7,1,3,11,2,0,3,5,5,2,13,20,4,1,1,6
132948,2022,France,Argentina,0,1,15,16,9/7/2022,0,0,8,8,10,1,9,20,0,1,4,5,5,1,12,18,4,2,3,9
132948,2022,France,Brazil,0,0,1,1,8/7/2022,0,0,0,0,0,0,0,0,0,0,0,0,0,0,0,0,0,0,0,0
132948,2022,France,USA,2,1,12,15,7/7/2022,0,0,7,7,8,5,15,28,0,0,5,5,5,3,20,28,4,4,1,9
132948,2022,Germany,France,0,0,0,0,26/06/2022,0,0,0,0,0,0,0,0,0,0,0,0,0,0,0,0,0,0,0,0
132948,2022,Japan,France,1,0,10,11,25/06/2022,0,1,5,6,9,2,9,20,0,2,1,3,7,1,9,17,4,2,0,6
132948,2022,France,Netherlands,2,3,11,16,23/06/2022,0,0,1,1,9,0,5,14,0,0,3,3,1,0,6,7,4,1,0,5
120735,2022,France,USA,0,0,0,0,24/07/2022,0,0,0,0,0,0,0,0,0,0,0,0,0,0,0,0,0,0,0,0
120735,2022,Italy,France,0,0,0,0,23/07/2022,0,0,0,0,0,0,0,0,0,0,0,0,0,0,0,0,0,0,0,0
120735,2022,France,Japan,1,3,13,17,21/07/2022,0,0,3,3,7,2,3,12,2,2,1,5,6,3,7,16,4,2,0,6
120735,2022,Australia,France,0,0,0,0,10/7/2022,0,0,0,0,0,0,0,0,0,0,0,0,0,0,0,0,0,0,0,0
120735,2022,France,Argentina,0,4,8,12,9/7/2022,0,0,2,2,7,3,12,22,1,5,7,13,5,4,16,25,12,5,1,18
120735,2022,France,Brazil,2,4,8,14,8/7/2022,0,0,3,3,9,3,5,17,1,3,2,6,4,4,17,25,4,1,1,6
120735,2022,France,USA,0,0,1,1,7/7/2022,0,0,0,0,0,1,2,3,0,0,0,0,1,0,2,3,1,0,1,2
120735,2022,Germany,France,1,5,8,14,26/06/2022,0,1,4,5,11,3,5,19,1,5,0,6,7,2,22,31,5,1,0,6
120735,2022,Japan,France,1,4,14,19,25/06/2022,0,0,5,5,6,3,9,18,1,4,2,7,7,0,12,19,4,0,3,7
120735,2022,France,Netherlands,0,0,1,1,23/06/2022,0,0,0,0,0,0,0,0,0,0,0,0,0,0,0,0,0,0,0,0
120735,2022,France,Poland,0,4,10,14,12/6/2022,0,0,5,5,10,3,7,20,0,3,5,8,9,5,24,38,4,7,2,13
120735,2022,France,Canada,1,1,6,8,10/6/2022,0,0,2,2,9,3,4,16,2,1,3,6,6,2,14,22,6,3,1,10
120735,2022,Serbia,France,2,2,11,15,9/6/2022,2,0,3,5,8,1,6,15,0,5,2,7,8,3,24,35,3,2,2,7
120735,2022,France,Italy,0,2,3,5,8/6/2022,0,0,1,1,2,5,5,12,0,0,1,1,6,1,9,16,4,0,0,4
152506,2022,France,USA,0,0,0,0,24/07/2022,0,0,0,0,0,0,0,0,0,0,0,0,0,0,0,0,0,0,0,0
152506,2022,Italy,France,0,0,0,0,23/07/2022,0,0,0,0,0,0,0,0,0,0,0,0,0,0,0,0,0,0,0,0
152506,2022,France,Japan,0,0,0,0,21/07/2022,0,0,0,0,0,0,0,0,0,0,0,0,0,0,0,0,0,0,0,0
152506,2022,Australia,France,0,0,0,0,10/7/2022,0,0,0,0,0,0,0,0,0,0,0,0,1,0,5,6,10,0,0,10
152506,2022,France,Argentina,0,0,0,0,9/7/2022,0,0,0,0,0,0,0,0,0,0,0,0,0,0,0,0,0,0,0,0
152506,2022,France,Brazil,0,0,0,0,8/7/2022,0,0,2,2,0,0,0,0,0,0,0,0,3,1,10,14,11,0,2,13
152506,2022,France,USA,0,0,0,0,7/7/2022,0,0,6,6,0,0,0,0,0,0,0,0,13,1,13,27,14,3,4,21
152506,2022,Germany,France,0,0,0,0,26/06/2022,0,0,0,0,0,0,0,0,0,0,0,0,0,0,0,0,0,0,0,0
152506,2022,Japan,France,0,0,0,0,25/06/2022,0,0,1,1,0,0,0,0,0,0,0,0,6,0,3,9,11,3,2,16
152506,2022,France,Netherlands,0,0,0,0,23/06/2022,0,0,0,0,0,0,0,0,0,0,0,0,7,5,11,23,6,1,0,7
152506,2022,France,Poland,0,0,0,0,12/6/2022,0,0,2,2,0,0,0,0,0,0,0,0,5,2,16,23,9,5,1,15
152506,2022,France,Canada,0,0,0,0,10/6/2022,0,0,0,0,0,0,0,0,0,0,0,0,0,0,0,0,0,0,0,0
152506,2022,Serbia,France,0,0,0,0,9/6/2022,1,0,0,1,0,0,0,0,0,0,0,0,6,0,12,18,16,4,3,23
152506,2022,France,Italy,0,0,0,0,8/6/2022,0,0,0,0,0,0,0,0,0,0,0,0,2,0,8,10,13,1,4,18
163309,2022,,,-,-,-,-,-,-,-,-,-,-,-,-,-,-,-,-,-,-,-,-,-,-,-,-,-
152531,2022,France,USA,0,0,0,0,24/07/2022,0,0,0,0,0,0,0,0,0,0,0,0,0,0,0,0,0,0,0,0
152531,2022,Italy,France,0,0,0,0,23/07/2022,0,0,0,0,0,0,0,0,0,0,0,0,0,0,0,0,0,0,0,0
152531,2022,France,Japan,0,0,0,0,21/07/2022,0,0,0,0,0,0,0,0,0,0,0,0,0,0,0,0,0,0,0,0
152531,2022,Australia,France,0,2,1,3,10/7/2022,0,0,1,1,5,1,2,8,0,2,0,2,1,0,3,4,1,0,0,1
152531,2022,France,Argentina,0,0,0,0,9/7/2022,0,0,0,0,0,0,0,0,0,0,0,0,0,0,0,0,0,0,0,0
152531,2022,France,Brazil,0,0,0,0,8/7/2022,0,0,0,0,0,0,0,0,0,0,0,0,0,0,0,0,0,0,0,0
152531,2022,France,USA,0,0,0,0,7/7/2022,0,0,0,0,0,0,0,0,0,0,0,0,0,0,0,0,0,0,0,0
152531,2022,Germany,France,0,0,0,0,26/06/2022,0,0,0,0,0,0,0,0,0,0,0,0,0,0,0,0,0,0,0,0
152531,2022,Japan,France,0,0,0,0,25/06/2022,0,0,0,0,0,0,0,0,0,0,0,0,0,0,0,0,0,0,0,0
152531,2022,France,Netherlands,0,0,0,0,23/06/2022,0,0,0,0,0,0,0,0,0,0,0,0,0,0,0,0,0,0,0,0
152531,2022,France,Poland,0,1,1,2,12/6/2022,0,0,1,1,4,0,1,5,0,0,0,0,0,0,3,3,1,0,0,1
152531,2022,France,Canada,2,5,7,14,10/6/2022,0,1,0,1,6,3,9,18,0,0,0,0,2,3,10,15,1,0,1,2
152531,2022,Serbia,France,0,0,0,0,9/6/2022,0,0,0,0,0,0,0,0,0,0,0,0,0,0,0,0,0,0,0,0
152531,2022,France,Italy,0,0,0,0,8/6/2022,0,0,0,0,0,0,0,0,0,0,0,0,0,0,0,0,0,0,0,0
142659,2022,,,-,-,-,-,-,-,-,-,-,-,-,-,-,-,-,-,-,-,-,-,-,-,-,-,-
181197,2022,France,Poland,0,0,0,0,12/6/2022,0,0,0,0,0,0,0,0,0,0,0,0,0,0,0,0,0,0,0,0
181197,2022,France,Canada,0,0,0,0,10/6/2022,0,0,0,0,0,0,0,0,0,0,0,0,0,0,0,0,0,0,0,0
181197,2022,Serbia,France,0,0,0,0,9/6/2022,0,0,0,0,0,0,0,0,0,0,0,0,0,0,0,0,0,0,0,0
181197,2022,France,Italy,0,0,0,0,8/6/2022,0,0,0,0,0,0,0,0,0,0,0,0,0,0,0,0,0,0,0,0
136856,2022,France,USA,2,3,3,8,24/07/2022,0,0,0,0,0,0,0,0,0,0,0,0,0,0,0,0,2,0,0,2
136856,2022,Italy,France,0,0,3,3,23/07/2022,0,0,0,0,0,0,0,0,0,0,0,0,0,0,0,0,0,0,0,0
136856,2022,France,Japan,0,1,0,1,21/07/2022,0,0,0,0,0,0,0,0,0,0,0,0,0,0,0,0,0,0,0,0
136856,2022,Australia,France,1,3,6,10,10/7/2022,0,0,1,1,3,0,1,4,1,1,3,5,0,0,0,0,1,1,0,2
136856,2022,France,Argentina,1,6,11,18,9/7/2022,0,0,2,2,6,1,2,9,1,3,6,10,0,0,0,0,2,0,1,3
136856,2022,France,Brazil,0,1,1,2,8/7/2022,0,0,0,0,0,0,0,0,0,0,0,0,0,0,0,0,0,0,0,0
136856,2022,France,USA,0,2,4,6,7/7/2022,0,0,0,0,0,0,0,0,0,0,0,0,0,0,0,0,1,0,0,1
136856,2022,Germany,France,3,5,10,18,26/06/2022,0,0,1,1,6,0,3,9,3,1,5,9,0,0,0,0,2,0,0,2
136856,2022,Japan,France,1,2,1,4,25/06/2022,0,0,0,0,0,0,0,0,0,0,0,0,0,0,0,0,0,0,0,0
136856,2022,France,Netherlands,0,0,0,0,23/06/2022,0,0,0,0,0,0,0,0,0,0,0,0,0,0,0,0,0,0,0,0
136856,2022,France,Poland,2,3,14,19,12/6/2022,0,0,0,0,4,1,3,8,1,3,4,8,0,0,1,1,0,1,1,2
136856,2022,France,Canada,0,0,3,3,10/6/2022,0,0,0,0,0,0,0,0,0,0,0,0,0,0,0,0,0,1,0,1
136856,2022,Serbia,France,1,3,10,14,9/6/2022,0,1,0,1,1,2,3,6,3,6,10,19,0,0,1,1,3,0,3,6
136856,2022,France,Italy,2,2,7,11,8/6/2022,0,0,1,1,5,0,4,9,0,4,7,11,0,0,0,0,3,0,2,5
164022,2022,,,-,-,-,-,-,-,-,-,-,-,-,-,-,-,-,-,-,-,-,-,-,-,-,-,-
183115,2022,,,-,-,-,-,-,-,-,-,-,-,-,-,-,-,-,-,-,-,-,-,-,-,-,-,-
164020,2022,,,-,-,-,-,-,-,-,-,-,-,-,-,-,-,-,-,-,-,-,-,-,-,-,-,-
119779,2022,Germany,Japan,0,5,8,13,9/7/2022,0,0,5,5,9,4,11,24,1,1,2,4,7,1,11,19,1,1,3,5
119779,2022,Germany,Australia,0,1,14,15,7/7/2022,0,0,0,0,13,6,6,25,0,1,2,3,0,0,1,1,4,0,2,6
119779,2022,Brazil,Germany,1,2,9,12,6/7/2022,0,0,3,3,10,3,12,25,1,3,0,4,6,1,24,31,2,4,1,7
119779,2022,USA,Germany,0,3,7,10,5/7/2022,0,0,3,3,7,3,14,24,2,2,2,6,7,5,11,23,3,0,0,3
119779,2022,Germany,France,0,4,5,9,26/06/2022,0,0,1,1,5,3,10,18,1,1,2,4,1,2,14,17,2,0,0,2
119779,2022,Germany,Netherlands,0,5,9,14,24/06/2022,1,0,3,4,8,5,18,31,1,3,3,7,3,1,13,17,9,3,1,13
119779,2022,China,Germany,0,0,0,0,23/06/2022,0,0,0,0,0,0,0,0,0,0,0,0,0,0,0,0,0,0,0,0
119779,2022,Germany,Italy,0,4,2,6,22/06/2022,0,0,2,2,4,1,2,7,0,0,1,1,1,3,10,14,0,0,1,1
119779,2022,Germany,Serbia,1,5,8,14,11/6/2022,0,0,7,7,13,1,11,25,4,1,1,6,2,4,18,24,6,3,2,11
119779,2022,Bulgaria,Germany,2,3,17,22,10/6/2022,0,0,7,7,17,4,7,28,3,1,2,6,9,0,23,32,2,1,2,5
119779,2022,Germany,Argentina,1,1,6,8,9/6/2022,0,0,2,2,7,4,9,20,1,1,2,4,1,2,19,22,1,3,0,4
119779,2022,Canada,Germany,3,0,11,14,7/6/2022,0,0,2,2,14,1,11,26,1,4,1,6,2,3,14,19,6,1,1,8
152469,2022,Germany,France,2,3,13,18,26/06/2022,15,1,44,60,1,0,0,1,1,4,0,5,0,0,1,1,8,0,1,9
152469,2022,Germany,Netherlands,0,1,3,4,24/06/2022,2,0,9,11,0,0,0,0,0,0,0,0,0,0,0,0,0,0,0,0
152469,2022,China,Germany,0,0,0,0,23/06/2022,0,0,0,0,0,0,0,0,0,0,0,0,0,0,0,0,0,0,0,0
152469,2022,Germany,Italy,0,2,3,5,22/06/2022,6,0,13,19,0,1,0,1,0,0,0,0,0,0,0,0,1,1,1,3
152469,2022,Germany,Serbia,1,0,11,12,11/6/2022,7,0,21,28,0,0,0,0,2,2,0,4,0,1,0,1,2,0,2,4
152469,2022,Bulgaria,Germany,0,0,0,0,10/6/2022,1,0,0,1,0,0,0,0,0,1,0,1,0,0,0,0,0,0,0,0
152469,2022,Germany,Argentina,0,1,3,4,9/6/2022,3,0,19,22,0,0,0,0,0,0,1,1,0,0,0,0,2,0,0,2
152469,2022,Canada,Germany,0,1,1,2,7/6/2022,0,0,0,0,0,0,0,0,0,0,0,0,0,0,0,0,0,0,0,0
136441,2022,,,-,-,-,-,-,-,-,-,-,-,-,-,-,-,-,-,-,-,-,-,-,-,-,-,-
182291,2022,Germany,Japan,0,0,0,0,9/7/2022,0,0,2,2,0,0,0,0,0,0,0,0,0,0,0,0,4,2,0,6
182291,2022,Germany,Australia,0,0,0,0,7/7/2022,0,0,0,0,0,0,0,0,0,0,0,0,0,0,0,0,0,0,0,0
182291,2022,Brazil,Germany,0,0,0,0,6/7/2022,0,0,0,0,0,0,0,0,0,0,0,0,0,0,0,0,0,0,0,0
182291,2022,USA,Germany,0,0,0,0,5/7/2022,0,0,0,0,0,0,0,0,0,0,0,0,0,0,0,0,0,0,0,0
182291,2022,Germany,France,0,0,0,0,26/06/2022,0,0,2,2,0,0,0,0,0,0,0,0,1,1,5,7,0,0,0,0
182291,2022,Germany,Netherlands,0,0,0,0,24/06/2022,0,0,0,0,0,0,0,0,0,0,0,0,0,0,1,1,0,0,0,0
182291,2022,China,Germany,0,0,0,0,23/06/2022,0,0,0,0,0,0,0,0,0,0,0,0,0,0,0,0,0,0,0,0
182291,2022,Germany,Italy,0,0,0,0,22/06/2022,0,0,0,0,0,0,0,0,0,0,0,0,0,0,0,0,0,0,0,0
139386,2022,Germany,Japan,0,0,0,0,9/7/2022,0,0,0,0,0,0,0,0,0,0,0,0,1,0,1,2,0,0,0,0
139386,2022,Germany,Australia,1,4,14,19,7/7/2022,0,0,5,5,21,1,10,32,0,5,1,6,9,2,8,19,5,4,2,11
139386,2022,Brazil,Germany,0,0,0,0,6/7/2022,0,1,0,1,0,0,0,0,0,0,0,0,0,0,4,4,1,0,1,2
139386,2022,USA,Germany,0,0,1,1,5/7/2022,0,0,3,3,0,0,1,1,0,0,0,0,3,0,1,4,0,0,0,0
139386,2022,Germany,France,0,0,0,0,26/06/2022,0,0,0,0,0,0,0,0,0,0,0,0,0,0,0,0,0,0,0,0
139386,2022,Germany,Netherlands,0,0,0,0,24/06/2022,0,0,0,0,0,0,0,0,0,0,0,0,0,0,0,0,0,0,0,0
139386,2022,China,Germany,0,0,0,0,23/06/2022,0,0,0,0,0,0,0,0,0,0,0,0,0,0,0,0,0,0,0,0
139386,2022,Germany,Italy,0,2,7,9,22/06/2022,0,0,3,3,3,3,7,13,0,1,1,2,2,1,13,16,6,2,0,8
139386,2022,Germany,Serbia,3,3,18,24,11/6/2022,0,0,4,4,14,4,19,37,1,2,1,4,16,0,25,41,4,0,7,11
139386,2022,Bulgaria,Germany,0,4,19,23,10/6/2022,0,0,2,2,13,4,11,28,1,3,2,6,8,1,21,30,3,3,4,10
139386,2022,Germany,Argentina,2,1,15,18,9/6/2022,0,1,2,3,14,5,6,25,2,3,5,10,8,2,19,29,1,2,1,4
139386,2022,Canada,Germany,2,1,13,16,7/6/2022,0,0,5,5,12,1,7,20,1,1,0,2,6,1,11,18,3,0,1,4
152470,2022,Germany,Japan,0,0,0,0,9/7/2022,0,0,5,5,0,0,0,0,0,0,0,0,4,1,11,16,2,1,1,4
152470,2022,Germany,Australia,0,0,0,0,7/7/2022,2,0,6,8,0,0,0,0,0,0,0,0,10,0,10,20,10,1,1,12
152470,2022,Brazil,Germany,0,0,0,0,6/7/2022,0,0,12,12,0,0,0,0,0,0,0,0,8,3,10,21,10,4,5,19
152470,2022,USA,Germany,0,0,0,0,5/7/2022,3,0,11,14,0,0,0,0,0,0,0,0,11,0,11,22,3,6,15,24
152470,2022,Germany,France,0,0,0,0,26/06/2022,0,0,6,6,0,0,0,0,0,0,0,0,5,2,6,13,2,3,0,5
152470,2022,Germany,Netherlands,0,0,0,0,24/06/2022,1,0,12,13,0,0,0,0,0,0,0,0,6,4,16,26,25,1,1,27
152470,2022,China,Germany,0,0,0,0,23/06/2022,0,0,0,0,0,0,0,0,0,0,0,0,0,0,0,0,0,0,0,0
152470,2022,Germany,Italy,0,0,0,0,22/06/2022,0,0,2,2,0,0,0,0,0,0,0,0,7,0,5,12,7,2,1,10
152470,2022,Germany,Serbia,0,0,0,0,11/6/2022,0,0,4,4,0,0,0,0,0,0,0,0,7,3,17,27,12,5,3,20
152470,2022,Bulgaria,Germany,0,0,0,0,10/6/2022,0,0,6,6,0,0,0,0,0,0,0,0,4,1,6,11,14,6,5,25
152470,2022,Germany,Argentina,0,0,0,0,9/6/2022,0,0,3,3,0,0,0,0,0,0,0,0,3,1,20,24,10,4,2,16
152470,2022,Canada,Germany,0,0,0,0,7/6/2022,0,0,3,3,0,0,0,0,0,0,0,0,9,0,11,20,5,1,5,11
116575,2022,,,-,-,-,-,-,-,-,-,-,-,-,-,-,-,-,-,-,-,-,-,-,-,-,-,-
156597,2022,,,-,-,-,-,-,-,-,-,-,-,-,-,-,-,-,-,-,-,-,-,-,-,-,-,-
189255,2022,,,-,-,-,-,-,-,-,-,-,-,-,-,-,-,-,-,-,-,-,-,-,-,-,-,-
162788,2022,,,-,-,-,-,-,-,-,-,-,-,-,-,-,-,-,-,-,-,-,-,-,-,-,-,-
136442,2022,Germany,Japan,0,1,12,13,9/7/2022,20,0,44,64,0,0,2,2,1,3,1,5,0,0,0,0,3,2,5,10
136442,2022,Germany,Australia,1,2,10,13,7/7/2022,33,0,50,83,1,0,1,2,0,2,2,4,0,0,0,0,4,0,2,6
136442,2022,Brazil,Germany,0,1,16,17,6/7/2022,28,0,58,86,0,0,0,0,0,1,1,2,0,0,0,0,2,2,3,7
136442,2022,USA,Germany,0,2,12,14,5/7/2022,30,0,62,92,2,0,1,3,0,3,2,5,0,0,0,0,8,2,3,13
136442,2022,Germany,France,0,0,0,0,26/06/2022,0,0,0,0,0,0,0,0,0,0,0,0,0,0,0,0,0,0,0,0
136442,2022,Germany,Netherlands,0,0,21,21,24/06/2022,11,1,90,102,0,0,2,2,0,4,4,8,0,0,0,0,8,2,3,13
136442,2022,China,Germany,0,0,0,0,23/06/2022,0,0,0,0,0,0,0,0,0,0,0,0,0,0,0,0,0,0,0,0
136442,2022,Germany,Italy,1,1,4,6,22/06/2022,9,0,38,47,0,0,0,0,0,4,0,4,0,0,0,0,1,0,0,1
136442,2022,Germany,Serbia,0,0,11,11,11/6/2022,26,2,66,94,0,0,2,2,0,2,2,4,0,1,1,2,4,5,1,10
136442,2022,Bulgaria,Germany,0,2,6,8,10/6/2022,32,1,59,92,1,1,0,2,0,2,1,3,0,0,2,2,4,0,2,6
136442,2022,Germany,Argentina,1,0,10,11,9/6/2022,13,0,51,64,0,0,1,1,0,0,2,2,0,0,0,0,4,2,1,7
136442,2022,Canada,Germany,1,1,11,13,7/6/2022,25,1,45,71,0,0,0,0,0,0,0,0,0,0,0,0,6,1,1,8
162790,2022,Germany,Japan,0,3,13,16,9/7/2022,0,0,0,0,3,1,3,7,2,3,1,6,1,0,0,1,1,0,1,2
162790,2022,Germany,Australia,1,2,13,16,7/7/2022,0,0,0,0,3,2,3,8,1,4,2,7,0,0,0,0,0,2,1,3
162790,2022,Brazil,Germany,1,2,11,14,6/7/2022,0,0,4,4,8,2,3,13,0,9,4,13,0,0,0,0,1,0,0,1
162790,2022,USA,Germany,0,3,11,14,5/7/2022,0,0,2,2,7,1,5,13,0,2,3,5,0,0,1,1,1,2,0,3
162790,2022,Germany,France,0,5,4,9,26/06/2022,0,0,1,1,3,1,0,4,1,9,3,13,1,1,1,3,1,0,2,3
162790,2022,Germany,Netherlands,0,0,1,1,24/06/2022,0,0,0,0,0,0,0,0,0,0,0,0,0,0,0,0,0,0,0,0
162790,2022,China,Germany,0,0,0,0,23/06/2022,0,0,0,0,0,0,0,0,0,0,0,0,0,0,0,0,0,0,0,0
162790,2022,Germany,Italy,0,1,5,6,22/06/2022,0,0,0,0,1,2,0,3,1,0,1,2,1,0,1,2,1,0,0,1
162790,2022,Germany,Serbia,0,3,8,11,11/6/2022,0,0,0,0,6,1,2,9,4,3,4,11,0,0,1,1,5,1,1,7
162790,2022,Bulgaria,Germany,0,0,0,0,10/6/2022,0,0,0,0,0,0,0,0,0,0,0,0,0,0,0,0,0,0,0,0
162790,2022,Germany,Argentina,2,4,9,15,9/6/2022,0,1,0,1,5,1,1,7,1,3,4,8,0,0,0,0,2,2,3,7
162790,2022,Canada,Germany,0,0,0,0,7/6/2022,0,0,0,0,0,0,0,0,0,0,0,0,0,0,0,0,0,0,0,0
174660,2022,Germany,Netherlands,0,0,0,0,24/06/2022,0,0,0,0,0,0,0,0,0,0,0,0,0,0,0,0,0,0,0,0
174660,2022,China,Germany,0,0,0,0,23/06/2022,0,0,0,0,0,0,0,0,0,0,0,0,0,0,0,0,0,0,0,0
174660,2022,Germany,Italy,2,0,6,8,22/06/2022,0,0,0,0,0,1,3,4,0,0,0,0,2,0,4,6,0,0,0,0
162082,2022,USA,Germany,0,0,0,0,5/7/2022,0,0,0,0,0,0,0,0,0,0,0,0,0,0,0,0,0,0,0,0
162082,2022,Germany,France,1,7,5,13,26/06/2022,0,0,2,2,14,6,8,28,1,4,4,9,0,0,0,0,3,3,0,6
162082,2022,Germany,Netherlands,1,8,5,14,24/06/2022,0,0,0,0,22,8,20,50,2,3,5,10,0,0,0,0,7,3,1,11
162082,2022,China,Germany,0,0,0,0,23/06/2022,0,0,0,0,0,0,0,0,0,0,0,0,0,0,0,0,0,0,0,0
162082,2022,Germany,Italy,0,4,3,7,22/06/2022,0,0,0,0,14,7,5,26,0,2,0,2,0,0,1,1,1,1,0,2
162082,2022,Germany,Serbia,2,5,10,17,11/6/2022,0,0,3,3,15,8,20,43,2,2,5,9,0,0,0,0,3,2,0,5
162082,2022,Bulgaria,Germany,1,3,14,18,10/6/2022,0,0,1,1,13,7,7,27,1,5,0,6,0,0,0,0,4,2,3,9
162082,2022,Germany,Argentina,3,6,5,14,9/6/2022,0,0,3,3,16,8,10,34,1,1,5,7,0,0,0,0,4,1,2,7
162082,2022,Canada,Germany,0,5,7,12,7/6/2022,0,0,2,2,12,4,9,25,3,4,3,10,0,0,0,0,1,1,3,5
152349,2022,Germany,Japan,0,4,7,11,9/7/2022,0,0,0,0,8,2,4,14,1,5,3,9,0,0,3,3,2,0,2,4
152349,2022,Germany,Australia,2,4,7,13,7/7/2022,0,0,0,0,9,3,3,15,6,7,5,18,0,0,0,0,0,0,0,0
152349,2022,Brazil,Germany,0,4,3,7,6/7/2022,0,0,0,0,5,1,2,8,1,9,2,12,0,0,2,2,1,1,0,2
152349,2022,USA,Germany,1,5,5,11,5/7/2022,0,0,2,2,6,1,12,19,1,4,4,9,1,0,1,2,0,0,3,3
152349,2022,Germany,France,0,0,0,0,26/06/2022,0,0,0,0,0,0,0,0,0,0,0,0,0,0,0,0,0,0,0,0
152349,2022,Germany,Netherlands,0,2,7,9,24/06/2022,0,0,0,0,11,2,2,15,1,3,5,9,0,0,0,0,1,0,0,1
152349,2022,China,Germany,0,0,0,0,23/06/2022,0,0,0,0,0,0,0,0,0,0,0,0,0,0,0,0,0,0,0,0
152349,2022,Germany,Italy,0,1,1,2,22/06/2022,0,0,0,0,4,0,1,5,1,0,2,3,0,0,0,0,1,0,0,1
152349,2022,Germany,Serbia,0,0,0,0,11/6/2022,0,0,0,0,0,0,0,0,0,0,0,0,0,0,0,0,0,0,0,0
152349,2022,Bulgaria,Germany,1,1,10,12,10/6/2022,0,0,0,0,11,1,4,16,5,4,5,14,1,0,0,1,0,0,1,1
152349,2022,Germany,Argentina,0,0,0,0,9/6/2022,0,0,0,0,0,0,0,0,0,0,0,0,0,0,0,0,0,0,0,0
152349,2022,Canada,Germany,1,3,1,5,7/6/2022,0,0,2,2,1,3,4,8,1,3,4,8,0,0,0,0,1,0,0,1
163592,2022,Germany,Japan,0,4,8,12,9/7/2022,0,0,3,3,12,2,13,27,0,2,0,2,5,2,18,25,3,2,1,6
163592,2022,Germany,Australia,0,4,12,16,7/7/2022,0,0,0,0,5,4,9,18,1,2,1,4,6,2,18,26,7,2,1,10
163592,2022,Brazil,Germany,0,2,11,13,6/7/2022,0,0,4,4,14,2,11,27,3,4,2,9,7,2,17,26,4,0,3,7
163592,2022,USA,Germany,0,2,15,17,5/7/2022,1,0,3,4,11,1,8,20,0,3,3,6,11,2,12,25,9,2,3,14
163592,2022,Germany,France,1,2,13,16,26/06/2022,0,0,6,6,4,1,10,15,0,1,1,2,8,2,11,21,3,1,0,4
163592,2022,Germany,Netherlands,0,1,13,14,24/06/2022,0,0,2,2,7,1,13,21,0,4,5,9,8,1,25,34,10,3,0,13
163592,2022,China,Germany,0,0,0,0,23/06/2022,0,0,0,0,0,0,0,0,0,0,0,0,0,0,0,0,0,0,0,0
163592,2022,Germany,Italy,0,0,1,1,22/06/2022,0,0,0,0,1,2,2,5,0,1,1,2,0,0,6,6,2,0,0,2
163592,2022,Germany,Serbia,0,0,5,5,11/6/2022,0,0,1,1,0,0,3,3,0,0,0,0,2,1,2,5,1,2,3,6
163592,2022,Bulgaria,Germany,0,0,2,2,10/6/2022,0,0,0,0,0,0,0,0,0,0,0,0,0,0,0,0,0,0,0,0
163592,2022,Germany,Argentina,0,0,1,1,9/6/2022,0,0,1,1,0,1,0,1,0,0,1,1,0,0,2,2,0,0,0,0
163592,2022,Canada,Germany,0,0,0,0,7/6/2022,0,0,0,0,0,0,0,0,0,0,0,0,0,0,0,0,0,0,0,0
183112,2022,Germany,Serbia,0,0,0,0,11/6/2022,0,0,0,0,0,0,0,0,0,0,0,0,0,0,0,0,0,0,0,0
183112,2022,Bulgaria,Germany,0,0,0,0,10/6/2022,0,0,0,0,0,0,0,0,0,0,0,0,0,0,0,0,0,0,0,0
183112,2022,Germany,Argentina,0,0,0,0,9/6/2022,0,0,0,0,0,0,0,0,0,0,0,0,0,0,0,0,0,0,0,0
183112,2022,Canada,Germany,0,0,0,0,7/6/2022,0,0,0,0,0,0,0,0,0,0,0,0,0,0,0,0,0,0,0,0
156598,2022,,,-,-,-,-,-,-,-,-,-,-,-,-,-,-,-,-,-,-,-,-,-,-,-,-,-
152352,2022,Brazil,Germany,1,3,12,16,6/7/2022,0,2,2,4,13,5,14,32,1,3,1,5,0,0,1,1,5,2,5,12
152352,2022,USA,Germany,1,2,12,15,5/7/2022,0,1,2,3,14,4,22,40,0,3,1,4,0,0,1,1,2,3,3,8
152352,2022,Germany,France,0,3,13,16,26/06/2022,0,0,1,1,5,1,5,11,3,4,3,10,0,0,2,2,3,0,0,3
152352,2022,Germany,Netherlands,0,2,13,15,24/06/2022,0,0,1,1,5,0,6,11,5,7,10,22,1,0,2,3,4,2,1,7
152352,2022,China,Germany,0,0,0,0,23/06/2022,0,0,0,0,0,0,0,0,0,0,0,0,0,0,0,0,0,0,0,0
152352,2022,Germany,Italy,0,2,7,9,22/06/2022,0,0,1,1,5,1,4,10,2,5,2,9,0,0,3,3,3,1,0,4
152352,2022,Germany,Serbia,2,3,16,21,11/6/2022,0,0,0,0,12,3,7,22,3,14,7,24,0,0,1,1,0,4,3,7
152352,2022,Bulgaria,Germany,1,3,18,22,10/6/2022,0,1,1,2,6,1,3,10,3,4,4,11,0,0,2,2,3,2,2,7
152352,2022,Germany,Argentina,0,3,9,12,9/6/2022,0,0,2,2,6,1,6,13,1,5,2,8,1,1,1,3,1,0,4,5
152352,2022,Canada,Germany,1,3,10,14,7/6/2022,0,0,0,0,4,0,3,7,0,6,1,7,0,0,1,1,1,0,4,5
174663,2022,,,-,-,-,-,-,-,-,-,-,-,-,-,-,-,-,-,-,-,-,-,-,-,-,-,-
176931,2022,Germany,Japan,0,1,1,2,9/7/2022,5,0,16,21,1,0,0,1,0,1,0,1,0,0,0,0,1,4,0,5
176931,2022,Germany,Australia,0,0,0,0,7/7/2022,0,0,0,0,0,0,0,0,0,0,0,0,0,0,0,0,0,0,0,0
176931,2022,Brazil,Germany,0,0,0,0,6/7/2022,0,0,4,4,0,0,0,0,0,0,0,0,0,0,0,0,0,0,0,0
176931,2022,USA,Germany,0,0,0,0,5/7/2022,1,0,1,2,0,0,0,0,0,0,0,0,0,0,0,0,0,0,0,0
152751,2022,Germany,Japan,0,0,0,0,9/7/2022,0,0,0,0,0,0,0,0,0,0,0,0,0,0,0,0,0,0,0,0
152751,2022,Germany,Australia,0,0,0,0,7/7/2022,0,0,0,0,0,0,0,0,0,0,0,0,0,0,0,0,0,0,0,0
152751,2022,Brazil,Germany,0,0,0,0,6/7/2022,0,0,0,0,0,0,0,0,0,0,0,0,0,0,0,0,0,0,0,0
152751,2022,USA,Germany,0,0,0,0,5/7/2022,0,0,0,0,0,0,0,0,0,0,0,0,0,0,0,0,0,0,0,0
152751,2022,Germany,France,0,1,0,1,26/06/2022,0,0,0,0,0,0,0,0,0,0,0,0,0,0,0,0,0,0,0,0
152751,2022,Germany,Netherlands,0,0,0,0,24/06/2022,0,0,0,0,1,0,0,1,0,0,1,1,0,0,0,0,0,0,0,0
152751,2022,China,Germany,0,0,0,0,23/06/2022,0,0,0,0,0,0,0,0,0,0,0,0,0,0,0,0,0,0,0,0
152751,2022,Germany,Italy,0,0,0,0,22/06/2022,0,0,0,0,0,0,0,0,0,0,0,0,0,0,0,0,0,0,0,0
152751,2022,Germany,Serbia,0,0,0,0,11/6/2022,0,0,0,0,0,0,0,0,0,0,0,0,0,0,0,0,0,0,0,0
152751,2022,Bulgaria,Germany,0,0,0,0,10/6/2022,0,0,0,0,0,0,0,0,0,0,0,0,0,0,0,0,0,0,0,0
152751,2022,Germany,Argentina,0,0,0,0,9/6/2022,0,0,0,0,0,0,0,0,0,0,0,0,0,0,0,0,0,0,0,0
152751,2022,Canada,Germany,0,0,0,0,7/6/2022,0,0,0,0,0,0,0,0,0,0,0,0,0,0,0,0,0,0,0,0
152713,2022,Germany,Japan,2,1,6,9,9/7/2022,0,0,0,0,5,2,1,8,0,0,0,0,0,0,10,10,0,1,3,4
152713,2022,Germany,Australia,0,1,2,3,7/7/2022,0,0,0,0,0,0,0,0,0,0,0,0,0,0,0,0,0,0,0,0
152713,2022,Brazil,Germany,0,0,3,3,6/7/2022,0,0,0,0,0,0,0,0,0,0,0,0,0,0,0,0,0,0,0,0
152713,2022,USA,Germany,0,0,2,2,5/7/2022,0,0,0,0,0,0,0,0,0,0,0,0,0,0,0,0,0,0,0,0
152713,2022,Germany,France,0,0,0,0,26/06/2022,0,0,0,0,0,0,0,0,0,0,0,0,0,0,0,0,0,0,0,0
152713,2022,Germany,Netherlands,0,1,1,2,24/06/2022,0,0,0,0,1,2,0,3,0,0,1,1,0,0,0,0,0,1,0,1
152713,2022,China,Germany,0,0,0,0,23/06/2022,0,0,0,0,0,0,0,0,0,0,0,0,0,0,0,0,0,0,0,0
152713,2022,Germany,Italy,0,0,1,1,22/06/2022,0,0,1,1,1,1,0,2,0,0,0,0,0,0,1,1,0,0,0,0
152713,2022,Germany,Serbia,0,0,0,0,11/6/2022,0,0,0,0,0,0,0,0,0,0,0,0,0,0,0,0,0,0,0,0
152713,2022,Bulgaria,Germany,0,0,0,0,10/6/2022,0,0,0,0,0,0,0,0,0,0,0,0,0,0,0,0,0,0,0,0
152713,2022,Germany,Argentina,0,1,0,1,9/6/2022,0,0,0,0,0,0,0,0,0,0,0,0,0,0,0,0,0,0,0,0
152713,2022,Canada,Germany,0,1,0,1,7/6/2022,0,0,0,0,0,0,0,0,0,0,0,0,0,0,0,0,0,0,0,0
174640,2022,Germany,Japan,0,5,7,12,9/7/2022,0,0,1,1,9,7,3,19,3,4,5,12,0,0,1,1,6,3,1,10
174640,2022,Germany,Australia,0,0,0,0,7/7/2022,0,0,0,0,0,0,0,0,0,0,0,0,0,0,0,0,0,0,0,0
174640,2022,Brazil,Germany,0,1,1,2,6/7/2022,0,0,0,0,1,0,2,3,0,0,0,0,0,0,0,0,0,0,0,0
174640,2022,USA,Germany,0,0,0,0,5/7/2022,0,0,0,0,0,1,1,2,0,0,0,0,0,0,0,0,0,0,0,0
174640,2022,Germany,Serbia,0,0,0,0,11/6/2022,0,0,0,0,0,0,0,0,0,0,0,0,0,0,0,0,0,0,0,0
174640,2022,Bulgaria,Germany,0,0,0,0,10/6/2022,0,0,0,0,0,0,0,0,0,0,0,0,0,0,0,0,0,0,0,0
174640,2022,Germany,Argentina,0,1,0,1,9/6/2022,0,0,0,0,0,0,2,2,0,0,0,0,0,0,0,0,0,0,0,0
174640,2022,Canada,Germany,0,0,0,0,7/6/2022,0,0,0,0,0,0,0,0,0,0,0,0,0,0,0,0,0,0,0,0
181283,2022,,,-,-,-,-,-,-,-,-,-,-,-,-,-,-,-,-,-,-,-,-,-,-,-,-,-
163173,2022,Poland,Iran,0,2,12,14,21/07/2022,0,0,4,4,5,2,2,9,1,2,9,12,2,0,0,2,1,1,1,3
163173,2022,Iran,Serbia,0,0,11,11,9/7/2022,0,0,0,0,3,2,0,5,6,3,0,9,0,0,1,1,2,1,0,3
163173,2022,Slovenia,Iran,0,2,7,9,8/7/2022,0,0,0,0,4,0,1,5,0,2,0,2,0,0,0,0,0,0,0,0
163173,2022,Italy,Iran,0,2,2,4,7/7/2022,0,0,0,0,0,0,1,1,0,3,1,4,0,0,0,0,0,0,0,0
163173,2022,Iran,Poland,0,1,9,10,5/7/2022,0,0,1,1,3,1,2,6,3,4,1,8,0,0,0,0,1,2,1,4
163173,2022,Canada,Iran,0,0,10,10,25/06/2022,0,0,0,0,3,0,0,3,2,3,2,7,0,0,1,1,0,1,0,1
163173,2022,Iran,Brazil,1,0,13,14,24/06/2022,0,0,0,0,2,1,3,6,0,1,0,1,0,0,0,0,0,0,0,0
163173,2022,USA,Iran,0,0,9,9,23/06/2022,0,0,0,0,4,1,1,6,1,3,0,4,0,0,0,0,1,2,0,3
163173,2022,Iran,Bulgaria,0,1,13,14,21/06/2022,0,0,0,0,0,0,2,2,1,3,3,7,1,0,0,1,0,1,0,1
163173,2022,Iran,Japan,0,0,5,5,12/6/2022,0,0,0,0,2,0,0,2,0,1,1,2,1,0,0,1,1,0,0,1
163173,2022,Iran,Australia,2,2,9,13,12/6/2022,3,0,0,3,4,1,4,9,5,4,3,12,0,0,0,0,1,0,0,1
163173,2022,Netherlands,Iran,2,0,7,9,10/6/2022,0,0,0,0,2,0,3,5,1,5,1,7,0,0,2,2,1,0,1,2
163173,2022,China,Iran,0,0,0,0,7/6/2022,0,0,0,0,0,0,0,0,0,0,0,0,0,0,0,0,0,0,0,0
136751,2022,Poland,Iran,3,5,11,19,21/07/2022,0,2,2,4,12,4,11,27,2,3,2,7,7,1,10,18,11,4,0,15
136751,2022,Iran,Serbia,1,3,12,16,9/7/2022,0,0,2,2,9,3,7,19,0,3,0,3,2,1,8,11,3,1,0,4
136751,2022,Slovenia,Iran,1,2,8,11,8/7/2022,0,0,2,2,10,2,5,17,1,0,0,1,3,2,10,15,0,1,0,1
136751,2022,Italy,Iran,4,2,14,20,7/7/2022,0,0,3,3,20,1,9,30,2,2,0,4,3,7,14,24,9,0,0,9
136751,2022,Iran,Poland,3,2,14,19,5/7/2022,0,0,4,4,14,4,6,24,1,1,0,2,2,3,10,15,8,2,2,12
136751,2022,Canada,Iran,2,4,10,16,25/06/2022,0,1,1,2,7,2,4,13,1,2,0,3,4,1,8,13,4,0,0,4
136751,2022,Iran,Brazil,0,1,9,10,24/06/2022,0,0,2,2,3,5,7,15,2,1,0,3,8,0,7,15,1,3,1,5
136751,2022,USA,Iran,2,3,8,13,23/06/2022,0,1,0,1,12,2,7,21,1,0,0,1,3,2,15,20,0,1,0,1
136751,2022,Iran,Bulgaria,0,0,2,2,21/06/2022,0,0,0,0,1,0,1,2,0,1,1,2,1,0,4,5,0,0,0,0
136751,2022,Iran,Japan,0,1,5,6,12/6/2022,2,0,0,2,2,2,8,12,1,1,1,3,3,3,12,18,1,1,0,2
136751,2022,Iran,Australia,0,2,11,13,12/6/2022,2,0,0,2,6,2,7,15,2,2,0,4,7,0,7,14,8,2,2,12
136751,2022,Netherlands,Iran,1,3,5,9,10/6/2022,1,0,0,1,5,4,7,16,0,2,0,2,3,1,14,18,4,0,0,4
136751,2022,China,Iran,1,3,11,15,7/6/2022,0,0,3,3,13,5,8,26,1,2,0,3,5,2,17,24,3,0,0,3
150817,2022,Iran,Japan,0,0,0,0,12/6/2022,0,0,0,0,0,0,0,0,0,0,0,0,0,0,0,0,0,0,0,0
150817,2022,Iran,Australia,0,0,0,0,12/6/2022,0,0,0,0,0,0,0,0,0,0,0,0,0,0,0,0,0,0,0,0
150817,2022,China,Iran,1,2,8,11,7/6/2022,0,0,0,0,2,2,0,4,2,7,4,13,0,1,3,4,5,1,2,8
163179,2022,Poland,Iran,2,4,8,14,21/07/2022,0,0,2,2,4,3,1,8,0,3,2,5,1,1,2,4,2,0,0,2
163179,2022,Iran,Serbia,1,3,15,19,9/7/2022,0,0,0,0,10,1,1,12,2,2,0,4,0,0,2,2,0,0,0,0
163179,2022,Slovenia,Iran,1,4,5,10,8/7/2022,0,0,0,0,3,0,1,4,1,0,1,2,0,0,1,1,0,0,0,0
163179,2022,Italy,Iran,1,2,11,14,7/7/2022,0,0,0,0,2,2,4,8,1,6,1,8,0,0,4,4,1,0,0,1
163179,2022,Iran,Poland,1,3,21,25,5/7/2022,0,0,0,0,6,3,5,14,0,5,1,6,0,0,3,3,1,1,1,3
163179,2022,Canada,Iran,0,0,0,0,25/06/2022,0,0,0,0,0,0,0,0,0,0,0,0,0,0,0,0,0,0,0,0
163179,2022,Iran,Brazil,0,2,7,9,24/06/2022,0,0,0,0,5,0,1,6,1,2,1,4,0,0,0,0,0,0,0,0
163179,2022,USA,Iran,0,1,2,3,23/06/2022,0,0,0,0,2,1,2,5,0,2,1,3,0,0,0,0,1,0,0,1
163179,2022,Iran,Bulgaria,0,1,8,9,21/06/2022,0,0,1,1,2,0,1,3,1,3,1,5,0,1,1,2,0,0,0,0
163179,2022,Iran,Japan,0,3,3,6,12/6/2022,0,0,0,0,2,1,3,6,0,6,1,7,2,0,1,3,2,1,1,4
163179,2022,Iran,Australia,1,4,15,20,12/6/2022,1,2,0,3,6,0,0,6,1,4,6,11,0,0,1,1,1,0,1,2
163179,2022,Netherlands,Iran,1,1,5,7,10/6/2022,0,0,0,0,1,0,0,1,0,4,0,4,0,0,2,2,0,0,0,0
163179,2022,China,Iran,2,2,12,16,7/6/2022,0,0,1,1,9,0,3,12,1,4,0,5,0,0,3,3,3,0,0,3
152741,2022,Canada,Iran,0,0,0,0,25/06/2022,0,0,0,0,0,0,0,0,0,0,0,0,0,0,0,0,0,0,0,0
152741,2022,Iran,Brazil,0,0,0,0,24/06/2022,0,0,0,0,0,0,0,0,0,0,0,0,0,0,0,0,0,0,0,0
152741,2022,USA,Iran,0,0,0,0,23/06/2022,0,0,0,0,0,0,0,0,0,0,0,0,0,0,0,0,0,0,0,0
152741,2022,Iran,Bulgaria,0,0,0,0,21/06/2022,0,0,0,0,0,0,0,0,0,0,0,0,0,0,3,3,1,0,0,1
152741,2022,Iran,Japan,0,1,1,2,12/6/2022,0,0,1,1,2,1,2,5,1,1,1,3,0,1,8,9,1,0,1,2
152741,2022,Iran,Australia,0,0,0,0,12/6/2022,0,0,0,0,0,0,0,0,0,0,0,0,0,0,0,0,0,0,0,0
152741,2022,Netherlands,Iran,0,0,0,0,10/6/2022,0,0,0,0,0,0,0,0,0,0,0,0,0,0,0,0,0,0,0,0
152741,2022,China,Iran,0,0,0,0,7/6/2022,0,0,0,0,0,0,0,0,0,0,0,0,0,0,0,0,0,0,0,0
163176,2022,Poland,Iran,0,0,0,0,21/07/2022,0,0,8,8,0,0,0,0,0,0,0,0,10,0,10,20,9,2,2,13
163176,2022,Iran,Serbia,0,0,0,0,9/7/2022,0,0,2,2,0,0,0,0,0,0,0,0,1,0,15,16,4,4,1,9
163176,2022,Slovenia,Iran,0,0,0,0,8/7/2022,0,0,4,4,0,0,0,0,0,0,0,0,4,1,3,8,7,2,2,11
163176,2022,Italy,Iran,0,0,0,0,7/7/2022,0,0,7,7,0,0,0,0,0,0,0,0,2,0,19,21,7,2,1,10
163176,2022,Iran,Poland,0,0,0,0,5/7/2022,0,0,3,3,0,0,0,0,0,0,0,0,6,3,11,20,5,2,0,7
163176,2022,Canada,Iran,0,0,0,0,25/06/2022,0,0,2,2,0,0,0,0,0,0,0,0,3,1,5,9,3,1,0,4
163176,2022,Iran,Brazil,0,0,0,0,24/06/2022,0,0,1,1,0,0,0,0,0,0,0,0,8,3,11,22,0,1,1,2
163176,2022,USA,Iran,0,0,0,0,23/06/2022,0,0,6,6,0,0,0,0,0,0,0,0,2,0,9,11,0,1,1,2
163176,2022,Iran,Bulgaria,0,0,0,0,21/06/2022,0,0,4,4,0,0,0,0,0,0,0,0,0,1,9,10,3,2,3,8
163176,2022,Iran,Japan,0,0,0,0,12/6/2022,2,0,0,2,0,0,0,0,0,0,0,0,0,0,4,4,4,1,0,5
163176,2022,Iran,Australia,0,0,0,0,12/6/2022,4,0,3,7,0,0,0,0,0,0,0,0,11,0,14,25,6,2,1,9
163176,2022,Netherlands,Iran,0,0,0,0,10/6/2022,5,0,0,5,0,0,0,0,0,0,0,0,8,0,11,19,6,3,3,12
163176,2022,China,Iran,0,0,0,0,7/6/2022,0,0,8,8,0,0,0,0,0,0,0,0,4,0,15,19,5,1,4,10
153535,2022,Canada,Iran,0,0,0,0,25/06/2022,0,0,0,0,0,0,0,0,0,0,0,0,0,0,0,0,0,0,0,0
153535,2022,Iran,Brazil,0,0,0,0,24/06/2022,0,0,0,0,0,0,0,0,0,0,0,0,0,0,0,0,0,0,0,0
153535,2022,USA,Iran,0,0,0,0,23/06/2022,0,0,0,0,0,0,0,0,0,0,0,0,0,0,0,0,0,0,0,0
153535,2022,Iran,Bulgaria,0,0,0,0,21/06/2022,0,0,0,0,0,0,0,0,0,0,0,0,2,0,3,5,0,1,0,1
153535,2022,Iran,Japan,0,0,0,0,12/6/2022,2,0,1,3,0,0,0,0,0,0,0,0,4,0,1,5,2,0,0,2
153535,2022,Iran,Australia,0,0,0,0,12/6/2022,0,0,0,0,0,0,0,0,0,0,0,0,0,0,0,0,0,0,0,0
153535,2022,Netherlands,Iran,0,0,0,0,10/6/2022,0,0,0,0,0,0,0,0,0,0,0,0,0,0,0,0,0,0,0,0
153535,2022,China,Iran,0,0,0,0,7/6/2022,0,0,0,0,0,0,0,0,0,0,0,0,0,0,0,0,0,0,0,0
164188,2022,Iran,Japan,0,0,5,5,12/6/2022,0,0,0,0,3,1,5,9,0,0,0,0,0,0,0,0,2,0,0,2
164188,2022,Iran,Australia,0,1,0,1,12/6/2022,0,0,0,0,0,0,0,0,0,0,0,0,0,0,0,0,0,0,0,0
164188,2022,Netherlands,Iran,0,0,1,1,10/6/2022,0,0,0,0,1,1,1,3,0,0,0,0,0,0,0,0,0,0,0,0
164188,2022,China,Iran,4,2,6,12,7/6/2022,0,1,0,1,3,5,5,13,0,1,1,2,0,0,1,1,4,1,0,5
124251,2022,,,-,-,-,-,-,-,-,-,-,-,-,-,-,-,-,-,-,-,-,-,-,-,-,-,-
152753,2022,Canada,Iran,0,0,0,0,25/06/2022,0,0,3,3,0,0,0,0,0,0,0,0,0,0,0,0,0,0,0,0
152753,2022,Iran,Brazil,0,0,2,2,24/06/2022,0,0,10,10,0,0,0,0,0,0,0,0,0,0,0,0,0,0,0,0
152753,2022,USA,Iran,0,0,0,0,23/06/2022,0,0,1,1,0,0,0,0,0,0,0,0,0,0,0,0,0,0,0,0
152753,2022,Iran,Bulgaria,0,1,0,1,21/06/2022,2,0,1,3,0,0,0,0,0,0,0,0,0,0,0,0,0,0,0,0
152753,2022,Iran,Japan,1,0,5,6,12/6/2022,12,2,21,35,0,0,2,2,0,0,1,1,0,0,0,0,2,1,0,3
152753,2022,Iran,Australia,0,0,0,0,12/6/2022,6,0,3,9,0,0,0,0,0,0,1,1,0,0,0,0,3,0,0,3
152753,2022,Netherlands,Iran,0,0,6,6,10/6/2022,9,1,17,27,1,0,0,1,0,3,0,3,0,0,1,1,1,1,1,3
152753,2022,China,Iran,0,0,0,0,7/6/2022,0,0,2,2,0,0,0,0,0,0,0,0,0,0,0,0,0,0,0,0
162557,2022,,,-,-,-,-,-,-,-,-,-,-,-,-,-,-,-,-,-,-,-,-,-,-,-,-,-
152743,2022,,,-,-,-,-,-,-,-,-,-,-,-,-,-,-,-,-,-,-,-,-,-,-,-,-,-
132534,2022,Poland,Iran,0,0,0,0,21/07/2022,0,0,0,0,0,0,0,0,0,0,0,0,0,0,0,0,0,0,0,0
132534,2022,Iran,Serbia,0,0,0,0,9/7/2022,0,0,0,0,0,0,0,0,0,0,0,0,0,0,0,0,0,0,0,0
132534,2022,Slovenia,Iran,0,0,0,0,8/7/2022,0,0,0,0,0,0,0,0,0,0,0,0,0,0,0,0,0,0,0,0
132534,2022,Italy,Iran,0,0,0,0,7/7/2022,0,0,0,0,0,0,0,0,0,0,0,0,0,0,0,0,0,0,0,0
132534,2022,Iran,Poland,0,0,0,0,5/7/2022,0,0,0,0,0,0,0,0,0,0,0,0,0,0,0,0,0,0,0,0
153539,2022,Poland,Iran,0,3,12,15,21/07/2022,1,0,1,2,21,9,9,39,1,6,4,11,1,0,0,1,2,2,2,6
153539,2022,Iran,Serbia,2,2,11,15,9/7/2022,0,0,2,2,13,2,9,24,1,4,0,5,0,0,0,0,4,2,0,6
153539,2022,Slovenia,Iran,3,5,14,22,8/7/2022,0,0,0,0,11,5,10,26,0,2,0,2,0,0,0,0,4,0,0,4
153539,2022,Italy,Iran,2,2,11,15,7/7/2022,0,0,5,5,18,6,18,42,3,2,0,5,0,0,2,2,0,2,0,2
153539,2022,Iran,Poland,3,4,17,24,5/7/2022,0,0,2,2,14,5,8,27,1,4,0,5,0,0,0,0,2,1,1,4
153539,2022,Canada,Iran,0,5,11,16,25/06/2022,0,0,0,0,15,3,6,24,0,1,2,3,0,0,0,0,2,0,3,5
153539,2022,Iran,Brazil,0,2,7,9,24/06/2022,0,0,0,0,15,3,3,21,0,2,2,4,0,0,0,0,0,0,0,0
153539,2022,USA,Iran,0,2,12,14,23/06/2022,0,1,0,1,19,4,6,29,1,1,3,5,0,0,1,1,1,1,1,3
153539,2022,Iran,Bulgaria,0,1,6,7,21/06/2022,0,0,0,0,15,6,8,29,2,2,0,4,0,0,0,0,2,0,1,3
153539,2022,Iran,Japan,2,2,4,8,12/6/2022,1,0,0,1,7,2,8,17,1,1,1,3,0,0,0,0,1,1,0,2
153539,2022,Iran,Australia,1,4,10,15,12/6/2022,1,0,0,1,21,7,9,37,1,2,3,6,0,0,0,0,7,2,1,10
153539,2022,Netherlands,Iran,0,2,8,10,10/6/2022,0,0,1,1,15,4,11,30,0,3,2,5,0,0,0,0,3,0,0,3
153539,2022,China,Iran,0,1,4,5,7/6/2022,0,0,0,0,6,0,0,6,1,0,2,3,0,0,0,0,1,0,0,1
119750,2022,Poland,Iran,0,1,16,17,21/07/2022,15,0,80,95,0,0,0,0,0,4,2,6,0,1,1,2,8,2,0,10
119750,2022,Iran,Serbia,1,1,7,9,9/7/2022,24,0,49,73,2,0,0,2,1,0,0,1,0,0,0,0,1,1,0,2
119750,2022,Slovenia,Iran,0,1,10,11,8/7/2022,18,0,44,62,0,0,0,0,3,1,0,4,0,0,0,0,0,1,0,1
119750,2022,Italy,Iran,0,0,14,14,7/7/2022,12,0,62,74,1,0,0,1,0,0,0,0,0,0,0,0,0,1,1,2
119750,2022,Iran,Poland,0,3,8,11,5/7/2022,19,0,75,94,0,0,1,1,0,3,0,3,0,0,0,0,1,0,1,2
119750,2022,Canada,Iran,0,1,10,11,25/06/2022,10,0,44,54,0,0,1,1,0,1,0,1,0,0,0,0,4,0,0,4
119750,2022,Iran,Brazil,0,0,8,8,24/06/2022,10,0,43,53,1,0,2,3,1,2,0,3,0,0,0,0,1,0,0,1
119750,2022,USA,Iran,0,1,11,12,23/06/2022,12,0,53,65,1,0,0,1,0,4,2,6,0,0,0,0,1,0,2,3
119750,2022,Iran,Bulgaria,0,1,13,14,21/06/2022,14,0,53,67,1,0,0,1,1,2,0,3,0,0,0,0,1,0,0,1
119750,2022,Iran,Japan,0,0,4,4,12/6/2022,8,0,16,24,0,0,0,0,0,1,1,2,0,0,0,0,4,0,0,4
119750,2022,Iran,Australia,0,0,12,12,12/6/2022,30,0,35,65,1,0,0,1,0,3,4,7,0,0,0,0,5,2,0,7
119750,2022,Netherlands,Iran,0,0,6,6,10/6/2022,13,0,27,40,0,0,0,0,0,1,0,1,0,0,0,0,3,1,0,4
119750,2022,China,Iran,2,0,11,13,7/6/2022,29,1,16,46,1,0,1,2,0,0,1,1,0,0,2,2,2,2,2,6
163174,2022,Poland,Iran,0,0,0,0,21/07/2022,0,0,0,0,1,0,0,1,0,0,0,0,2,0,2,4,0,1,0,1
163174,2022,Iran,Serbia,0,0,0,0,9/7/2022,0,0,0,0,0,0,0,0,0,0,0,0,0,0,0,0,0,0,0,0
163174,2022,Slovenia,Iran,0,0,0,0,8/7/2022,0,0,0,0,0,0,0,0,0,0,0,0,0,0,0,0,0,0,0,0
163174,2022,Italy,Iran,0,0,0,0,7/7/2022,0,0,0,0,0,0,0,0,0,0,0,0,0,0,2,2,0,0,0,0
163174,2022,Iran,Poland,0,0,0,0,5/7/2022,0,0,0,0,0,0,0,0,0,0,0,0,0,0,0,0,0,0,0,0
152762,2022,,,-,-,-,-,-,-,-,-,-,-,-,-,-,-,-,-,-,-,-,-,-,-,-,-,-
174560,2022,Poland,Iran,0,0,1,1,21/07/2022,0,0,0,0,1,1,0,2,0,0,0,0,0,0,0,0,0,0,0,0
174560,2022,Iran,Serbia,0,0,1,1,9/7/2022,0,0,0,0,0,0,0,0,0,0,0,0,0,0,0,0,0,0,0,0
174560,2022,Slovenia,Iran,0,0,0,0,8/7/2022,0,0,0,0,0,0,0,0,0,0,0,0,0,0,0,0,0,0,0,0
174560,2022,Italy,Iran,0,0,8,8,7/7/2022,0,0,0,0,1,0,0,1,0,2,0,2,0,0,0,0,1,0,1,2
174560,2022,Iran,Poland,0,0,1,1,5/7/2022,0,0,0,0,0,0,0,0,0,0,0,0,0,0,0,0,0,0,0,0
174560,2022,Canada,Iran,0,0,10,10,25/06/2022,0,0,1,1,3,0,1,4,1,2,4,7,0,0,0,0,0,1,0,1
174560,2022,Iran,Brazil,0,0,2,2,24/06/2022,0,0,0,0,0,1,0,1,0,2,0,2,0,0,0,0,0,1,0,1
174560,2022,USA,Iran,0,1,7,8,23/06/2022,0,0,0,0,0,0,1,1,1,0,0,1,0,0,2,2,0,0,0,0
174560,2022,Iran,Bulgaria,0,1,1,2,21/06/2022,0,0,0,0,0,0,0,0,0,0,0,0,0,0,0,0,1,0,0,1
152752,2022,Poland,Iran,1,4,9,14,21/07/2022,0,0,2,2,10,5,14,29,3,3,3,9,10,3,13,26,5,3,2,10
152752,2022,Iran,Serbia,2,2,8,12,9/7/2022,0,0,4,4,11,3,7,21,4,3,0,7,4,0,21,25,1,0,0,1
152752,2022,Slovenia,Iran,1,3,6,10,8/7/2022,0,0,0,0,8,3,5,16,1,0,0,1,3,1,19,23,1,1,1,3
152752,2022,Italy,Iran,1,5,2,8,7/7/2022,0,0,2,2,4,4,6,14,0,0,0,0,3,1,12,16,1,0,1,2
152752,2022,Iran,Poland,2,2,14,18,5/7/2022,0,0,1,1,19,3,10,32,0,4,1,5,3,4,34,41,1,3,1,5
152752,2022,Canada,Iran,2,3,6,11,25/06/2022,0,0,1,1,12,1,8,21,0,1,3,4,8,2,11,21,2,2,0,4
152752,2022,Iran,Brazil,1,4,3,8,24/06/2022,0,0,0,0,4,3,5,12,1,3,1,5,5,1,10,16,0,0,0,0
152752,2022,USA,Iran,3,5,9,17,23/06/2022,0,0,0,0,8,1,4,13,2,2,2,6,5,1,20,26,1,1,0,2
152752,2022,Iran,Bulgaria,0,0,7,7,21/06/2022,0,0,1,1,8,5,4,17,0,1,1,2,5,2,9,16,0,1,0,1
152752,2022,Iran,Japan,0,2,2,4,12/6/2022,1,0,1,2,4,1,1,6,0,2,4,6,3,5,5,13,1,0,1,2
152752,2022,Iran,Australia,1,3,14,18,12/6/2022,1,0,1,2,10,2,8,20,3,1,4,8,6,2,14,22,3,2,2,7
152752,2022,Netherlands,Iran,2,1,3,6,10/6/2022,0,0,0,0,3,0,1,4,0,3,2,5,4,0,5,9,3,1,1,5
152752,2022,China,Iran,0,0,0,0,7/6/2022,0,0,0,0,0,0,0,0,0,0,0,0,0,0,0,0,0,0,0,0
168551,2022,Poland,Iran,0,0,0,0,21/07/2022,0,0,1,1,0,0,0,0,0,0,0,0,0,0,0,0,0,0,0,0
168551,2022,Iran,Serbia,0,0,0,0,9/7/2022,0,0,0,0,0,0,0,0,0,0,0,0,0,0,0,0,0,0,0,0
168551,2022,Slovenia,Iran,0,0,0,0,8/7/2022,0,0,0,0,1,0,0,1,0,0,0,0,0,0,0,0,0,0,0,0
168551,2022,Italy,Iran,0,0,0,0,7/7/2022,0,0,0,0,0,0,0,0,0,0,0,0,0,0,0,0,0,0,0,0
168551,2022,Iran,Poland,0,0,0,0,5/7/2022,0,0,0,0,0,0,0,0,0,1,0,1,0,0,0,0,0,0,0,0
168551,2022,Canada,Iran,0,0,0,0,25/06/2022,0,0,0,0,0,0,0,0,0,0,0,0,0,0,0,0,0,0,0,0
168551,2022,Iran,Brazil,1,1,1,3,24/06/2022,0,0,0,0,1,0,4,5,0,1,0,1,0,0,0,0,1,1,0,2
168551,2022,USA,Iran,0,0,0,0,23/06/2022,0,0,0,0,0,0,0,0,0,0,0,0,0,0,0,0,0,0,0,0
168551,2022,Iran,Bulgaria,0,0,1,1,21/06/2022,0,0,0,0,2,0,0,2,0,0,0,0,0,0,0,0,0,0,0,0
152755,2022,,,-,-,-,-,-,-,-,-,-,-,-,-,-,-,-,-,-,-,-,-,-,-,-,-,-
189118,2022,Poland,Iran,0,0,1,1,21/07/2022,3,0,1,4,0,0,0,0,0,0,0,0,0,0,0,0,0,0,0,0
189118,2022,Iran,Serbia,0,0,0,0,9/7/2022,0,0,0,0,0,0,0,0,0,0,0,0,0,0,0,0,0,0,0,0
189118,2022,Slovenia,Iran,0,0,0,0,8/7/2022,0,0,0,0,0,0,0,0,0,0,0,0,0,0,0,0,0,0,0,0
189118,2022,Italy,Iran,0,1,1,2,7/7/2022,1,0,22,23,0,0,1,1,0,0,0,0,0,0,0,0,0,0,0,0
189118,2022,Iran,Poland,0,0,1,1,5/7/2022,0,0,1,1,0,0,0,0,0,0,0,0,0,0,0,0,0,0,0,0
189175,2022,Poland,Iran,0,0,0,0,21/07/2022,0,0,0,0,0,0,0,0,0,0,0,0,0,0,0,0,0,0,0,0
189175,2022,Iran,Serbia,0,0,0,0,9/7/2022,0,0,0,0,0,0,0,0,0,0,0,0,0,0,0,0,0,0,0,0
189175,2022,Slovenia,Iran,0,0,0,0,8/7/2022,0,0,0,0,0,0,0,0,0,0,0,0,0,0,0,0,0,0,0,0
189175,2022,Italy,Iran,0,1,0,1,7/7/2022,0,0,0,0,0,0,0,0,0,0,0,0,0,0,0,0,0,0,0,0
189175,2022,Iran,Poland,0,0,0,0,5/7/2022,0,0,0,0,0,0,0,0,0,0,0,0,0,0,0,0,0,0,0,0
189175,2022,Canada,Iran,0,0,0,0,25/06/2022,0,0,0,0,0,0,0,0,0,0,0,0,0,0,0,0,0,0,0,0
189175,2022,Iran,Brazil,0,1,1,2,24/06/2022,0,0,0,0,0,0,1,1,0,1,0,1,0,0,0,0,0,0,0,0
189175,2022,USA,Iran,0,0,0,0,23/06/2022,0,0,0,0,0,0,0,0,0,0,0,0,0,0,0,0,0,0,0,0
189175,2022,Iran,Bulgaria,0,0,0,0,21/06/2022,0,0,0,0,0,0,0,0,0,0,0,0,0,0,0,0,0,0,0,0
189175,2022,Iran,Japan,0,1,2,3,12/6/2022,0,1,0,1,1,1,1,3,0,2,3,5,0,0,1,1,0,1,0,1
189175,2022,Iran,Australia,0,0,0,0,12/6/2022,0,0,0,0,0,0,0,0,0,0,0,0,0,0,0,0,0,0,0,0
189175,2022,Netherlands,Iran,1,1,4,6,10/6/2022,0,0,0,0,4,0,2,6,0,4,4,8,0,0,0,0,1,0,0,1
189175,2022,China,Iran,0,0,0,0,7/6/2022,0,0,0,0,0,0,0,0,0,0,0,0,0,0,0,0,0,0,0,0
182187,2022,,,-,-,-,-,-,-,-,-,-,-,-,-,-,-,-,-,-,-,-,-,-,-,-,-,-
152742,2022,Poland,Iran,0,1,2,3,21/07/2022,0,0,0,0,1,0,0,1,0,1,0,1,0,0,4,4,0,1,0,1
152742,2022,Iran,Serbia,0,1,0,1,9/7/2022,0,0,0,0,0,0,0,0,0,0,0,0,0,0,3,3,0,0,0,0
152742,2022,Slovenia,Iran,0,0,1,1,8/7/2022,0,0,0,0,0,0,0,0,0,0,0,0,0,0,0,0,0,0,0,0
152742,2022,Italy,Iran,0,2,2,4,7/7/2022,0,0,0,0,3,4,3,10,1,1,0,2,1,0,13,14,4,0,0,4
152742,2022,Iran,Poland,0,0,1,1,5/7/2022,0,0,0,0,0,0,0,0,0,0,0,0,0,0,0,0,0,0,0,0
152742,2022,Canada,Iran,0,0,1,1,25/06/2022,0,0,0,0,0,0,0,0,0,0,0,0,0,0,0,0,0,0,0,0
152742,2022,Iran,Brazil,1,1,2,4,24/06/2022,0,0,0,0,4,0,0,4,0,1,0,1,1,1,5,7,0,2,0,2
152742,2022,USA,Iran,0,0,3,3,23/06/2022,0,0,0,0,0,0,0,0,0,0,0,0,0,0,0,0,1,0,0,1
152742,2022,Iran,Bulgaria,1,4,5,10,21/06/2022,0,0,0,0,10,4,6,20,0,2,0,2,2,2,18,22,0,0,0,0
152742,2022,Iran,Japan,1,3,1,5,12/6/2022,0,0,1,1,4,1,3,8,0,0,0,0,1,1,6,8,2,0,0,2
152742,2022,Iran,Australia,0,0,0,0,12/6/2022,0,0,0,0,0,0,0,0,0,0,0,0,0,0,0,0,0,0,0,0
152742,2022,Netherlands,Iran,0,2,5,7,10/6/2022,1,0,0,1,4,4,2,10,0,3,2,5,1,1,5,7,0,0,1,1
152742,2022,China,Iran,4,3,12,19,7/6/2022,0,0,2,2,14,1,5,20,2,1,2,5,2,2,8,12,3,0,0,3
162518,2022,Italy,China,2,3,7,12,26/06/2022,0,0,0,0,12,4,4,20,1,4,1,6,0,0,0,0,6,0,2,8
162518,2022,Italy,Slovenia,0,2,2,4,25/06/2022,1,0,0,1,5,2,1,8,0,3,1,4,0,0,0,0,3,1,0,4
162518,2022,Japan,Italy,0,0,0,0,24/06/2022,0,0,0,0,0,0,0,0,0,0,0,0,0,0,0,0,0,0,0,0
162518,2022,Germany,Italy,0,1,3,4,22/06/2022,0,0,0,0,0,0,0,0,0,0,0,0,0,0,0,0,0,0,0,0
162518,2022,Argentina,Italy,0,3,2,5,12/6/2022,0,0,2,2,9,3,11,23,0,0,4,4,0,0,0,0,0,3,1,4
162518,2022,Canada,Italy,0,0,0,0,11/6/2022,0,0,0,0,0,1,0,1,0,0,0,0,0,0,0,0,0,0,0,0
162518,2022,Poland,Italy,0,0,0,0,9/6/2022,0,0,0,0,0,0,0,0,0,0,0,0,0,0,0,0,0,0,0,0
162518,2022,France,Italy,0,0,0,0,8/6/2022,0,0,0,0,0,0,0,0,0,0,0,0,0,0,0,0,0,0,0,0
141638,2022,Italy,China,0,0,1,1,26/06/2022,0,0,0,0,0,0,0,0,0,0,0,0,0,0,0,0,0,0,0,0
141638,2022,Italy,Slovenia,0,0,0,0,25/06/2022,0,0,0,0,0,0,0,0,0,0,0,0,0,0,0,0,0,0,0,0
141638,2022,Japan,Italy,0,0,0,0,24/06/2022,0,0,0,0,0,0,0,0,0,0,0,0,0,0,0,0,0,0,0,0
141638,2022,Germany,Italy,0,0,0,0,22/06/2022,0,0,0,0,0,0,0,0,0,0,0,0,0,0,0,0,0,0,0,0
163033,2022,Italy,Poland,0,0,0,0,24/07/2022,0,0,0,0,0,0,0,0,0,0,0,0,0,0,0,0,0,0,0,0
163033,2022,Italy,France,0,1,1,2,23/07/2022,0,0,0,0,0,0,2,2,0,0,0,0,1,1,1,3,1,0,0,1
163033,2022,Italy,Netherlands,0,0,0,0,20/07/2022,0,0,0,0,0,0,0,0,0,0,0,0,0,0,0,0,0,0,0,0
163033,2022,Argentina,Italy,0,4,15,19,12/6/2022,0,0,4,4,13,4,6,23,2,3,2,7,5,1,23,29,5,0,3,8
163033,2022,Canada,Italy,0,2,7,9,11/6/2022,0,0,2,2,7,4,4,15,0,1,1,2,6,0,12,18,5,0,1,6
163033,2022,Poland,Italy,0,2,14,16,9/6/2022,0,0,8,8,8,3,14,25,1,3,1,5,3,2,17,22,5,2,4,11
163033,2022,France,Italy,1,3,9,13,8/6/2022,0,0,8,8,8,2,5,15,0,5,1,6,2,1,19,22,7,2,3,12
152492,2022,Italy,Netherlands,0,0,0,0,10/7/2022,0,0,0,0,0,0,0,0,0,0,0,0,0,0,0,0,0,0,0,0
152492,2022,Italy,Serbia,0,0,0,0,8/7/2022,0,0,0,0,0,0,0,0,0,0,0,0,0,0,0,0,0,0,0,0
152492,2022,Italy,Iran,0,0,0,0,7/7/2022,0,0,0,0,0,0,0,0,0,0,0,0,0,0,0,0,0,0,0,0
152492,2022,Bulgaria,Italy,0,0,0,0,5/7/2022,0,0,0,0,0,0,0,0,0,0,0,0,0,0,0,0,0,0,0,0
152492,2022,Italy,China,0,0,0,0,26/06/2022,0,0,0,0,0,0,0,0,0,0,0,0,0,0,0,0,0,0,0,0
152492,2022,Italy,Slovenia,0,0,0,0,25/06/2022,0,0,0,0,0,0,0,0,0,0,0,0,0,0,0,0,0,0,0,0
152492,2022,Japan,Italy,0,0,0,0,24/06/2022,0,0,0,0,0,0,0,0,0,0,0,0,0,1,1,2,0,0,0,0
152492,2022,Germany,Italy,0,0,0,0,22/06/2022,0,0,0,0,0,0,0,0,0,0,0,0,0,0,0,0,0,0,0,0
171191,2022,Italy,Poland,1,3,7,11,24/07/2022,0,0,4,4,3,4,7,14,1,2,3,6,1,3,8,12,2,2,0,4
171191,2022,Italy,France,1,1,11,13,23/07/2022,0,0,1,1,9,2,4,15,0,3,2,5,11,3,6,20,3,5,0,8
171191,2022,Italy,Netherlands,1,2,11,14,20/07/2022,0,0,3,3,10,5,10,25,1,4,5,10,3,0,14,17,2,3,1,6
171191,2022,Italy,Netherlands,3,2,12,17,10/7/2022,0,0,0,0,9,4,5,18,2,3,0,5,0,0,15,15,1,1,0,2
171191,2022,Italy,Serbia,0,1,14,15,8/7/2022,0,0,0,0,7,4,6,17,0,3,0,3,2,0,6,8,5,0,1,6
171191,2022,Italy,Iran,0,0,19,19,7/7/2022,0,0,0,0,11,1,10,22,0,2,0,2,3,2,23,28,4,1,0,5
171191,2022,Bulgaria,Italy,1,1,13,15,5/7/2022,0,0,3,3,10,1,9,20,1,0,0,1,5,0,19,24,2,0,1,3
171191,2022,Italy,China,1,2,8,11,26/06/2022,0,0,1,1,8,2,5,15,0,1,1,2,8,2,14,24,3,0,0,3
171191,2022,Italy,Slovenia,1,2,10,13,25/06/2022,0,0,1,1,13,1,10,24,2,1,1,4,8,0,10,18,6,2,1,9
171191,2022,Japan,Italy,0,6,8,14,24/06/2022,0,0,2,2,14,2,5,21,2,2,0,4,11,5,26,42,4,1,0,5
171191,2022,Germany,Italy,1,1,8,10,22/06/2022,0,0,0,0,6,5,4,15,1,1,0,2,1,1,11,13,6,2,1,9
144005,2022,Italy,Poland,0,1,7,8,24/07/2022,9,0,60,69,1,0,3,4,0,6,2,8,0,0,0,0,8,1,0,9
144005,2022,Italy,France,0,0,11,11,23/07/2022,14,0,38,52,0,0,1,1,0,4,1,5,0,0,1,1,3,2,0,5
144005,2022,Italy,Netherlands,0,1,20,21,20/07/2022,16,1,67,84,1,0,1,2,2,7,2,11,0,0,2,2,5,1,1,7
144005,2022,Italy,Netherlands,0,4,9,13,10/7/2022,11,0,58,69,1,0,0,1,0,2,0,2,0,0,1,1,1,0,0,1
144005,2022,Italy,Serbia,0,1,9,10,8/7/2022,13,0,51,64,2,0,2,4,3,1,0,4,0,0,0,0,0,2,0,2
144005,2022,Italy,Iran,3,2,11,16,7/7/2022,26,0,70,96,2,1,1,4,2,3,0,5,0,0,2,2,2,2,0,4
144005,2022,Bulgaria,Italy,3,1,10,14,5/7/2022,7,1,51,59,2,0,0,2,2,1,0,3,0,0,1,1,2,0,0,2
144005,2022,Italy,China,1,2,9,12,26/06/2022,16,1,40,57,1,0,1,2,3,0,3,6,0,0,0,0,2,1,1,4
144005,2022,Italy,Slovenia,1,2,10,13,25/06/2022,20,0,43,63,4,0,0,4,0,4,0,4,0,0,0,0,6,1,0,7
144005,2022,Japan,Italy,1,2,20,23,24/06/2022,31,0,60,91,4,0,1,5,3,0,4,7,0,0,0,0,6,1,2,9
144005,2022,Germany,Italy,0,2,8,10,22/06/2022,16,0,38,54,0,0,0,0,1,2,2,5,0,0,0,0,5,1,2,8
144005,2022,Argentina,Italy,1,2,12,15,12/6/2022,52,0,35,87,1,0,3,4,1,2,3,6,0,0,0,0,6,7,2,15
144005,2022,Canada,Italy,1,4,14,19,11/6/2022,0,0,71,71,6,0,0,6,2,1,1,4,0,0,0,0,5,1,0,6
144005,2022,Poland,Italy,0,5,11,16,9/6/2022,32,0,38,70,4,0,4,8,0,3,4,7,0,0,0,0,6,2,4,12
144005,2022,France,Italy,1,3,8,12,8/6/2022,45,1,22,68,0,1,2,3,4,4,1,9,0,0,0,0,8,3,1,12
150436,2022,Italy,Poland,0,0,0,0,24/07/2022,0,0,7,7,0,0,0,0,0,0,0,0,3,6,10,19,13,3,2,18
150436,2022,Italy,France,0,0,0,0,23/07/2022,0,0,4,4,0,0,0,0,0,0,0,0,6,1,11,18,7,2,1,10
150436,2022,Italy,Netherlands,0,0,0,0,20/07/2022,0,0,4,4,0,0,0,0,0,0,0,0,3,3,18,24,15,1,0,16
150436,2022,Italy,Netherlands,0,0,0,0,10/7/2022,0,0,0,0,0,0,0,0,0,0,0,0,0,0,0,0,0,0,0,0
150436,2022,Italy,Serbia,0,0,0,0,8/7/2022,0,0,0,0,0,0,0,0,0,0,0,0,2,1,4,7,3,0,0,3
150436,2022,Italy,Iran,0,0,0,0,7/7/2022,0,0,4,4,0,0,0,0,0,0,0,0,7,1,12,20,5,3,1,9
150436,2022,Bulgaria,Italy,0,0,0,0,5/7/2022,0,0,4,4,0,0,0,0,0,0,0,0,1,1,11,13,3,3,1,7
150436,2022,Italy,China,0,0,0,0,26/06/2022,0,0,1,1,0,0,0,0,0,0,0,0,4,0,5,9,9,2,1,12
150436,2022,Italy,Slovenia,0,0,0,0,25/06/2022,0,1,6,7,0,0,0,0,0,0,0,0,3,0,3,6,7,1,2,10
150436,2022,Japan,Italy,0,0,0,0,24/06/2022,1,0,7,8,0,0,0,0,0,0,0,0,6,3,13,22,8,2,1,11
150436,2022,Germany,Italy,0,0,0,0,22/06/2022,0,0,4,4,0,0,0,0,0,0,0,0,4,2,11,17,6,2,0,8
152370,2022,Italy,Poland,0,1,3,4,24/07/2022,0,0,0,0,0,0,0,0,0,0,0,0,0,0,0,0,0,0,0,0
152370,2022,Italy,France,0,0,2,2,23/07/2022,5,0,8,13,0,0,0,0,0,2,0,2,0,0,0,0,0,0,0,0
152370,2022,Italy,Netherlands,0,0,0,0,20/07/2022,0,0,0,0,0,0,0,0,0,0,0,0,0,0,0,0,0,0,0,0
152370,2022,Italy,Netherlands,0,0,3,3,10/7/2022,0,0,4,4,0,0,0,0,0,0,0,0,0,0,0,0,0,0,0,0
152370,2022,Italy,Serbia,0,0,0,0,8/7/2022,1,1,5,7,0,0,0,0,0,0,0,0,0,0,0,0,0,0,0,0
152370,2022,Italy,Iran,0,1,1,2,7/7/2022,0,0,1,1,0,0,0,0,0,0,0,0,0,0,0,0,0,0,0,0
152370,2022,Bulgaria,Italy,0,0,1,1,5/7/2022,0,0,0,0,0,0,0,0,0,0,0,0,0,0,0,0,0,0,0,0
152370,2022,Italy,China,0,1,1,2,26/06/2022,3,0,8,11,0,0,0,0,1,1,0,2,0,0,0,0,0,0,0,0
152370,2022,Italy,Slovenia,0,0,3,3,25/06/2022,1,0,9,10,0,0,0,0,0,2,1,3,0,0,0,0,0,0,0,0
152370,2022,Japan,Italy,0,0,5,5,24/06/2022,0,0,0,0,0,0,0,0,0,0,0,0,0,0,0,0,0,0,0,0
152370,2022,Germany,Italy,0,0,0,0,22/06/2022,0,0,0,0,0,0,0,0,0,0,0,0,0,0,0,0,0,0,0,0
120511,2022,Italy,Poland,0,0,0,0,24/07/2022,0,0,0,0,0,0,0,0,0,0,0,0,0,0,0,0,0,0,0,0
120511,2022,Italy,France,0,1,1,2,23/07/2022,0,0,1,1,5,2,2,9,0,2,1,3,1,1,1,3,0,1,0,1
120511,2022,Italy,Netherlands,0,1,1,2,20/07/2022,0,0,0,0,1,0,0,1,0,0,0,0,0,0,0,0,2,0,0,2
120511,2022,Italy,Netherlands,0,4,7,11,10/7/2022,0,0,0,0,11,5,8,24,0,4,0,4,0,0,2,2,2,1,0,3
120511,2022,Italy,Serbia,0,0,0,0,8/7/2022,0,0,0,0,0,0,0,0,0,0,0,0,0,0,0,0,0,0,0,0
120511,2022,Italy,Iran,1,5,9,15,7/7/2022,0,0,1,1,14,5,11,30,2,2,0,4,0,0,3,3,3,0,2,5
120511,2022,Bulgaria,Italy,0,0,0,0,5/7/2022,0,0,0,0,0,0,0,0,0,0,0,0,0,0,0,0,0,0,0,0
115843,2022,Argentina,Italy,0,1,2,3,12/6/2022,5,1,4,10,0,0,0,0,0,0,1,1,0,0,0,0,0,0,0,0
115843,2022,Canada,Italy,0,0,0,0,11/6/2022,0,0,0,0,0,0,0,0,0,0,0,0,0,0,0,0,0,0,0,0
115843,2022,Poland,Italy,0,0,0,0,9/6/2022,0,0,0,0,0,0,0,0,0,0,0,0,0,0,0,0,0,0,0,0
115843,2022,France,Italy,0,0,0,0,8/6/2022,0,0,0,0,0,0,0,0,0,0,0,0,0,0,0,0,0,0,0,0
152422,2022,Argentina,Italy,0,0,0,0,12/6/2022,0,0,0,0,0,0,0,0,0,0,0,0,0,0,0,0,0,0,0,0
152422,2022,Canada,Italy,0,0,0,0,11/6/2022,0,0,0,0,0,0,0,0,0,0,0,0,0,0,0,0,0,0,0,0
152422,2022,Poland,Italy,0,0,0,0,9/6/2022,0,0,0,0,0,0,0,0,0,0,0,0,0,0,0,0,0,0,0,0
152422,2022,France,Italy,0,1,2,3,8/6/2022,0,0,1,1,0,1,7,8,0,0,2,2,0,2,6,8,1,1,0,2
163447,2022,Italy,Poland,0,0,0,0,24/07/2022,0,0,0,0,0,0,0,0,0,0,0,0,0,0,0,0,0,0,0,0
163447,2022,Italy,France,0,0,1,1,23/07/2022,0,0,1,1,0,1,1,2,0,0,0,0,1,1,1,3,0,2,0,2
163447,2022,Italy,Netherlands,0,0,0,0,20/07/2022,0,0,0,0,0,0,0,0,0,0,0,0,0,1,0,1,0,0,0,0
163447,2022,Italy,Netherlands,0,0,0,0,10/7/2022,0,0,0,0,0,0,0,0,0,0,0,0,0,0,0,0,0,0,0,0
163447,2022,Italy,Serbia,0,0,0,0,8/7/2022,0,0,0,0,0,0,0,0,0,0,0,0,0,0,0,0,0,0,0,0
163447,2022,Italy,Iran,2,2,4,8,7/7/2022,0,0,1,1,2,3,5,10,0,0,0,0,1,1,6,8,2,0,0,2
163447,2022,Bulgaria,Italy,0,0,0,0,5/7/2022,0,0,0,0,0,0,0,0,0,0,0,0,0,0,0,0,0,0,0,0
163447,2022,Italy,China,0,1,1,2,26/06/2022,0,0,0,0,2,1,2,5,0,2,2,4,0,0,6,6,0,0,0,0
163447,2022,Italy,Slovenia,0,0,0,0,25/06/2022,0,0,0,0,0,0,0,0,0,0,0,0,0,0,0,0,0,0,0,0
163447,2022,Japan,Italy,0,1,2,3,24/06/2022,0,0,0,0,0,0,0,0,0,1,0,1,1,1,1,3,0,2,0,2
163447,2022,Germany,Italy,0,0,0,0,22/06/2022,0,0,0,0,0,0,0,0,0,0,0,0,0,0,0,0,0,0,0,0
163447,2022,Argentina,Italy,4,4,11,19,12/6/2022,0,0,1,1,14,4,12,30,3,5,5,13,5,1,18,24,4,2,4,10
163447,2022,Canada,Italy,1,4,9,14,11/6/2022,0,0,2,2,11,5,9,25,1,1,2,4,0,0,13,13,8,0,0,8
163447,2022,Poland,Italy,2,3,15,20,9/6/2022,1,0,5,6,13,4,1,18,1,2,0,3,7,1,19,27,1,0,2,3
163447,2022,France,Italy,0,2,7,9,8/6/2022,0,0,0,0,3,5,10,18,0,2,2,4,1,0,13,14,2,2,0,4
163028,2022,Italy,Poland,0,0,0,0,24/07/2022,0,0,0,0,0,0,0,0,0,0,0,0,0,0,0,0,0,0,0,0
163028,2022,Italy,France,0,0,0,0,23/07/2022,0,0,0,0,0,0,0,0,0,0,0,0,0,0,0,0,0,0,0,0
163028,2022,Italy,Netherlands,0,0,0,0,20/07/2022,0,0,0,0,0,0,0,0,0,0,0,0,0,0,0,0,0,0,0,0
163028,2022,Italy,Netherlands,0,0,0,0,10/7/2022,0,0,0,0,0,0,0,0,0,0,0,0,0,0,0,0,0,0,0,0
163028,2022,Italy,Serbia,0,0,3,3,8/7/2022,0,0,0,0,3,0,4,7,2,5,0,7,0,0,0,0,0,1,0,1
163028,2022,Italy,Iran,0,0,0,0,7/7/2022,0,0,0,0,0,0,0,0,0,0,0,0,0,0,0,0,0,0,0,0
163028,2022,Bulgaria,Italy,0,0,0,0,5/7/2022,0,0,0,0,0,0,0,0,0,0,0,0,0,0,0,0,0,0,0,0
163028,2022,Argentina,Italy,0,0,0,0,12/6/2022,0,0,0,0,0,0,0,0,0,0,0,0,0,0,0,0,0,0,0,0
163028,2022,Canada,Italy,0,0,0,0,11/6/2022,0,0,0,0,0,0,0,0,0,0,0,0,0,0,0,0,0,0,0,0
163028,2022,Poland,Italy,0,2,4,6,9/6/2022,0,0,0,0,2,0,4,6,0,2,0,2,0,0,0,0,0,0,2,2
163028,2022,France,Italy,0,3,5,8,8/6/2022,0,0,1,1,5,1,2,8,0,3,4,7,0,0,2,2,2,0,1,3
152408,2022,Italy,Poland,0,2,2,4,24/07/2022,0,0,1,1,2,1,3,6,1,1,4,6,0,0,1,1,0,0,0,0
152408,2022,Italy,France,1,2,5,8,23/07/2022,0,0,0,0,5,0,1,6,0,2,4,6,0,0,0,0,0,0,0,0
152408,2022,Italy,Netherlands,1,0,2,3,20/07/2022,0,0,0,0,4,0,3,7,2,2,2,6,0,0,0,0,1,0,0,1
152408,2022,Italy,Netherlands,1,2,2,5,10/7/2022,0,0,0,0,3,0,2,5,2,2,0,4,0,0,0,0,0,0,0,0
152408,2022,Italy,Serbia,0,2,4,6,8/7/2022,0,0,1,1,3,0,2,5,3,3,0,6,0,0,0,0,0,0,0,0
152408,2022,Italy,Iran,2,2,13,17,7/7/2022,0,0,0,0,9,0,1,10,2,3,0,5,0,0,0,0,0,0,0,0
152408,2022,Bulgaria,Italy,0,0,4,4,5/7/2022,0,0,0,0,0,0,0,0,0,0,0,0,0,0,0,0,0,0,1,1
152408,2022,Italy,China,0,3,5,8,26/06/2022,0,0,0,0,3,0,4,7,1,5,4,10,0,0,1,1,2,1,0,3
152408,2022,Italy,Slovenia,1,3,5,9,25/06/2022,1,0,1,2,5,1,3,9,1,2,2,5,0,0,0,0,1,0,0,1
152408,2022,Japan,Italy,1,4,8,13,24/06/2022,0,0,0,0,6,0,5,11,1,8,5,14,1,0,0,1,2,1,1,4
152408,2022,Germany,Italy,0,3,6,9,22/06/2022,0,0,0,0,7,0,1,8,4,6,2,12,0,0,0,0,1,1,0,2
152408,2022,Argentina,Italy,0,2,5,7,12/6/2022,0,0,0,0,3,3,2,8,2,2,2,6,0,0,0,0,0,1,1,2
152408,2022,Canada,Italy,0,0,10,10,11/6/2022,0,0,0,0,5,2,0,7,1,2,1,4,0,0,2,2,1,0,0,1
152408,2022,Poland,Italy,2,2,3,7,9/6/2022,0,0,0,0,2,2,3,7,1,5,3,9,0,0,0,0,0,0,4,4
152408,2022,France,Italy,0,1,6,7,8/6/2022,0,0,1,1,3,1,4,8,0,2,4,6,0,0,2,2,0,0,4,4
153200,2022,Italy,Poland,0,1,10,11,24/07/2022,1,0,4,5,14,3,16,33,0,0,1,1,6,0,14,20,6,4,0,10
153200,2022,Italy,France,0,0,6,6,23/07/2022,0,0,1,1,4,2,11,17,2,3,1,6,0,4,5,9,2,1,0,3
153200,2022,Italy,Netherlands,1,1,14,16,20/07/2022,1,0,2,3,10,1,12,23,2,5,0,7,6,2,9,17,10,1,1,12
153200,2022,Italy,Netherlands,0,0,15,15,10/7/2022,0,0,0,0,15,3,7,25,0,2,0,2,0,3,11,14,2,1,0,3
153200,2022,Italy,Serbia,2,1,15,18,8/7/2022,0,0,0,0,7,3,7,17,1,1,0,2,5,1,26,32,1,1,1,3
153200,2022,Italy,Iran,0,2,8,10,7/7/2022,0,0,1,1,11,5,8,24,0,3,0,3,2,4,6,12,2,1,0,3
153200,2022,Bulgaria,Italy,0,1,11,12,5/7/2022,0,0,0,0,10,1,7,18,2,3,1,6,1,0,8,9,3,1,2,6
153200,2022,Italy,China,3,2,12,17,26/06/2022,0,0,2,2,16,1,6,23,3,3,0,6,4,0,2,6,5,0,0,5
153200,2022,Italy,Slovenia,2,2,10,14,25/06/2022,0,0,2,2,12,2,10,24,0,2,0,2,5,0,19,24,2,0,2,4
153200,2022,Japan,Italy,1,3,14,18,24/06/2022,0,0,1,1,18,2,11,31,3,5,6,14,7,4,15,26,1,1,1,3
153200,2022,Germany,Italy,0,1,11,12,22/06/2022,0,0,1,1,8,2,8,18,1,2,0,3,2,0,11,13,1,0,0,1
162520,2022,Italy,Poland,0,4,8,12,24/07/2022,0,0,1,1,12,5,11,28,0,1,0,1,,,,,4,1,0,5
162520,2022,Italy,France,0,3,2,5,23/07/2022,0,0,0,0,6,1,8,15,0,1,0,1,,,,,6,1,0,7
162520,2022,Italy,Netherlands,4,0,12,16,20/07/2022,0,0,1,1,12,6,8,26,0,7,5,12,,,,,1,2,0,3
162520,2022,Italy,Netherlands,0,0,0,0,10/7/2022,0,0,0,0,0,0,0,0,0,0,0,0,,,,,0,0,0,0
162520,2022,Italy,Serbia,3,3,8,14,8/7/2022,0,0,1,1,9,3,7,19,1,2,0,3,,,,,1,0,0,1
162520,2022,Italy,Iran,0,0,0,0,7/7/2022,0,0,0,0,0,0,0,0,0,0,0,0,,,,,0,0,0,0
162520,2022,Bulgaria,Italy,1,3,8,12,5/7/2022,0,0,1,1,10,3,7,20,2,2,0,4,,,,,0,0,0,0
162520,2022,Italy,China,0,0,0,0,26/06/2022,0,0,0,0,0,0,0,0,0,0,0,0,,,,,0,0,0,0
162520,2022,Italy,Slovenia,1,1,3,5,25/06/2022,0,0,0,0,4,2,4,10,1,1,0,2,,,,,7,1,0,8
162520,2022,Japan,Italy,0,6,8,14,24/06/2022,0,0,0,0,14,3,11,28,2,3,3,8,,,,,7,1,0,8
162520,2022,Germany,Italy,2,4,10,16,22/06/2022,0,0,0,0,10,2,4,16,1,2,5,8,,,,,2,3,0,5
162520,2022,Argentina,Italy,0,3,2,5,12/6/2022,0,0,1,1,2,2,8,12,2,2,2,6,,,,,1,1,1,3
162520,2022,Canada,Italy,1,2,6,9,11/6/2022,0,0,0,0,11,3,8,22,1,1,1,3,,,,,2,0,0,2
162520,2022,Poland,Italy,0,6,10,16,9/6/2022,1,0,1,2,16,5,9,30,0,7,1,8,,,,,7,1,1,9
162520,2022,France,Italy,0,4,9,13,8/6/2022,0,0,2,2,14,5,13,32,2,1,0,3,,,,,3,1,5,9
124865,2022,Italy,Poland,0,0,8,8,24/07/2022,0,0,0,0,1,0,5,6,0,6,2,8,0,0,0,0,2,0,0,2
124865,2022,Italy,France,0,0,1,1,23/07/2022,0,0,0,0,0,0,0,0,1,2,1,4,0,0,0,0,1,0,0,1
124865,2022,Italy,Netherlands,0,1,4,5,20/07/2022,0,0,0,0,0,1,1,2,2,1,2,5,0,0,0,0,0,1,0,1
124865,2022,Italy,Netherlands,0,0,7,7,10/7/2022,0,0,0,0,3,0,0,3,2,1,0,3,0,0,1,1,0,0,0,0
124865,2022,Italy,Serbia,0,0,0,0,8/7/2022,0,0,0,0,0,0,0,0,0,0,0,0,0,0,0,0,0,0,0,0
124865,2022,Italy,Iran,0,2,10,12,7/7/2022,0,0,0,0,6,1,2,9,4,5,0,9,0,0,0,0,1,0,1,2
124865,2022,Bulgaria,Italy,0,1,5,6,5/7/2022,0,0,0,0,2,0,2,4,1,2,0,3,0,1,0,1,1,0,0,1
124865,2022,Italy,China,0,1,8,9,26/06/2022,0,0,2,2,3,0,0,3,2,2,3,7,1,1,0,2,1,0,0,1
124865,2022,Italy,Slovenia,0,1,11,12,25/06/2022,0,0,2,2,6,1,2,9,1,1,7,9,0,0,0,0,3,0,0,3
124865,2022,Japan,Italy,0,1,13,14,24/06/2022,0,0,2,2,7,0,3,10,3,7,9,19,0,0,0,0,1,2,2,5
124865,2022,Germany,Italy,1,1,11,13,22/06/2022,0,0,0,0,4,1,0,5,4,2,2,8,0,0,0,0,1,3,1,5
163032,2022,Argentina,Italy,0,0,0,0,12/6/2022,0,0,0,0,0,0,0,0,0,0,0,0,0,0,0,0,0,0,0,0
163032,2022,Canada,Italy,0,0,0,0,11/6/2022,0,0,0,0,0,0,0,0,0,0,0,0,0,0,0,0,0,0,0,0
163032,2022,Poland,Italy,0,0,0,0,9/6/2022,0,0,0,0,0,0,0,0,0,0,0,0,0,0,0,0,0,0,0,0
163032,2022,France,Italy,0,0,0,0,8/6/2022,0,0,0,0,0,0,0,0,0,0,0,0,0,0,0,0,0,0,0,0
152405,2022,Italy,Poland,0,0,2,2,24/07/2022,0,0,1,1,0,1,0,1,0,1,2,3,0,0,0,0,2,0,0,2
152405,2022,Italy,France,0,1,7,8,23/07/2022,0,0,0,0,3,1,2,6,0,4,0,4,0,0,0,0,1,0,0,1
152405,2022,Italy,Netherlands,0,1,17,18,20/07/2022,0,0,0,0,9,0,2,11,3,9,1,13,1,0,0,1,2,1,0,3
152405,2022,Italy,Netherlands,0,1,3,4,10/7/2022,0,0,0,0,2,0,0,2,0,3,1,4,0,0,0,0,0,0,0,0
152405,2022,Italy,Serbia,1,2,5,8,8/7/2022,0,0,0,0,5,0,3,8,4,4,0,8,0,0,0,0,0,0,0,0
152405,2022,Italy,Iran,0,0,0,0,7/7/2022,0,0,0,0,0,0,0,0,0,0,0,0,0,0,0,0,0,0,0,0
152405,2022,Bulgaria,Italy,1,2,7,10,5/7/2022,0,0,1,1,3,0,3,6,3,5,0,8,0,0,0,0,0,0,0,0
172961,2022,,,-,-,-,-,-,-,-,-,-,-,-,-,-,-,-,-,-,-,-,-,-,-,-,-,-
152412,2022,Italy,China,0,0,0,0,26/06/2022,0,0,0,0,0,0,0,0,0,0,0,0,1,0,3,4,2,0,0,2
152412,2022,Italy,Slovenia,0,0,0,0,25/06/2022,0,0,0,0,0,0,0,0,0,0,0,0,0,0,0,0,0,0,0,0
152412,2022,Japan,Italy,0,0,0,0,24/06/2022,0,0,0,0,0,0,0,0,0,0,0,0,0,0,0,0,0,0,0,0
152412,2022,Germany,Italy,0,0,0,0,22/06/2022,0,0,0,0,0,0,0,0,0,0,0,0,0,0,0,0,0,0,0,0
152412,2022,Argentina,Italy,0,0,0,0,12/6/2022,0,0,4,4,0,0,0,0,0,0,0,0,9,0,11,20,17,5,5,27
152412,2022,Canada,Italy,0,0,0,0,11/6/2022,0,0,2,2,0,0,0,0,0,0,0,0,8,0,11,19,7,0,1,8
152412,2022,Poland,Italy,0,0,0,0,9/6/2022,0,1,6,7,0,0,0,0,0,0,0,0,5,1,9,15,5,5,3,13
152412,2022,France,Italy,0,0,0,0,8/6/2022,0,0,13,13,0,0,0,0,0,0,0,0,1,1,9,11,8,0,3,11
172965,2022,,,-,-,-,-,-,-,-,-,-,-,-,-,-,-,-,-,-,-,-,-,-,-,-,-,-
181128,2022,Italy,Poland,0,0,0,0,24/07/2022,0,0,0,0,0,0,0,0,0,0,0,0,0,0,3,3,1,1,0,2
181128,2022,Italy,France,0,0,0,0,23/07/2022,0,0,0,0,0,0,0,0,0,0,0,0,0,0,0,0,0,0,0,0
181128,2022,Italy,Netherlands,0,0,0,0,20/07/2022,0,0,0,0,0,0,0,0,0,0,0,0,0,0,0,0,0,0,0,0
181128,2022,Italy,Netherlands,0,0,0,0,10/7/2022,0,0,1,1,0,0,0,0,0,0,0,0,0,1,15,16,8,1,0,9
181128,2022,Italy,Serbia,0,0,0,0,8/7/2022,0,0,0,0,0,0,0,0,0,0,0,0,0,0,4,4,0,0,2,2
181128,2022,Italy,Iran,0,0,0,0,7/7/2022,0,0,0,0,0,0,0,0,0,0,0,0,0,0,0,0,1,1,1,3
181128,2022,Bulgaria,Italy,0,0,0,0,5/7/2022,0,0,0,0,0,0,0,0,0,0,0,0,0,0,0,0,0,0,0,0
181128,2022,Argentina,Italy,0,0,0,0,12/6/2022,0,0,0,0,0,0,0,0,0,0,0,0,0,0,0,0,0,0,0,0
181128,2022,Canada,Italy,0,0,0,0,11/6/2022,0,0,0,0,0,0,0,0,0,0,0,0,0,0,0,0,0,0,0,0
181128,2022,Poland,Italy,0,0,0,0,9/6/2022,0,0,0,0,0,0,0,0,0,0,0,0,0,0,0,0,0,0,0,0
181128,2022,France,Italy,0,0,0,0,8/6/2022,0,0,1,1,0,0,0,0,0,0,0,0,0,0,0,0,1,0,0,1
150435,2022,Argentina,Italy,2,2,14,18,12/6/2022,1,0,2,3,5,2,5,12,2,6,7,15,0,0,0,0,3,0,0,3
150435,2022,Canada,Italy,0,0,0,0,11/6/2022,0,0,0,0,0,0,0,0,0,0,0,0,0,0,0,0,0,0,0,0
150435,2022,Poland,Italy,1,2,7,10,9/6/2022,0,0,0,0,2,0,1,3,0,4,1,5,0,0,0,0,0,0,2,2
150435,2022,France,Italy,0,1,1,2,8/6/2022,0,0,0,0,1,0,0,1,0,1,2,3,0,0,0,0,0,0,2,2
174074,2022,Japan,Italy,0,0,0,0,24/06/2022,0,0,0,0,0,0,0,0,0,0,0,0,0,0,0,0,0,0,0,0
174074,2022,Germany,Italy,0,0,0,0,22/06/2022,0,0,0,0,0,0,0,0,0,0,0,0,0,0,0,0,0,0,0,0
174074,2022,Argentina,Italy,0,1,3,4,12/6/2022,0,0,0,0,1,0,0,1,1,0,0,1,0,0,1,1,1,0,0,1
174074,2022,Canada,Italy,0,0,12,12,11/6/2022,0,0,0,0,7,2,0,9,2,4,5,11,0,0,0,0,2,1,0,3
174074,2022,Poland,Italy,0,0,4,4,9/6/2022,0,0,1,1,1,0,1,2,2,1,5,8,0,0,0,0,1,1,0,2
174074,2022,France,Italy,0,0,0,0,8/6/2022,0,0,0,0,0,0,0,0,0,0,0,0,0,0,0,0,0,0,0,0
163519,2022,France,Japan,2,5,4,11,21/07/2022,0,0,0,0,6,5,11,22,0,3,1,4,0,0,0,0,3,4,0,7
163519,2022,Brazil,Japan,1,6,6,13,10/7/2022,0,0,0,0,15,6,8,29,1,2,2,5,1,0,0,1,0,0,2,2
163519,2022,Germany,Japan,0,0,1,1,9/7/2022,0,0,0,0,0,0,1,1,1,0,0,1,0,0,0,0,0,1,0,1
163519,2022,Japan,Canada,1,6,8,15,8/7/2022,0,0,0,0,16,2,11,29,1,5,3,9,0,0,0,0,5,5,2,12
163519,2022,Japan,Australia,6,7,8,21,6/7/2022,0,0,0,0,17,4,1,22,1,2,3,6,0,0,0,0,4,1,0,5
163519,2022,Japan,Slovenia,2,4,10,16,26/06/2022,0,0,1,1,10,5,10,25,0,6,3,9,0,0,0,0,2,2,0,4
163519,2022,Japan,France,0,0,0,0,25/06/2022,0,0,0,0,0,0,0,0,0,0,0,0,0,0,0,0,0,0,0,0
163519,2022,Japan,Italy,5,5,6,16,24/06/2022,0,0,2,2,22,9,9,40,1,6,2,9,0,0,1,1,4,3,0,7
163519,2022,Argentina,Japan,3,5,9,17,21/06/2022,0,0,1,1,20,4,11,35,2,4,3,9,0,0,0,0,6,2,1,9
163519,2022,Iran,Japan,5,4,6,15,12/6/2022,1,0,0,1,11,3,8,22,1,1,1,3,0,0,0,0,3,0,0,3
163519,2022,Japan,USA,0,0,0,0,10/6/2022,0,0,0,0,0,0,0,0,0,0,0,0,0,0,0,0,0,0,0,0
163519,2022,Japan,China,3,7,8,18,9/6/2022,0,0,0,0,22,7,4,33,1,2,0,3,0,0,0,0,3,1,1,5
163519,2022,Japan,Netherlands,1,5,10,16,8/6/2022,1,0,1,2,23,7,7,37,1,4,0,5,0,0,0,0,3,3,0,6
142565,2022,France,Japan,1,2,10,13,21/07/2022,0,0,1,1,5,0,1,6,1,3,1,5,0,0,1,1,1,1,0,2
142565,2022,Brazil,Japan,0,1,8,9,10/7/2022,0,0,0,0,3,1,3,7,0,1,3,4,0,0,3,3,3,4,3,10
142565,2022,Germany,Japan,0,4,13,17,9/7/2022,0,0,1,1,5,0,3,8,1,5,6,12,1,0,1,2,2,0,0,2
142565,2022,Japan,Canada,0,0,10,10,8/7/2022,0,0,1,1,9,1,2,12,1,4,2,7,1,1,2,4,2,2,0,4
142565,2022,Japan,Australia,0,1,7,8,6/7/2022,0,0,0,0,0,0,0,0,0,0,0,0,0,0,0,0,0,0,0,0
142565,2022,Japan,Slovenia,0,0,2,2,26/06/2022,0,0,0,0,0,0,0,0,0,0,0,0,0,0,0,0,1,0,0,1
142565,2022,Japan,France,0,0,0,0,25/06/2022,0,0,0,0,0,0,0,0,0,0,0,0,0,0,0,0,0,0,0,0
142565,2022,Japan,Italy,1,1,20,22,24/06/2022,0,0,1,1,5,1,3,9,0,3,2,5,2,0,1,3,5,1,2,8
142565,2022,Argentina,Japan,2,2,11,15,21/06/2022,0,0,0,0,5,0,5,10,2,2,3,7,0,0,1,1,4,0,1,5
142565,2022,Iran,Japan,0,1,4,5,12/6/2022,0,0,0,0,2,1,1,4,2,3,2,7,1,0,1,2,4,1,0,5
142565,2022,Japan,USA,0,1,11,12,10/6/2022,0,1,0,1,5,1,2,8,0,3,2,5,1,0,0,1,2,2,1,5
142565,2022,Japan,China,0,0,0,0,9/6/2022,0,0,0,0,0,0,0,0,0,0,0,0,0,0,0,0,0,0,0,0
142565,2022,Japan,Netherlands,1,2,15,18,8/6/2022,0,1,1,2,4,2,3,9,2,5,6,13,2,0,4,6,3,0,1,4
118822,2022,,,-,-,-,-,-,-,-,-,-,-,-,-,-,-,-,-,-,-,-,-,-,-,-,-,-
142575,2022,,,-,-,-,-,-,-,-,-,-,-,-,-,-,-,-,-,-,-,-,-,-,-,-,-,-
163516,2022,France,Japan,0,1,6,7,21/07/2022,0,0,2,2,5,4,5,14,0,3,1,4,2,0,12,14,2,3,0,5
163516,2022,Brazil,Japan,1,0,8,9,10/7/2022,0,0,2,2,3,1,3,7,1,0,1,2,3,0,11,14,4,0,0,4
163516,2022,Germany,Japan,0,0,0,0,9/7/2022,0,0,0,0,0,0,0,0,0,0,0,0,0,0,0,0,0,0,0,0
163516,2022,Japan,Canada,1,2,13,16,8/7/2022,0,0,2,2,8,0,12,20,0,5,1,6,7,3,11,21,4,3,3,10
163516,2022,Japan,Australia,0,0,13,13,6/7/2022,1,0,1,2,11,2,6,19,0,2,1,3,9,0,14,23,2,3,1,6
163516,2022,Japan,Slovenia,0,3,10,13,26/06/2022,0,0,3,3,13,3,6,22,0,0,2,2,10,1,26,37,8,2,0,10
163516,2022,Japan,France,0,2,5,7,25/06/2022,0,1,0,1,15,6,13,34,0,0,3,3,0,0,0,0,5,1,1,7
163516,2022,Japan,Italy,0,0,0,0,24/06/2022,0,0,0,0,0,0,0,0,0,0,0,0,0,0,0,0,0,0,0,0
163516,2022,Argentina,Japan,0,0,0,0,21/06/2022,0,0,1,1,0,0,1,1,0,0,0,0,0,0,0,0,0,0,0,0
163516,2022,Iran,Japan,0,1,1,2,12/6/2022,0,0,0,0,2,0,0,2,0,0,0,0,1,1,3,5,0,0,0,0
163516,2022,Japan,USA,0,1,4,5,10/6/2022,0,0,0,0,5,3,11,19,0,1,2,3,2,0,4,6,3,1,0,4
163516,2022,Japan,China,0,0,0,0,9/6/2022,0,0,0,0,0,0,1,1,0,0,0,0,1,0,0,1,0,0,0,0
163516,2022,Japan,Netherlands,0,0,1,1,8/6/2022,0,0,0,0,3,0,2,5,0,1,0,1,0,0,1,1,1,0,0,1
146409,2022,France,Japan,0,1,8,9,21/07/2022,0,0,1,1,5,2,1,8,2,4,1,7,0,0,0,0,3,1,0,4
146409,2022,Brazil,Japan,0,1,8,9,10/7/2022,0,0,0,0,3,2,3,8,0,3,2,5,0,0,1,1,1,1,0,2
146409,2022,Germany,Japan,0,0,0,0,9/7/2022,0,0,0,0,0,0,0,0,0,0,0,0,0,0,0,0,0,0,0,0
146409,2022,Japan,Canada,1,1,12,14,8/7/2022,0,0,0,0,5,1,3,9,2,5,7,14,0,0,2,2,0,0,2,2
146409,2022,Japan,Australia,0,2,14,16,6/7/2022,1,0,0,1,7,0,5,12,0,7,1,8,0,0,0,0,2,1,1,4
146409,2022,Japan,Slovenia,0,3,14,17,26/06/2022,0,0,1,1,5,1,5,11,2,5,5,12,0,0,1,1,6,1,0,7
146409,2022,Japan,France,0,0,0,0,25/06/2022,0,0,0,0,0,0,0,0,0,0,0,0,0,0,0,0,0,0,0,0
146409,2022,Japan,Italy,1,1,15,17,24/06/2022,0,0,3,3,14,1,3,18,0,5,8,13,0,0,0,0,3,1,0,4
146409,2022,Argentina,Japan,1,2,14,17,21/06/2022,0,0,0,0,7,1,5,13,2,3,2,7,0,0,0,0,3,0,0,3
146409,2022,Iran,Japan,1,1,8,10,12/6/2022,0,0,0,0,4,0,1,5,2,2,4,8,0,0,0,0,1,0,0,1
146409,2022,Japan,USA,0,2,18,20,10/6/2022,0,0,0,0,6,0,6,12,0,8,7,15,0,0,0,0,4,1,2,7
146409,2022,Japan,China,0,2,8,10,9/6/2022,1,0,0,1,5,2,1,8,0,2,2,4,0,0,0,0,2,0,1,3
146409,2022,Japan,Netherlands,0,0,7,7,8/6/2022,0,0,0,0,1,1,4,6,0,3,0,3,1,0,1,2,3,0,1,4
153365,2022,France,Japan,0,3,1,4,21/07/2022,0,0,5,5,3,2,7,12,0,2,0,2,2,1,4,7,0,1,1,2
153365,2022,Brazil,Japan,0,0,0,0,10/7/2022,0,0,2,2,1,0,0,1,0,0,0,0,0,0,0,0,1,0,0,1
153365,2022,Germany,Japan,0,4,7,11,9/7/2022,0,0,5,5,14,4,3,21,2,6,6,14,3,1,16,20,4,3,1,8
153365,2022,Japan,Canada,0,0,0,0,8/7/2022,0,0,0,0,0,0,0,0,0,0,0,0,0,0,0,0,0,0,0,0
153365,2022,Japan,Australia,0,0,0,0,6/7/2022,0,0,0,0,0,0,0,0,0,0,0,0,0,0,0,0,0,0,0,0
153365,2022,Japan,Slovenia,0,0,0,0,26/06/2022,0,0,0,0,0,0,0,0,0,0,0,0,0,0,0,0,0,0,0,0
153365,2022,Japan,France,0,7,4,11,25/06/2022,0,1,2,3,12,5,11,28,1,1,1,3,2,4,17,23,6,2,0,8
153365,2022,Japan,Italy,0,0,0,0,24/06/2022,0,0,1,1,1,1,1,3,0,1,0,1,1,0,1,2,1,0,0,1
153365,2022,Argentina,Japan,0,2,3,5,21/06/2022,0,0,2,2,4,3,3,10,0,0,1,1,4,1,11,16,4,1,0,5
133009,2022,France,Japan,0,0,8,8,21/07/2022,10,0,41,51,0,0,1,1,0,0,0,0,0,1,0,1,6,3,0,9
133009,2022,Brazil,Japan,0,1,9,10,10/7/2022,29,0,40,69,0,0,0,0,0,0,3,3,0,1,0,1,3,4,2,9
133009,2022,Germany,Japan,0,0,0,0,9/7/2022,0,0,4,4,0,0,0,0,0,0,0,0,0,0,0,0,0,0,0,0
133009,2022,Japan,Canada,0,2,16,18,8/7/2022,29,0,48,77,1,0,1,2,0,1,7,8,0,0,0,0,12,3,4,19
133009,2022,Japan,Australia,2,0,10,12,6/7/2022,31,0,41,72,1,0,0,1,0,2,2,4,0,0,1,1,4,2,2,8
133009,2022,Japan,Slovenia,0,0,16,16,26/06/2022,20,0,71,91,1,0,1,2,1,2,4,7,0,0,2,2,5,2,0,7
133009,2022,Japan,France,0,0,2,2,25/06/2022,0,0,1,1,0,0,0,0,0,0,0,0,0,0,0,0,0,0,0,0
133009,2022,Japan,Italy,1,0,18,19,24/06/2022,24,0,81,105,1,0,0,1,0,3,1,4,0,0,2,2,6,4,3,13
133009,2022,Argentina,Japan,0,2,14,16,21/06/2022,15,0,69,84,0,0,0,0,0,2,2,4,0,0,0,0,8,2,0,10
133009,2022,Iran,Japan,0,1,14,15,12/6/2022,18,1,31,50,0,0,0,0,0,1,5,6,0,0,1,1,8,1,0,9
133009,2022,Japan,USA,0,1,4,5,10/6/2022,11,0,25,36,0,0,0,0,0,1,0,1,0,0,0,0,4,0,0,4
133009,2022,Japan,China,0,0,0,0,9/6/2022,0,0,0,0,0,0,0,0,0,0,0,0,0,0,0,0,0,0,0,0
133009,2022,Japan,Netherlands,0,0,8,8,8/6/2022,31,0,47,78,0,0,0,0,0,1,3,4,0,0,1,1,5,3,0,8
142570,2022,France,Japan,0,0,0,0,21/07/2022,4,0,5,9,0,0,0,0,0,0,0,0,0,0,1,1,0,1,1,2
142570,2022,Brazil,Japan,0,0,0,0,10/7/2022,1,0,1,2,0,0,0,0,0,0,0,0,0,0,0,0,0,0,1,1
142570,2022,Germany,Japan,0,0,13,13,9/7/2022,16,1,54,71,0,1,0,1,0,1,8,9,0,0,0,0,6,3,2,11
142570,2022,Japan,Canada,0,0,0,0,8/7/2022,1,0,2,3,0,0,0,0,0,0,0,0,0,0,0,0,1,0,0,1
142570,2022,Japan,Australia,0,0,0,0,6/7/2022,5,1,4,10,0,0,0,0,0,0,0,0,0,0,0,0,1,0,0,1
142570,2022,Japan,Slovenia,0,0,0,0,26/06/2022,0,0,0,0,0,0,0,0,0,0,0,0,0,0,0,0,0,0,0,0
142570,2022,Japan,France,0,1,12,13,25/06/2022,16,1,64,81,3,0,1,4,1,1,5,7,0,0,1,1,6,2,2,10
142570,2022,Japan,Italy,0,0,0,0,24/06/2022,0,0,0,0,0,0,0,0,0,0,0,0,0,0,0,0,0,0,0,0
142570,2022,Argentina,Japan,0,0,1,1,21/06/2022,0,0,1,1,0,0,0,0,0,0,0,0,0,0,0,0,0,0,0,0
142561,2022,France,Japan,0,0,0,0,21/07/2022,0,0,0,0,0,0,0,0,0,0,0,0,0,0,0,0,0,0,0,0
142561,2022,Brazil,Japan,0,0,0,0,10/7/2022,0,0,0,0,0,0,0,0,0,0,0,0,0,0,0,0,0,0,0,0
142561,2022,Germany,Japan,0,2,12,14,9/7/2022,0,0,1,1,4,0,2,6,6,3,4,13,0,0,1,1,3,3,0,6
142561,2022,Japan,Canada,0,0,1,1,8/7/2022,0,0,0,0,0,1,0,1,1,0,0,1,0,0,0,0,1,0,0,1
142561,2022,Japan,Australia,0,1,6,7,6/7/2022,0,0,0,0,12,0,4,16,2,5,8,15,0,0,0,0,1,0,2,3
142561,2022,Japan,Slovenia,0,3,12,15,26/06/2022,0,0,0,0,9,0,3,12,2,2,5,9,0,0,0,0,2,0,1,3
142561,2022,Japan,France,0,1,6,7,25/06/2022,0,0,1,1,6,1,2,9,0,6,10,16,0,0,0,0,4,0,0,4
142561,2022,Japan,Italy,0,0,0,0,24/06/2022,0,0,0,0,0,0,0,0,0,0,1,1,0,0,0,0,0,0,0,0
142561,2022,Argentina,Japan,0,0,0,0,21/06/2022,0,0,0,0,0,0,0,0,0,0,0,0,0,0,0,0,0,0,0,0
178761,2022,Japan,Slovenia,0,0,0,0,26/06/2022,0,0,0,0,0,1,0,1,0,0,0,0,0,0,1,1,0,0,0,0
178761,2022,Japan,France,0,3,7,10,25/06/2022,0,0,3,3,2,1,8,11,0,0,0,0,7,0,16,23,10,1,1,12
178761,2022,Japan,Italy,0,0,0,0,24/06/2022,0,0,1,1,0,0,0,0,0,0,0,0,0,0,0,0,0,0,0,0
178761,2022,Argentina,Japan,0,1,1,2,21/06/2022,0,0,0,0,1,1,1,3,0,0,0,0,0,0,3,3,0,0,0,0
178761,2022,Iran,Japan,0,0,0,0,12/6/2022,0,0,0,0,0,0,0,0,0,0,0,0,0,0,0,0,0,0,0,0
178761,2022,Japan,USA,0,2,1,3,10/6/2022,0,0,1,1,1,1,1,3,0,3,0,3,2,0,7,9,4,0,0,4
178761,2022,Japan,China,0,0,0,0,9/6/2022,0,0,0,0,0,0,0,0,0,0,0,0,0,0,0,0,0,0,0,0
178761,2022,Japan,Netherlands,0,0,0,0,8/6/2022,0,0,0,0,0,0,0,0,0,0,0,0,0,0,0,0,0,0,0,0
178762,2022,France,Japan,1,2,4,7,21/07/2022,0,0,0,0,3,2,1,6,0,0,0,0,8,1,12,21,1,1,0,2
178762,2022,Brazil,Japan,0,3,5,8,10/7/2022,0,0,0,0,3,3,5,11,0,1,0,1,2,1,9,12,1,2,1,4
178762,2022,Germany,Japan,1,4,14,19,9/7/2022,0,0,5,5,13,4,6,23,0,4,3,7,3,0,21,24,6,1,0,7
178762,2022,Japan,Canada,0,0,0,0,8/7/2022,0,0,0,0,0,0,0,0,0,0,0,0,0,0,1,1,0,0,0,0
178762,2022,Japan,Australia,0,0,0,0,6/7/2022,0,0,0,0,0,0,0,0,0,0,0,0,0,0,0,0,0,0,0,0
178762,2022,Japan,Slovenia,0,0,0,0,26/06/2022,0,0,0,0,0,0,0,0,0,0,0,0,0,0,0,0,0,0,0,0
178762,2022,Japan,France,0,0,0,0,25/06/2022,0,0,0,0,0,0,0,0,0,0,0,0,0,0,0,0,0,0,0,0
178762,2022,Japan,Italy,0,4,9,13,24/06/2022,0,0,2,2,7,4,8,19,1,3,1,5,5,1,21,27,4,3,0,7
178762,2022,Argentina,Japan,0,0,4,4,21/06/2022,0,0,3,3,4,1,1,6,0,0,0,0,4,0,5,9,3,2,0,5
178762,2022,Iran,Japan,3,2,8,13,12/6/2022,2,0,2,4,6,2,8,16,0,3,3,6,4,0,6,10,9,1,0,10
178762,2022,Japan,USA,0,2,18,20,10/6/2022,2,0,0,2,12,1,15,28,0,3,6,9,13,3,24,40,12,1,2,15
178762,2022,Japan,China,1,2,18,21,9/6/2022,1,0,1,2,13,3,6,22,0,2,0,2,7,0,13,20,6,1,0,7
178762,2022,Japan,Netherlands,2,3,13,18,8/6/2022,0,0,0,0,8,3,8,19,0,1,1,2,7,0,13,20,3,0,1,4
180990,2022,France,Japan,0,0,0,0,21/07/2022,0,0,0,0,0,0,0,0,0,0,0,0,0,0,0,0,0,0,0,0
180990,2022,Brazil,Japan,0,0,0,0,10/7/2022,0,0,0,0,0,0,0,0,0,0,0,0,0,0,0,0,0,0,0,0
180990,2022,Germany,Japan,0,0,0,0,9/7/2022,0,0,4,4,0,0,0,0,0,0,0,0,4,1,12,17,4,2,1,7
180990,2022,Japan,Canada,0,0,0,0,8/7/2022,0,0,0,0,0,0,0,0,0,0,0,0,0,0,0,0,0,0,0,0
180990,2022,Japan,Australia,0,0,0,0,6/7/2022,0,0,0,0,0,0,0,0,0,0,0,0,0,0,0,0,0,0,0,0
180990,2022,Japan,Slovenia,0,0,0,0,26/06/2022,0,0,0,0,0,0,0,0,0,0,0,0,0,0,0,0,0,0,0,0
180990,2022,Japan,France,0,0,0,0,25/06/2022,0,0,5,5,0,0,0,0,0,0,0,0,2,1,11,14,8,1,5,14
180990,2022,Japan,Italy,0,0,0,0,24/06/2022,0,0,0,0,0,0,0,0,0,0,0,0,0,0,0,0,0,0,0,0
180990,2022,Argentina,Japan,0,0,0,0,21/06/2022,0,0,0,0,0,0,0,0,0,0,0,0,0,0,0,0,0,0,0,0
180990,2022,Iran,Japan,0,0,0,0,12/6/2022,0,0,0,0,0,0,0,0,0,0,0,0,0,0,0,0,0,1,0,1
180990,2022,Japan,USA,0,0,0,0,10/6/2022,0,0,0,0,0,0,0,0,0,0,0,0,0,0,0,0,0,0,0,0
180990,2022,Japan,China,0,0,0,0,9/6/2022,0,0,0,0,0,0,0,0,0,0,0,0,0,0,0,0,0,0,0,0
180990,2022,Japan,Netherlands,0,0,0,0,8/6/2022,0,0,0,0,0,0,0,0,0,0,0,0,0,0,0,0,0,0,0,0
142568,2022,Brazil,Japan,1,2,9,12,10/7/2022,0,0,6,6,12,2,3,17,1,3,2,6,8,1,8,17,3,4,0,7
142568,2022,Germany,Japan,1,1,2,4,9/7/2022,0,0,0,0,0,0,0,0,0,0,0,0,0,0,0,0,0,0,0,0
142568,2022,Japan,Canada,4,4,12,20,8/7/2022,1,0,5,6,15,3,12,30,0,3,3,6,4,2,10,16,7,1,2,10
142568,2022,Japan,Australia,5,5,9,19,6/7/2022,2,0,4,6,11,2,6,19,2,2,1,5,9,1,13,23,4,2,4,10
142568,2022,Japan,Slovenia,3,4,10,17,26/06/2022,0,0,3,3,17,2,15,34,1,2,0,3,7,1,7,15,8,2,2,12
142568,2022,Japan,France,0,0,0,0,25/06/2022,0,0,0,0,0,0,0,0,0,0,0,0,0,0,0,0,0,0,0,0
142568,2022,Japan,Italy,6,2,14,22,24/06/2022,3,0,4,7,14,8,17,39,0,2,1,3,7,1,20,28,10,2,4,16
142568,2022,Argentina,Japan,3,6,7,16,21/06/2022,0,0,9,9,15,4,10,29,0,1,2,3,8,0,17,25,6,2,2,10
142568,2022,Iran,Japan,1,2,11,14,12/6/2022,3,0,1,4,14,1,5,20,1,3,3,7,4,0,9,13,4,1,0,5
142568,2022,Japan,USA,1,3,3,7,10/6/2022,1,1,0,2,7,4,9,20,1,4,0,5,5,1,3,9,2,1,0,3
142568,2022,Japan,China,3,9,7,19,9/6/2022,3,0,0,3,11,3,7,21,2,2,3,7,7,0,14,21,5,2,0,7
142568,2022,Japan,Netherlands,1,3,13,17,8/6/2022,1,0,4,5,6,5,8,19,5,7,1,13,8,1,11,20,6,2,1,9
163038,2022,France,Japan,0,1,2,3,21/07/2022,0,0,1,1,3,0,1,4,0,0,0,0,0,0,0,0,0,0,0,0
163038,2022,Brazil,Japan,0,0,0,0,10/7/2022,0,0,0,0,0,0,0,0,0,0,0,0,0,0,0,0,0,0,0,0
163038,2022,Germany,Japan,2,5,10,17,9/7/2022,0,0,0,0,15,7,10,32,0,1,3,4,0,0,0,0,7,3,0,10
163038,2022,Japan,Canada,0,0,2,2,8/7/2022,0,0,0,0,0,0,2,2,0,0,0,0,0,0,0,0,0,0,0,0
163038,2022,Japan,Australia,0,0,1,1,6/7/2022,0,0,0,0,2,0,2,4,1,1,1,3,0,0,0,0,0,0,0,0
163038,2022,Iran,Japan,0,0,0,0,12/6/2022,0,0,0,0,0,0,0,0,0,0,0,0,0,0,0,0,0,0,0,0
163038,2022,Japan,USA,0,3,11,14,10/6/2022,0,0,2,2,19,6,17,42,1,3,7,11,0,0,0,0,11,2,1,14
163038,2022,Japan,China,0,0,1,1,9/6/2022,0,0,0,0,0,0,0,0,0,0,0,0,0,0,0,0,0,0,0,0
163038,2022,Japan,Netherlands,0,1,0,1,8/6/2022,0,0,0,0,0,0,0,0,0,0,0,0,0,0,0,0,0,0,0,0
189192,2022,,,-,-,-,-,-,-,-,-,-,-,-,-,-,-,-,-,-,-,-,-,-,-,-,-,-
152593,2022,,,-,-,-,-,-,-,-,-,-,-,-,-,-,-,-,-,-,-,-,-,-,-,-,-,-
172893,2022,France,Japan,0,0,0,0,21/07/2022,0,0,3,3,0,0,0,0,0,0,0,0,3,0,6,9,6,0,0,6
172893,2022,Brazil,Japan,0,0,0,0,10/7/2022,0,0,0,0,0,0,0,0,0,0,0,0,4,1,6,11,8,2,2,12
172893,2022,Germany,Japan,0,0,0,0,9/7/2022,0,0,0,0,0,0,0,0,0,0,0,0,0,0,0,0,0,0,0,0
172893,2022,Japan,Canada,0,0,0,0,8/7/2022,2,0,9,11,0,0,0,0,0,0,0,0,10,2,9,21,7,0,5,12
172893,2022,Japan,Australia,0,0,0,0,6/7/2022,1,0,4,5,0,0,0,0,0,0,0,0,12,0,8,20,6,5,3,14
172893,2022,Japan,Slovenia,0,0,0,0,26/06/2022,0,0,3,3,0,0,0,0,0,0,0,0,2,0,7,9,11,1,0,12
172893,2022,Japan,France,0,0,0,0,25/06/2022,0,0,0,0,0,0,0,0,0,0,0,0,0,0,1,1,0,0,0,0
172893,2022,Japan,Italy,0,0,0,0,24/06/2022,1,0,4,5,0,0,0,0,0,0,0,0,6,1,11,18,14,1,0,15
172893,2022,Argentina,Japan,0,0,0,0,21/06/2022,0,0,5,5,0,0,0,0,0,0,0,0,0,0,13,13,6,7,1,14
172893,2022,Iran,Japan,0,0,0,0,12/6/2022,3,0,1,4,0,0,0,0,0,0,0,0,3,3,4,10,5,0,2,7
172893,2022,Japan,USA,0,0,0,0,10/6/2022,10,0,5,15,0,0,0,0,0,0,0,0,11,0,7,18,20,2,2,24
172893,2022,Japan,China,0,0,0,0,9/6/2022,4,0,0,4,0,0,0,0,0,0,0,0,11,0,11,22,12,1,3,16
172893,2022,Japan,Netherlands,0,0,0,0,8/6/2022,1,0,1,2,0,0,0,0,0,0,0,0,10,2,10,22,12,3,2,17
142562,2022,Iran,Japan,0,0,0,0,12/6/2022,2,0,4,6,0,0,1,1,0,1,0,1,0,0,0,0,0,0,0,0
142562,2022,Japan,USA,0,0,8,8,10/6/2022,32,2,47,81,3,1,0,4,1,0,2,3,0,0,0,0,4,0,1,5
142562,2022,Japan,China,0,4,8,12,9/6/2022,38,0,46,84,0,0,0,0,0,1,5,6,0,0,0,0,5,1,2,8
142562,2022,Japan,Netherlands,0,0,3,3,8/6/2022,5,0,14,19,0,0,0,0,0,0,1,1,0,0,0,0,3,0,0,3
153359,2022,,,-,-,-,-,-,-,-,-,-,-,-,-,-,-,-,-,-,-,-,-,-,-,-,-,-
189038,2022,,,-,-,-,-,-,-,-,-,-,-,-,-,-,-,-,-,-,-,-,-,-,-,-,-,-
189037,2022,France,Japan,0,0,0,0,21/07/2022,0,0,0,0,0,0,0,0,0,0,0,0,0,0,0,0,0,0,0,0
189037,2022,Brazil,Japan,0,0,0,0,10/7/2022,0,0,0,0,0,0,0,0,0,0,0,0,0,0,0,0,0,0,0,0
189037,2022,Germany,Japan,0,0,1,1,9/7/2022,0,0,1,1,1,0,0,1,0,0,0,0,0,0,0,0,1,0,0,1
189037,2022,Japan,Canada,0,0,0,0,8/7/2022,0,0,0,0,0,0,0,0,0,0,0,0,0,0,0,0,0,0,0,0
189037,2022,Japan,Australia,0,0,0,0,6/7/2022,0,0,0,0,0,0,0,0,0,0,0,0,0,0,0,0,0,0,0,0
189037,2022,Japan,Slovenia,0,0,0,0,26/06/2022,0,0,0,0,0,0,0,0,0,0,0,0,0,0,0,0,0,0,0,0
189037,2022,Japan,France,1,2,11,14,25/06/2022,0,0,0,0,2,1,3,6,0,3,3,6,0,0,0,0,4,0,1,5
189037,2022,Japan,Italy,0,0,0,0,24/06/2022,0,0,0,0,0,0,0,0,0,0,0,0,0,0,0,0,0,0,0,0
189037,2022,Argentina,Japan,0,0,0,0,21/06/2022,0,0,0,0,0,0,0,0,0,0,0,0,0,0,0,0,0,0,0,0
189037,2022,Iran,Japan,0,0,0,0,12/6/2022,0,0,0,0,0,0,0,0,0,0,0,0,0,0,0,0,0,0,0,0
189037,2022,Japan,USA,0,1,3,4,10/6/2022,0,0,0,0,2,0,2,4,0,1,0,1,0,0,0,0,0,0,0,0
189037,2022,Japan,China,1,2,11,14,9/6/2022,0,0,1,1,5,2,2,9,1,6,1,8,0,0,0,0,0,2,0,2
189037,2022,Japan,Netherlands,1,1,6,8,8/6/2022,0,0,0,0,9,0,3,12,2,3,4,9,0,0,1,1,1,0,0,1
189039,2022,,,-,-,-,-,-,-,-,-,-,-,-,-,-,-,-,-,-,-,-,-,-,-,-,-,-
189064,2022,,,-,-,-,-,-,-,-,-,-,-,-,-,-,-,-,-,-,-,-,-,-,-,-,-,-
150729,2022,,,-,-,-,-,-,-,-,-,-,-,-,-,-,-,-,-,-,-,-,-,-,-,-,-,-
181284,2022,,,-,-,-,-,-,-,-,-,-,-,-,-,-,-,-,-,-,-,-,-,-,-,-,-,-
141546,2022,Italy,Netherlands,0,0,14,14,20/07/2022,14,0,82,96,1,0,0,1,0,3,3,6,0,1,0,1,10,2,0,12
141546,2022,Italy,Netherlands,0,2,6,8,10/7/2022,8,0,62,70,3,0,0,3,0,2,0,2,0,0,0,0,2,0,0,2
141546,2022,Poland,Netherlands,1,1,7,9,9/7/2022,6,0,57,63,3,0,1,4,0,0,0,0,0,0,1,1,1,1,0,2
141546,2022,Bulgaria,Netherlands,0,0,14,14,8/7/2022,19,0,63,82,0,1,0,1,0,1,0,1,1,0,3,4,1,0,0,1
141546,2022,Netherlands,China,0,1,15,16,6/7/2022,7,0,63,70,0,0,0,0,0,0,0,0,0,0,0,0,0,1,0,1
141546,2022,Argentina,Netherlands,0,0,17,17,25/06/2022,12,0,93,105,1,0,1,2,1,2,2,5,0,0,1,1,10,2,1,13
141546,2022,Germany,Netherlands,1,1,12,14,24/06/2022,12,1,85,98,2,0,1,3,0,4,5,9,0,0,0,0,4,1,2,7
141546,2022,France,Netherlands,0,0,6,6,23/06/2022,13,0,38,51,0,0,0,0,0,1,0,1,0,0,2,2,3,3,0,6
141546,2022,Slovenia,Netherlands,0,0,13,13,21/06/2022,12,0,47,59,0,1,0,1,1,1,4,6,0,0,0,0,3,0,1,4
141546,2022,Netherlands,Australia,0,1,6,7,12/6/2022,22,0,38,60,2,0,0,2,1,1,1,3,0,0,0,0,2,0,0,2
141546,2022,Netherlands,Iran,0,0,12,12,10/6/2022,25,0,46,71,0,0,1,1,0,1,2,3,0,3,0,3,3,1,1,5
141546,2022,Netherlands,USA,0,0,0,0,9/6/2022,0,1,7,8,0,0,0,0,0,0,0,0,0,0,0,0,1,0,0,1
141546,2022,Japan,Netherlands,0,0,10,10,8/6/2022,20,0,54,74,1,0,2,3,2,5,2,9,1,0,0,1,3,2,1,6
139929,2022,Italy,Netherlands,0,4,4,8,20/07/2022,0,0,2,2,4,1,9,14,1,2,2,5,3,0,6,9,2,4,0,6
139929,2022,Italy,Netherlands,0,1,0,1,10/7/2022,0,0,0,0,2,0,2,4,0,0,0,0,0,0,1,1,0,0,0,0
139929,2022,Poland,Netherlands,0,3,4,7,9/7/2022,0,0,3,3,7,4,6,17,0,4,0,4,0,1,12,13,1,2,0,3
139929,2022,Bulgaria,Netherlands,0,0,5,5,8/7/2022,0,0,1,1,1,2,3,6,0,0,0,0,1,1,11,13,0,0,0,0
139929,2022,Netherlands,China,0,0,0,0,6/7/2022,0,0,0,0,1,0,0,1,0,0,0,0,0,0,2,2,0,0,0,0
139929,2022,Netherlands,Australia,1,2,4,7,12/6/2022,1,0,0,1,2,1,5,8,2,2,0,4,8,0,5,13,2,0,1,3
139929,2022,Netherlands,Iran,0,0,0,0,10/6/2022,0,0,0,0,0,0,0,0,0,0,0,0,0,0,0,0,0,0,0,0
139929,2022,Netherlands,USA,0,1,2,3,9/6/2022,0,0,0,0,2,0,1,3,0,0,0,0,0,0,1,1,0,1,1,2
139929,2022,Japan,Netherlands,0,5,9,14,8/6/2022,1,0,0,1,12,8,9,29,2,3,1,6,4,1,19,24,4,2,1,7
137345,2022,Italy,Netherlands,0,2,1,3,20/07/2022,0,1,1,2,3,4,3,10,0,1,0,1,5,1,1,7,2,0,0,2
137345,2022,Italy,Netherlands,1,2,8,11,10/7/2022,0,0,0,0,8,2,6,16,1,1,0,2,4,2,16,22,3,0,0,3
137345,2022,Poland,Netherlands,0,1,4,5,9/7/2022,0,0,0,0,3,0,2,5,0,0,0,0,1,0,3,4,1,0,0,1
137345,2022,Netherlands,China,2,2,7,11,6/7/2022,0,0,0,0,10,2,4,16,2,0,0,2,2,0,17,19,4,0,0,4
137345,2022,Argentina,Netherlands,0,0,0,0,25/06/2022,0,0,0,0,0,1,1,2,0,1,0,1,0,1,0,1,0,0,0,0
137345,2022,Germany,Netherlands,0,1,1,2,24/06/2022,0,0,0,0,3,1,2,6,2,0,0,2,0,0,7,7,1,0,0,1
137345,2022,France,Netherlands,0,0,2,2,23/06/2022,0,0,0,0,4,4,2,10,0,1,1,2,3,1,9,13,1,2,0,3
137345,2022,Slovenia,Netherlands,2,2,6,10,21/06/2022,0,0,4,4,9,2,3,14,1,4,3,8,3,2,10,15,4,1,1,6
137345,2022,Netherlands,Australia,0,3,1,4,12/6/2022,1,0,0,1,2,2,4,8,1,1,2,4,4,1,4,9,5,0,0,5
137345,2022,Netherlands,Iran,0,3,5,8,10/6/2022,0,0,1,1,14,1,5,20,0,1,4,5,0,0,7,7,5,2,1,8
137345,2022,Netherlands,USA,0,3,3,6,9/6/2022,1,0,1,2,9,3,8,20,0,2,0,2,7,2,15,24,4,1,0,5
137345,2022,Japan,Netherlands,0,0,1,1,8/6/2022,0,0,0,0,1,0,1,2,0,0,0,0,1,0,0,1,0,0,0,0
169921,2022,Italy,Netherlands,0,0,0,0,20/07/2022,0,0,0,0,0,0,0,0,0,0,0,0,0,0,0,0,0,0,0,0
169921,2022,Italy,Netherlands,0,1,6,7,10/7/2022,0,0,0,0,1,0,3,4,0,1,0,1,0,0,3,3,0,1,0,1
169921,2022,Poland,Netherlands,0,0,2,2,9/7/2022,0,0,0,0,0,0,0,0,0,1,0,1,0,0,0,0,0,0,0,0
169921,2022,Bulgaria,Netherlands,0,0,1,1,8/7/2022,0,0,0,0,0,0,0,0,0,0,0,0,0,1,0,1,0,0,0,0
169921,2022,Netherlands,China,0,0,0,0,6/7/2022,0,0,0,0,0,0,0,0,0,0,0,0,0,0,0,0,0,0,0,0
169921,2022,Argentina,Netherlands,0,0,0,0,25/06/2022,0,0,0,0,0,0,0,0,0,0,0,0,0,0,0,0,0,0,0,0
169921,2022,Germany,Netherlands,0,0,3,3,24/06/2022,0,0,0,0,0,0,0,0,2,3,1,6,0,0,0,0,0,1,0,1
169921,2022,France,Netherlands,0,0,0,0,23/06/2022,0,0,0,0,0,0,0,0,0,0,0,0,0,0,0,0,0,0,0,0
169921,2022,Slovenia,Netherlands,1,0,12,13,21/06/2022,0,0,0,0,2,0,2,4,0,2,1,3,1,0,1,2,2,0,0,2
169921,2022,Netherlands,Australia,1,0,3,4,12/6/2022,0,0,0,0,0,0,1,1,0,3,3,6,1,0,0,1,0,0,0,0
169921,2022,Netherlands,Iran,0,0,0,0,10/6/2022,0,0,0,0,0,0,0,0,1,0,0,1,0,0,0,0,0,0,0,0
169921,2022,Netherlands,USA,0,0,0,0,9/6/2022,0,0,0,0,0,0,0,0,0,0,0,0,0,0,0,0,0,0,0,0
169921,2022,Japan,Netherlands,1,1,9,11,8/6/2022,0,0,0,0,0,1,3,4,2,6,4,12,0,0,1,1,1,0,0,1
184894,2022,,,-,-,-,-,-,-,-,-,-,-,-,-,-,-,-,-,-,-,-,-,-,-,-,-,-
131980,2022,Italy,Netherlands,1,1,5,7,20/07/2022,0,0,0,0,3,0,3,6,0,1,0,1,5,1,4,10,3,1,1,5
131980,2022,Italy,Netherlands,0,1,1,2,10/7/2022,0,0,0,0,0,0,0,0,0,0,0,0,0,0,1,1,0,0,0,0
131980,2022,Poland,Netherlands,0,0,2,2,9/7/2022,0,0,0,0,0,0,0,0,0,0,0,0,0,0,4,4,0,0,0,0
131980,2022,Bulgaria,Netherlands,1,0,12,13,8/7/2022,0,0,2,2,4,4,11,19,0,2,0,2,0,2,15,17,1,1,1,3
131980,2022,Netherlands,China,1,0,7,8,6/7/2022,0,0,0,0,5,2,1,8,1,0,0,1,0,0,13,13,3,1,2,6
131980,2022,Argentina,Netherlands,1,3,16,20,25/06/2022,0,0,2,2,10,5,9,24,1,0,0,1,7,1,27,35,18,4,1,23
131980,2022,Germany,Netherlands,0,2,19,21,24/06/2022,1,0,7,8,10,3,10,23,1,4,3,8,9,0,14,23,16,2,0,18
131980,2022,France,Netherlands,0,1,4,5,23/06/2022,0,0,5,5,3,3,1,7,0,1,0,1,4,0,4,8,3,2,0,5
131980,2022,Slovenia,Netherlands,0,0,3,3,21/06/2022,0,0,0,0,0,0,1,1,0,0,0,0,3,0,4,7,1,0,0,1
131980,2022,Netherlands,Australia,0,1,3,4,12/6/2022,1,0,0,1,0,0,0,0,0,0,0,0,4,0,3,7,1,1,0,2
131980,2022,Netherlands,Iran,0,0,2,2,10/6/2022,0,0,0,0,0,0,0,0,0,0,0,0,0,0,2,2,0,0,0,0
131980,2022,Netherlands,USA,0,1,8,9,9/6/2022,3,0,1,4,3,4,6,13,1,3,2,6,8,0,14,22,4,3,1,8
131980,2022,Japan,Netherlands,0,0,1,1,8/6/2022,0,0,0,0,1,1,1,3,0,0,0,0,1,1,1,3,3,0,1,4
156678,2022,Italy,Netherlands,1,2,11,14,20/07/2022,0,0,2,2,5,2,1,8,2,5,4,11,0,0,3,3,2,0,0,2
156678,2022,Italy,Netherlands,1,0,1,2,10/7/2022,0,0,0,0,1,0,1,2,0,1,0,1,0,0,0,0,0,0,0,0
156678,2022,Poland,Netherlands,0,2,2,4,9/7/2022,0,0,1,1,2,1,4,7,0,4,0,4,0,1,0,1,0,0,1,1
156678,2022,Bulgaria,Netherlands,0,3,7,10,8/7/2022,0,0,0,0,7,1,2,10,1,7,1,9,0,0,2,2,0,0,0,0
156678,2022,Netherlands,China,0,3,9,12,6/7/2022,0,0,0,0,4,0,1,5,5,4,1,10,0,0,0,0,2,0,0,2
156678,2022,Argentina,Netherlands,5,4,10,19,25/06/2022,1,0,3,4,5,1,4,10,4,4,5,13,0,0,2,2,1,0,0,1
156678,2022,Germany,Netherlands,1,4,8,13,24/06/2022,0,0,1,1,5,0,4,9,2,5,5,12,0,0,0,0,7,0,0,7
156678,2022,France,Netherlands,0,2,4,6,23/06/2022,1,0,1,2,3,0,1,4,0,5,3,8,0,0,1,1,0,0,0,0
156678,2022,Slovenia,Netherlands,0,0,0,0,21/06/2022,0,0,0,0,1,0,0,1,0,1,0,1,0,0,0,0,0,0,0,0
156678,2022,Netherlands,Australia,0,2,11,13,12/6/2022,0,0,0,0,10,0,1,11,0,3,4,7,0,0,0,0,2,0,0,2
156678,2022,Netherlands,Iran,0,4,9,13,10/6/2022,0,1,0,1,8,1,2,11,3,5,2,10,0,1,0,1,5,1,1,7
156678,2022,Netherlands,USA,0,0,0,0,9/6/2022,0,0,0,0,0,0,0,0,0,0,0,0,0,0,0,0,0,0,0,0
156678,2022,Japan,Netherlands,1,2,13,16,8/6/2022,0,0,1,1,6,0,4,10,2,4,5,11,1,0,1,2,2,0,1,3
176460,2022,Argentina,Netherlands,0,0,0,0,25/06/2022,0,0,0,0,0,0,0,0,0,0,0,0,0,0,0,0,0,0,0,0
176460,2022,Germany,Netherlands,0,0,0,0,24/06/2022,0,0,0,0,0,0,0,0,0,0,0,0,0,0,0,0,0,0,0,0
176460,2022,France,Netherlands,0,0,0,0,23/06/2022,0,0,0,0,0,0,0,0,0,0,0,0,0,0,0,0,0,0,0,0
176460,2022,Slovenia,Netherlands,0,0,0,0,21/06/2022,0,0,0,0,0,0,0,0,0,0,0,0,0,0,0,0,0,0,0,0
176460,2022,Netherlands,Australia,0,0,0,0,12/6/2022,0,0,0,0,0,0,0,0,0,0,0,0,0,0,0,0,0,0,0,0
176460,2022,Netherlands,Iran,0,0,0,0,10/6/2022,0,0,0,0,0,0,0,0,0,0,0,0,0,0,0,0,0,0,0,0
176460,2022,Netherlands,USA,0,0,0,0,9/6/2022,0,0,0,0,0,0,0,0,0,0,0,0,0,0,0,0,0,0,0,0
176460,2022,Japan,Netherlands,0,0,0,0,8/6/2022,0,0,0,0,0,0,0,0,0,0,0,0,0,0,0,0,0,0,0,0
169923,2022,Italy,Netherlands,0,0,0,0,20/07/2022,0,0,1,1,2,0,1,3,0,0,0,0,0,0,0,0,0,0,0,0
169923,2022,Italy,Netherlands,0,0,0,0,10/7/2022,0,0,0,0,0,0,0,0,0,0,0,0,0,0,0,0,0,0,0,0
169923,2022,Poland,Netherlands,0,0,0,0,9/7/2022,0,0,0,0,0,0,0,0,0,0,0,0,0,0,0,0,0,0,0,0
169923,2022,Bulgaria,Netherlands,0,0,0,0,8/7/2022,0,0,0,0,0,0,0,0,0,0,0,0,0,0,0,0,0,0,0,0
169923,2022,Netherlands,China,0,0,0,0,6/7/2022,0,0,0,0,0,0,0,0,0,0,0,0,0,0,0,0,0,0,0,0
169923,2022,Argentina,Netherlands,0,1,0,1,25/06/2022,0,0,0,0,7,2,2,11,0,2,2,4,0,0,0,0,1,1,0,2
169923,2022,Germany,Netherlands,0,0,1,1,24/06/2022,0,0,2,2,0,0,0,0,0,0,0,0,0,0,0,0,0,0,0,0
169923,2022,France,Netherlands,0,1,2,3,23/06/2022,0,0,1,1,3,1,1,5,0,0,1,1,0,0,0,0,0,0,0,0
169923,2022,Slovenia,Netherlands,0,0,0,0,21/06/2022,0,0,0,0,0,0,0,0,0,0,0,0,0,0,0,0,0,0,0,0
169923,2022,Netherlands,Australia,0,0,0,0,12/6/2022,0,0,0,0,0,0,0,0,0,0,0,0,0,0,0,0,0,0,0,0
169923,2022,Netherlands,Iran,0,0,0,0,10/6/2022,0,0,0,0,0,0,0,0,0,0,0,0,0,0,0,0,0,0,0,0
169923,2022,Netherlands,USA,0,1,8,9,9/6/2022,0,0,0,0,6,5,10,21,1,2,0,3,0,0,0,0,2,0,0,2
169923,2022,Japan,Netherlands,0,0,1,1,8/6/2022,0,0,0,0,0,0,0,0,0,0,0,0,0,0,0,0,1,0,0,1
181318,2022,,,-,-,-,-,-,-,-,-,-,-,-,-,-,-,-,-,-,-,-,-,-,-,-,-,-
170436,2022,Italy,Netherlands,4,4,9,17,20/07/2022,0,0,3,3,16,4,11,31,0,1,1,2,13,2,14,29,8,1,0,9
170436,2022,Italy,Netherlands,1,4,10,15,10/7/2022,0,0,0,0,5,1,9,15,2,1,0,3,0,1,17,18,2,0,1,3
170436,2022,Poland,Netherlands,1,2,6,9,9/7/2022,0,0,2,2,7,3,5,15,0,4,0,4,1,2,15,18,1,1,0,2
170436,2022,Bulgaria,Netherlands,2,1,6,9,8/7/2022,0,0,6,6,6,2,5,13,0,0,0,0,1,1,14,16,2,0,1,3
170436,2022,Netherlands,China,0,1,2,3,6/7/2022,0,0,1,1,0,2,4,6,0,0,0,0,3,0,5,8,0,0,0,0
170436,2022,Argentina,Netherlands,0,4,16,20,25/06/2022,0,0,3,3,17,1,13,31,1,5,2,8,5,1,18,24,4,1,1,6
170436,2022,Germany,Netherlands,1,4,9,14,24/06/2022,0,0,0,0,8,4,17,29,1,3,3,7,2,1,16,19,7,1,3,11
170436,2022,France,Netherlands,3,2,6,11,23/06/2022,1,0,0,1,7,3,9,19,1,1,1,3,10,2,15,27,3,1,0,4
170436,2022,Slovenia,Netherlands,2,2,10,14,21/06/2022,0,0,3,3,10,4,4,18,1,3,2,6,2,0,10,12,6,2,0,8
170436,2022,Netherlands,Australia,1,1,4,6,12/6/2022,1,0,1,2,4,2,3,9,0,2,0,2,1,0,6,7,2,0,1,3
170436,2022,Netherlands,Iran,0,5,10,15,10/6/2022,1,0,0,1,7,2,4,13,1,3,1,5,4,2,13,19,6,0,0,6
170436,2022,Netherlands,USA,0,1,0,1,9/6/2022,1,0,0,1,2,0,1,3,0,1,0,1,0,0,0,0,0,0,0,0
170436,2022,Japan,Netherlands,0,0,12,12,8/6/2022,2,0,1,3,10,4,9,23,1,2,2,5,9,3,24,36,7,2,0,9
184896,2022,Italy,Netherlands,0,0,0,0,20/07/2022,0,0,0,0,0,0,0,0,0,0,0,0,0,0,0,0,0,0,0,0
184896,2022,Italy,Netherlands,0,0,0,0,10/7/2022,0,0,0,0,0,0,0,0,0,0,0,0,0,0,0,0,0,0,0,0
184896,2022,Poland,Netherlands,0,0,0,0,9/7/2022,0,0,0,0,0,0,0,0,0,0,0,0,0,0,0,0,0,0,0,0
184896,2022,Bulgaria,Netherlands,0,0,0,0,8/7/2022,0,0,0,0,0,0,0,0,0,0,0,0,0,0,0,0,0,0,0,0
184896,2022,Netherlands,China,0,0,0,0,6/7/2022,0,0,0,0,0,0,0,0,0,0,0,0,0,0,0,0,0,0,0,0
137498,2022,Italy,Netherlands,0,6,5,11,20/07/2022,0,0,1,1,16,7,18,41,0,3,2,5,0,0,1,1,6,1,0,7
137498,2022,Italy,Netherlands,1,4,7,12,10/7/2022,0,0,0,0,14,4,11,29,0,4,0,4,0,0,2,2,0,0,0,0
137498,2022,Poland,Netherlands,4,5,9,18,9/7/2022,0,0,2,2,15,5,6,26,0,0,0,0,0,0,1,1,1,1,0,2
137498,2022,Bulgaria,Netherlands,2,5,11,18,8/7/2022,0,1,2,3,22,10,14,46,1,2,0,3,0,0,2,2,5,0,1,6
137498,2022,Netherlands,China,6,3,7,16,6/7/2022,0,0,0,0,21,2,11,34,3,2,0,5,0,0,2,2,0,0,0,0
137498,2022,Argentina,Netherlands,2,5,6,13,25/06/2022,0,0,4,4,21,8,13,42,1,2,1,4,0,0,0,0,3,2,0,5
137498,2022,Germany,Netherlands,3,5,9,17,24/06/2022,0,0,1,1,25,5,23,53,3,0,6,9,0,0,2,2,7,5,0,12
137498,2022,France,Netherlands,1,5,2,8,23/06/2022,1,0,1,2,10,4,8,22,0,2,1,3,1,0,1,2,0,4,0,4
137498,2022,Slovenia,Netherlands,3,5,3,11,21/06/2022,1,0,2,3,15,6,13,34,0,3,4,7,0,0,0,0,6,2,1,9
137498,2022,Netherlands,Australia,5,6,7,18,12/6/2022,1,0,0,1,14,2,8,24,1,3,1,5,0,0,0,0,2,2,0,4
137498,2022,Netherlands,Iran,2,5,8,15,10/6/2022,0,0,0,0,17,1,10,28,1,1,2,4,0,0,1,1,2,2,0,4
137498,2022,Netherlands,USA,0,0,0,0,9/6/2022,0,0,0,0,0,0,0,0,0,0,0,0,0,0,0,0,0,0,0,0
137498,2022,Japan,Netherlands,1,7,10,18,8/6/2022,1,0,3,4,17,6,8,31,0,2,3,5,0,0,1,1,4,1,2,7
164837,2022,Argentina,Netherlands,0,0,2,2,25/06/2022,0,0,1,1,0,0,0,0,0,1,1,2,0,0,0,0,0,0,0,0
164837,2022,Germany,Netherlands,0,0,1,1,24/06/2022,0,0,10,10,0,0,0,0,0,0,1,1,0,0,0,0,0,0,0,0
164837,2022,France,Netherlands,0,0,0,0,23/06/2022,3,0,8,11,0,0,0,0,0,0,0,0,0,0,0,0,1,0,0,1
164837,2022,Slovenia,Netherlands,0,0,0,0,21/06/2022,0,0,0,0,0,0,0,0,0,0,0,0,0,0,0,0,0,0,0,0
164837,2022,Netherlands,Australia,0,0,0,0,12/6/2022,0,0,0,0,0,0,0,0,0,0,0,0,0,0,0,0,0,0,0,0
164837,2022,Netherlands,Iran,0,0,0,0,10/6/2022,0,0,0,0,0,0,0,0,0,0,0,0,0,0,0,0,0,0,0,0
164837,2022,Netherlands,USA,0,0,3,3,9/6/2022,15,4,37,56,0,0,1,1,1,0,3,4,0,0,0,0,2,1,0,3
164837,2022,Japan,Netherlands,0,0,0,0,8/6/2022,0,2,13,15,0,0,0,0,0,0,0,0,0,0,0,0,0,0,0,0
137337,2022,Italy,Netherlands,0,0,1,1,20/07/2022,0,0,0,0,0,0,0,0,0,0,0,0,0,0,0,0,0,0,0,0
137337,2022,Italy,Netherlands,0,0,0,0,10/7/2022,0,0,0,0,0,0,0,0,0,0,0,0,0,0,0,0,0,0,0,0
137337,2022,Poland,Netherlands,0,0,1,1,9/7/2022,0,0,0,0,0,0,0,0,0,0,0,0,0,0,0,0,0,0,0,0
137337,2022,Bulgaria,Netherlands,1,0,5,6,8/7/2022,0,1,2,3,6,0,0,6,1,5,0,6,0,0,2,2,0,0,0,0
137337,2022,Netherlands,China,0,0,0,0,6/7/2022,0,0,0,0,0,0,0,0,0,0,0,0,0,0,0,0,0,0,0,0
137337,2022,Argentina,Netherlands,0,1,6,7,25/06/2022,0,0,1,1,5,0,1,6,0,5,1,6,0,0,0,0,3,1,0,4
137337,2022,Germany,Netherlands,0,0,0,0,24/06/2022,0,0,0,0,0,0,0,0,0,0,0,0,0,0,0,0,0,0,0,0
137337,2022,France,Netherlands,1,0,2,3,23/06/2022,0,0,0,0,0,2,1,3,0,1,1,2,0,0,1,1,0,0,0,0
137337,2022,Slovenia,Netherlands,0,0,0,0,21/06/2022,0,0,0,0,0,0,0,0,0,0,0,0,0,0,0,0,0,0,0,0
137337,2022,Netherlands,Australia,0,0,0,0,12/6/2022,0,0,0,0,0,0,0,0,0,0,0,0,0,0,0,0,0,0,0,0
137337,2022,Netherlands,Iran,0,0,0,0,10/6/2022,0,0,0,0,0,0,0,0,0,0,0,0,0,0,0,0,0,0,0,0
137337,2022,Netherlands,USA,0,1,9,10,9/6/2022,1,0,0,1,2,1,3,6,1,2,3,6,1,0,1,2,2,0,0,2
137337,2022,Japan,Netherlands,0,1,2,3,8/6/2022,0,0,0,0,0,0,0,0,0,0,1,1,0,0,0,0,0,0,0,0
121992,2022,Italy,Netherlands,0,0,0,0,20/07/2022,1,0,5,6,0,0,0,0,0,0,0,0,9,2,16,27,4,3,0,7
121992,2022,Italy,Netherlands,0,0,0,0,10/7/2022,0,0,0,0,0,0,0,0,0,0,0,0,2,1,10,13,5,3,1,9
121992,2022,Poland,Netherlands,0,0,0,0,9/7/2022,0,0,3,3,0,0,0,0,0,0,0,0,1,0,20,21,4,1,1,6
121992,2022,Bulgaria,Netherlands,0,0,0,0,8/7/2022,0,0,0,0,0,0,0,0,0,0,0,0,15,0,10,25,9,4,2,15
121992,2022,Netherlands,China,0,0,0,0,6/7/2022,0,0,0,0,0,0,0,0,0,0,0,0,0,0,5,5,1,2,1,4
121992,2022,Argentina,Netherlands,0,0,0,0,25/06/2022,0,0,6,6,0,0,0,0,0,0,0,0,9,1,15,25,10,3,0,13
121992,2022,Germany,Netherlands,0,0,0,0,24/06/2022,0,0,4,4,0,0,0,0,0,0,0,0,6,0,16,22,8,6,3,17
121992,2022,France,Netherlands,0,0,0,0,23/06/2022,0,0,3,3,0,0,0,0,0,0,0,0,2,1,4,7,8,2,0,10
121992,2022,Slovenia,Netherlands,0,0,0,0,21/06/2022,0,0,4,4,0,0,0,0,0,0,0,0,3,0,7,10,7,2,1,10
121992,2022,Netherlands,Australia,0,0,0,0,12/6/2022,0,0,0,0,0,0,0,0,0,0,0,0,2,0,6,8,6,1,0,7
121992,2022,Netherlands,Iran,0,0,0,0,10/6/2022,1,0,1,2,0,0,0,0,0,0,0,0,6,1,17,24,6,1,1,8
121992,2022,Netherlands,USA,0,0,0,0,9/6/2022,3,0,0,3,0,0,0,0,0,0,0,0,2,3,9,14,2,4,0,6
121992,2022,Japan,Netherlands,0,0,0,0,8/6/2022,2,0,2,4,0,0,0,0,0,0,0,0,3,1,9,13,6,0,0,6
162642,2022,Italy,Netherlands,0,0,0,0,20/07/2022,1,0,7,8,0,0,0,0,0,0,0,0,0,0,0,0,0,1,0,1
162642,2022,Italy,Netherlands,0,0,0,0,10/7/2022,0,0,0,0,0,0,0,0,0,0,0,0,0,0,0,0,0,0,0,0
162642,2022,Poland,Netherlands,0,0,0,0,9/7/2022,0,0,2,2,0,0,0,0,0,0,0,0,0,0,0,0,0,0,0,0
162642,2022,Bulgaria,Netherlands,0,2,1,3,8/7/2022,7,0,11,18,0,0,0,0,0,2,0,2,0,0,0,0,0,0,0,0
162642,2022,Netherlands,China,0,0,0,0,6/7/2022,0,0,0,0,0,0,0,0,0,0,0,0,0,0,0,0,0,0,0,0
181317,2022,,,-,-,-,-,-,-,-,-,-,-,-,-,-,-,-,-,-,-,-,-,-,-,-,-,-
153711,2022,,,-,-,-,-,-,-,-,-,-,-,-,-,-,-,-,-,-,-,-,-,-,-,-,-,-
150703,2022,Italy,Netherlands,0,1,7,8,20/07/2022,0,0,1,1,2,2,2,6,1,2,3,6,0,0,1,1,1,0,1,2
150703,2022,Italy,Netherlands,1,2,8,11,10/7/2022,0,1,1,2,2,1,0,3,2,6,0,8,0,0,2,2,0,0,0,0
150703,2022,Poland,Netherlands,0,2,6,8,9/7/2022,0,0,0,0,0,0,1,1,4,3,0,7,0,0,0,0,0,2,0,2
150703,2022,Bulgaria,Netherlands,0,0,5,5,8/7/2022,0,0,0,0,2,2,1,5,0,3,0,3,0,0,2,2,1,0,0,1
150703,2022,Netherlands,China,1,1,9,11,6/7/2022,0,0,0,0,2,0,2,4,2,3,0,5,0,0,0,0,1,0,0,1
150703,2022,Argentina,Netherlands,0,2,4,6,25/06/2022,0,0,1,1,0,0,0,0,0,0,0,0,0,0,0,0,0,0,0,0
150703,2022,Germany,Netherlands,0,4,12,16,24/06/2022,0,1,0,1,4,0,0,4,4,4,15,23,0,0,1,1,4,0,0,4
150703,2022,France,Netherlands,0,0,7,7,23/06/2022,0,0,0,0,0,2,2,4,0,4,4,8,0,0,0,0,1,0,0,1
150703,2022,Slovenia,Netherlands,1,1,8,10,21/06/2022,0,0,1,1,1,2,1,4,2,3,10,15,0,0,1,1,1,3,0,4
150703,2022,Netherlands,Australia,1,0,9,10,12/6/2022,0,0,0,0,3,0,1,4,1,2,0,3,0,0,0,0,0,1,1,2
150703,2022,Netherlands,Iran,0,0,10,10,10/6/2022,0,0,1,1,2,0,1,3,2,2,3,7,0,0,0,0,0,2,0,2
150703,2022,Netherlands,USA,0,1,5,6,9/6/2022,0,0,0,0,2,0,2,4,1,1,1,3,0,0,2,2,0,0,0,0
150703,2022,Japan,Netherlands,0,0,2,2,8/6/2022,0,0,0,0,0,0,0,0,0,0,0,0,0,0,0,0,0,1,0,1
184361,2022,,,-,-,-,-,-,-,-,-,-,-,-,-,-,-,-,-,-,-,-,-,-,-,-,-,-
157237,2022,,,-,-,-,-,-,-,-,-,-,-,-,-,-,-,-,-,-,-,-,-,-,-,-,-,-
188782,2022,,,-,-,-,-,-,-,-,-,-,-,-,-,-,-,-,-,-,-,-,-,-,-,-,-,-
188784,2022,,,-,-,-,-,-,-,-,-,-,-,-,-,-,-,-,-,-,-,-,-,-,-,-,-,-
153394,2022,France,Poland,0,0,1,1,12/6/2022,0,0,0,0,0,1,0,1,0,0,0,0,0,0,0,0,0,0,0,0
153394,2022,Bulgaria,Poland,1,3,9,13,11/6/2022,0,0,1,1,11,4,12,27,0,3,2,5,3,0,12,15,7,2,3,12
153394,2022,Poland,Italy,0,0,0,0,9/6/2022,0,0,0,0,0,0,0,0,0,0,0,0,0,0,0,0,0,0,0,0
153394,2022,Poland,Argentina,0,0,0,0,8/6/2022,0,0,0,0,0,0,0,0,0,0,0,0,0,0,0,0,0,0,0,0
156531,2022,France,Poland,0,0,0,0,12/6/2022,0,0,0,0,0,0,0,0,0,0,0,0,0,0,0,0,0,0,0,0
156531,2022,Bulgaria,Poland,0,4,7,11,11/6/2022,0,0,1,1,12,1,4,17,1,3,3,7,0,0,0,0,4,4,1,9
156531,2022,Poland,Italy,0,0,0,0,9/6/2022,0,0,0,0,0,0,1,1,0,1,0,1,0,0,0,0,0,0,0,0
156531,2022,Poland,Argentina,0,2,9,11,8/6/2022,0,1,1,2,9,6,9,24,1,0,2,3,0,0,0,0,3,1,1,5
153388,2022,Italy,Poland,0,0,0,0,24/07/2022,0,0,0,0,0,0,0,0,0,0,0,0,0,0,0,0,0,0,0,0
153388,2022,Poland,USA,0,0,0,0,23/07/2022,0,0,0,0,0,0,0,0,0,0,0,0,0,0,0,0,0,0,0,0
153388,2022,Poland,Iran,0,0,0,0,21/07/2022,0,0,0,0,0,0,0,0,0,0,0,0,0,0,0,0,0,0,0,0
153388,2022,Poland,Slovenia,0,0,0,0,10/7/2022,0,0,0,0,0,0,0,0,0,0,0,0,0,0,0,0,0,0,0,0
153388,2022,Poland,Netherlands,0,0,0,0,9/7/2022,0,0,0,0,0,0,0,0,0,0,0,0,0,0,0,0,0,0,0,0
153388,2022,Poland,China,0,0,0,0,7/7/2022,0,0,2,2,0,0,0,0,0,0,0,0,5,0,10,15,4,0,0,4
153388,2022,Iran,Poland,0,0,0,0,5/7/2022,0,0,0,0,0,0,0,0,0,0,0,0,0,0,0,0,0,1,0,1
153388,2022,USA,Poland,0,0,0,0,26/06/2022,0,0,0,0,0,0,0,0,0,0,0,0,5,3,7,15,2,3,0,5
153388,2022,Poland,Australia,0,0,0,0,25/06/2022,0,0,0,0,0,0,0,0,0,0,0,0,0,0,0,0,0,0,0,0
153388,2022,Poland,Canada,0,0,0,0,23/06/2022,0,0,2,2,0,0,0,0,0,0,0,0,0,2,7,9,3,0,0,3
153388,2022,Brazil,Poland,0,0,0,0,22/06/2022,0,0,0,0,0,0,0,0,0,0,0,0,0,0,0,0,0,0,0,0
153388,2022,France,Poland,0,0,0,0,12/6/2022,0,0,3,3,0,0,0,0,0,0,0,0,2,3,15,20,8,4,0,12
153388,2022,Bulgaria,Poland,0,0,0,0,11/6/2022,0,0,0,0,0,0,0,0,0,0,0,0,0,0,0,0,0,0,1,1
153388,2022,Poland,Italy,0,0,0,0,9/6/2022,0,0,3,3,0,0,0,0,0,0,0,0,3,2,16,21,1,3,3,7
153388,2022,Poland,Argentina,0,0,0,0,8/6/2022,0,0,7,7,0,0,0,0,0,0,0,0,7,0,5,12,10,2,2,14
152872,2022,France,Poland,0,0,0,0,12/6/2022,0,0,0,0,0,0,0,0,0,0,0,0,0,0,0,0,0,0,0,0
152872,2022,Bulgaria,Poland,0,0,7,7,11/6/2022,39,0,32,71,1,0,0,1,1,1,3,5,0,0,1,1,1,0,4,5
152872,2022,Poland,Italy,0,0,0,0,9/6/2022,1,0,0,1,0,0,0,0,0,0,0,0,0,0,0,0,0,0,1,1
152872,2022,Poland,Argentina,0,0,0,0,8/6/2022,0,0,0,0,0,0,0,0,0,0,0,0,0,0,0,0,0,0,0,0
162105,2022,Italy,Poland,0,0,0,0,24/07/2022,0,0,0,0,0,0,0,0,0,0,0,0,0,0,0,0,0,0,0,0
162105,2022,Poland,USA,0,0,0,0,23/07/2022,0,0,0,0,1,0,0,1,0,2,0,2,0,0,0,0,0,0,0,0
162105,2022,Poland,Iran,0,1,2,3,21/07/2022,0,0,0,0,3,0,3,6,0,0,0,0,0,0,0,0,0,0,0,0
162105,2022,Poland,Slovenia,0,0,3,3,10/7/2022,0,0,0,0,0,1,1,2,1,0,0,1,0,0,0,0,1,0,0,1
162105,2022,Poland,Netherlands,0,0,1,1,9/7/2022,0,0,0,0,0,0,0,0,0,0,0,0,0,0,0,0,0,0,0,0
162105,2022,Poland,China,2,2,10,14,7/7/2022,0,0,0,0,7,4,5,16,1,1,0,2,0,0,0,0,2,1,0,3
162105,2022,Iran,Poland,0,0,1,1,5/7/2022,0,0,0,0,1,0,1,2,0,0,0,0,0,0,0,0,0,0,0,0
162105,2022,USA,Poland,0,1,0,1,26/06/2022,0,0,0,0,0,0,0,0,0,0,0,0,0,0,0,0,0,0,0,0
162105,2022,Poland,Australia,1,1,12,14,25/06/2022,0,0,1,1,7,4,6,17,0,2,3,5,0,0,0,0,2,1,0,3
162105,2022,Poland,Canada,0,1,13,14,23/06/2022,0,0,1,1,12,1,4,17,1,0,0,1,0,0,0,0,2,1,1,4
162105,2022,Brazil,Poland,0,0,1,1,22/06/2022,0,0,2,2,2,2,3,7,0,0,1,1,0,0,0,0,0,0,0,0
115806,2022,Italy,Poland,3,4,7,14,24/07/2022,0,0,3,3,10,3,12,25,0,0,5,5,0,0,0,0,8,1,1,10
115806,2022,Poland,USA,1,3,7,11,23/07/2022,0,0,1,1,10,3,11,24,0,1,1,2,0,0,0,0,2,4,0,6
115806,2022,Poland,Iran,1,6,6,13,21/07/2022,0,0,2,2,13,5,10,28,1,1,5,7,0,0,0,0,1,5,0,6
115806,2022,Poland,Slovenia,5,6,8,19,10/7/2022,0,0,0,0,14,3,8,25,4,1,0,5,0,0,0,0,2,0,0,2
115806,2022,Poland,Netherlands,1,0,2,3,9/7/2022,0,0,1,1,2,0,1,3,0,1,0,1,0,0,0,0,0,0,0,0
115806,2022,Poland,China,0,0,0,0,7/7/2022,0,0,0,0,0,0,0,0,0,0,0,0,0,0,0,0,0,0,0,0
115806,2022,Iran,Poland,2,3,13,18,5/7/2022,0,0,0,0,19,4,11,34,2,2,0,4,0,0,1,1,1,4,1,6
115806,2022,USA,Poland,0,3,16,19,26/06/2022,0,0,2,2,21,5,2,28,2,1,1,4,1,0,1,2,2,1,2,5
115806,2022,Poland,Australia,0,0,1,1,25/06/2022,0,0,0,0,5,0,1,6,0,0,1,1,0,0,0,0,0,1,0,1
115806,2022,Poland,Canada,0,0,2,2,23/06/2022,0,0,0,0,1,0,0,1,0,0,0,0,0,0,0,0,0,0,0,0
115806,2022,Brazil,Poland,0,6,9,15,22/06/2022,0,0,3,3,16,7,17,40,1,1,2,4,0,0,0,0,1,0,2,3
118618,2022,Italy,Poland,0,0,0,0,24/07/2022,0,0,0,0,0,0,0,0,0,0,0,0,0,0,0,0,0,0,0,0
118618,2022,Poland,USA,0,0,0,0,23/07/2022,0,0,0,0,0,0,0,0,0,0,0,0,0,0,0,0,0,0,0,0
118618,2022,Poland,Iran,1,1,10,12,21/07/2022,0,0,0,0,2,1,0,3,3,2,0,5,1,0,0,1,0,0,2,2
118618,2022,Poland,Slovenia,0,0,2,2,10/7/2022,0,0,0,0,0,0,0,0,2,0,0,2,0,0,0,0,0,0,0,0
118618,2022,Poland,Netherlands,0,1,7,8,9/7/2022,0,0,0,0,5,0,1,6,5,2,1,8,0,0,0,0,2,0,0,2
118618,2022,Poland,China,0,0,6,6,7/7/2022,0,0,1,1,8,1,0,9,0,4,0,4,0,0,0,0,0,1,0,1
118618,2022,Iran,Poland,0,0,5,5,5/7/2022,0,0,0,0,3,0,1,4,1,2,0,3,0,0,1,1,0,0,1,1
118618,2022,USA,Poland,0,0,0,0,26/06/2022,0,0,0,0,0,0,0,0,0,0,0,0,0,0,0,0,0,0,0,0
118618,2022,Poland,Australia,1,0,12,13,25/06/2022,1,0,0,1,6,3,2,11,2,3,5,10,0,0,0,0,1,0,0,1
118618,2022,Poland,Canada,0,0,8,8,23/06/2022,0,0,0,0,7,0,1,8,2,1,3,6,1,0,1,2,1,0,0,1
118618,2022,Brazil,Poland,0,0,0,0,22/06/2022,0,0,0,0,0,0,0,0,0,0,0,0,0,0,0,0,0,0,0,0
118618,2022,France,Poland,0,1,4,5,12/6/2022,0,0,0,0,0,1,2,3,2,2,0,4,0,0,0,0,0,0,0,0
118618,2022,Bulgaria,Poland,1,1,7,9,11/6/2022,0,0,0,0,3,1,0,4,1,1,2,4,0,1,0,1,1,0,1,2
118618,2022,Poland,Italy,0,0,1,1,9/6/2022,0,0,0,0,0,0,0,0,0,1,0,1,0,0,0,0,1,0,0,1
118618,2022,Poland,Argentina,1,1,9,11,8/6/2022,0,0,3,3,5,0,3,8,3,3,4,10,0,0,1,1,0,1,0,1
119646,2022,,,-,-,-,-,-,-,-,-,-,-,-,-,-,-,-,-,-,-,-,-,-,-,-,-,-
150742,2022,Italy,Poland,0,0,0,0,24/07/2022,0,0,0,0,0,0,0,0,0,0,0,0,0,0,0,0,0,0,0,0
150742,2022,Poland,USA,0,1,3,4,23/07/2022,0,0,0,0,2,0,2,4,0,0,1,1,1,3,2,6,0,1,0,1
150742,2022,Poland,Iran,0,0,0,0,21/07/2022,0,0,0,0,0,0,1,1,0,0,0,0,1,0,2,3,0,0,0,0
150742,2022,Poland,Slovenia,0,0,0,0,10/7/2022,0,0,0,0,0,0,0,0,0,0,0,0,0,0,0,0,0,0,0,0
150742,2022,Poland,Netherlands,1,2,3,6,9/7/2022,0,0,0,0,5,1,0,6,0,0,0,0,0,3,7,10,1,3,0,4
150742,2022,Poland,China,0,0,0,0,7/7/2022,0,0,0,0,0,0,0,0,0,0,0,0,0,0,0,0,0,0,0,0
150742,2022,Iran,Poland,0,6,9,15,5/7/2022,0,0,3,3,16,8,6,30,1,1,0,2,5,2,22,29,1,0,0,1
115794,2022,Italy,Poland,0,0,0,0,24/07/2022,0,0,0,0,0,0,0,0,0,0,0,0,0,0,0,0,0,0,0,0
115794,2022,Poland,USA,0,0,1,1,23/07/2022,5,0,6,11,0,0,0,0,0,1,0,1,0,0,0,0,0,0,0,0
115794,2022,Poland,Iran,0,0,3,3,21/07/2022,3,0,15,18,0,0,0,0,0,1,0,1,0,0,0,0,1,1,0,2
115794,2022,USA,Poland,0,0,0,0,26/06/2022,1,0,5,6,0,0,0,0,0,0,0,0,0,0,0,0,0,0,1,1
115794,2022,Poland,Australia,0,0,7,7,25/06/2022,26,0,39,65,0,0,0,0,0,1,2,3,0,0,0,0,2,2,1,5
115794,2022,Poland,Canada,0,0,3,3,23/06/2022,4,0,7,11,0,0,0,0,0,1,0,1,0,0,0,0,1,0,0,1
115794,2022,Brazil,Poland,0,0,1,1,22/06/2022,2,0,1,3,0,0,0,0,0,0,0,0,0,0,0,0,0,0,1,1
142678,2022,France,Poland,0,0,1,1,12/6/2022,0,0,0,0,0,1,2,3,0,0,1,1,0,2,3,5,2,0,0,2
142678,2022,Bulgaria,Poland,0,0,0,0,11/6/2022,0,0,0,0,0,0,1,1,0,0,0,0,0,0,0,0,0,0,0,0
142678,2022,Poland,Italy,0,1,13,14,9/6/2022,0,0,6,6,13,4,9,26,0,4,5,9,10,3,13,26,7,2,2,11
142678,2022,Poland,Argentina,0,0,0,0,8/6/2022,0,0,0,0,0,0,0,0,0,0,0,0,0,0,0,0,0,0,0,0
142679,2022,Italy,Poland,0,0,1,1,24/07/2022,0,0,1,1,1,0,3,4,0,1,2,3,2,0,6,8,5,0,0,5
142679,2022,Poland,USA,0,3,1,4,23/07/2022,0,0,2,2,4,2,4,10,0,1,0,1,4,1,9,14,3,2,1,6
142679,2022,Poland,Iran,0,2,6,8,21/07/2022,1,0,2,3,10,1,7,18,0,1,3,4,5,1,15,21,5,5,0,10
142679,2022,Poland,Slovenia,0,2,4,6,10/7/2022,0,0,0,0,6,0,5,11,2,3,0,5,1,3,14,18,1,1,1,3
142679,2022,Poland,Netherlands,0,1,9,10,9/7/2022,0,0,0,0,5,0,3,8,0,0,0,0,0,1,6,7,2,0,1,3
142679,2022,Poland,China,0,0,0,0,7/7/2022,0,0,0,0,0,0,0,0,0,0,0,0,0,0,0,0,0,0,0,0
142679,2022,Iran,Poland,1,6,10,17,5/7/2022,0,0,3,3,9,0,8,17,0,2,0,2,3,2,28,33,5,3,0,8
142679,2022,USA,Poland,2,2,15,19,26/06/2022,1,0,1,2,10,5,9,24,1,2,0,3,6,4,20,30,1,1,0,2
142679,2022,Poland,Australia,0,2,7,9,25/06/2022,0,0,0,0,7,0,3,10,1,1,2,4,3,0,6,9,2,1,0,3
142679,2022,Poland,Canada,0,0,0,0,23/06/2022,0,0,0,0,0,0,0,0,0,0,0,0,0,0,0,0,0,0,0,0
142679,2022,Brazil,Poland,2,0,12,14,22/06/2022,0,0,1,1,7,1,6,14,0,1,1,2,7,1,18,26,3,0,0,3
152870,2022,Italy,Poland,1,5,9,15,24/07/2022,0,0,1,1,5,0,1,6,0,3,3,6,1,0,0,1,2,0,0,2
152870,2022,Poland,USA,2,1,10,13,23/07/2022,0,0,0,0,4,1,2,7,1,3,4,8,0,0,0,0,3,0,1,4
152870,2022,Poland,Iran,3,2,7,12,21/07/2022,0,0,0,0,1,1,3,5,2,0,2,4,0,0,1,1,2,0,0,2
152870,2022,Poland,Slovenia,1,2,9,12,10/7/2022,0,0,0,0,4,2,1,7,1,1,0,2,0,0,2,2,2,0,0,2
152870,2022,Poland,Netherlands,0,0,0,0,9/7/2022,0,0,0,0,0,0,0,0,0,0,0,0,0,0,0,0,0,0,0,0
152870,2022,Poland,China,3,2,14,19,7/7/2022,0,0,1,1,5,1,2,8,0,1,0,1,0,0,0,0,1,0,0,1
152870,2022,Iran,Poland,0,3,7,10,5/7/2022,0,0,0,0,3,2,4,9,2,3,0,5,0,0,0,0,0,0,0,0
152870,2022,USA,Poland,0,3,5,8,26/06/2022,0,0,1,1,4,0,1,5,4,3,3,10,0,0,1,1,1,1,0,2
152870,2022,Poland,Australia,0,0,0,0,25/06/2022,0,0,0,0,0,0,0,0,0,0,0,0,0,0,0,0,0,0,0,0
152870,2022,Poland,Canada,0,3,2,5,23/06/2022,0,0,0,0,4,1,1,6,0,1,1,2,0,0,0,0,0,0,0,0
152870,2022,Brazil,Poland,0,3,10,13,22/06/2022,0,0,1,1,8,0,4,12,4,3,5,12,1,0,1,2,1,1,1,3
152870,2022,France,Poland,0,2,9,11,12/6/2022,0,0,1,1,7,0,4,11,3,5,7,15,0,0,0,0,2,0,2,4
152870,2022,Bulgaria,Poland,0,0,0,0,11/6/2022,0,0,0,0,0,0,0,0,0,0,0,0,0,0,0,0,0,0,0,0
152870,2022,Poland,Italy,0,4,8,12,9/6/2022,0,0,0,0,4,2,3,9,1,3,2,6,1,0,2,3,1,0,0,1
152870,2022,Poland,Argentina,1,5,9,15,8/6/2022,0,0,1,1,5,0,1,6,1,6,9,16,0,0,0,0,2,0,0,2
153395,2022,Italy,Poland,2,2,12,16,24/07/2022,0,0,0,0,9,0,12,21,1,6,0,7,3,0,4,7,5,1,1,7
153395,2022,Poland,USA,0,3,4,7,23/07/2022,0,0,0,0,7,5,8,20,0,2,0,2,8,0,14,22,4,0,0,4
153395,2022,Poland,Iran,0,3,10,13,21/07/2022,0,0,1,1,15,3,12,30,2,3,2,7,9,1,12,22,4,1,0,5
153395,2022,Poland,Slovenia,1,3,19,23,10/7/2022,0,0,1,1,11,3,11,25,1,0,0,1,0,0,14,14,4,1,0,5
153395,2022,Poland,Netherlands,1,1,5,7,9/7/2022,0,0,0,0,7,0,3,10,2,1,0,3,1,0,7,8,0,0,0,0
153395,2022,Poland,China,0,4,6,10,7/7/2022,0,0,1,1,5,2,3,10,1,3,0,4,3,1,11,15,1,0,0,1
153395,2022,Iran,Poland,0,1,0,1,5/7/2022,0,0,0,0,0,0,1,1,0,0,0,0,0,1,1,2,0,0,0,0
153395,2022,USA,Poland,1,1,14,16,26/06/2022,0,0,1,1,14,3,11,28,0,2,3,5,5,1,16,22,2,2,0,4
153395,2022,Poland,Australia,0,0,0,0,25/06/2022,0,0,0,0,0,0,0,0,0,0,0,0,0,0,0,0,0,0,0,0
153395,2022,Poland,Canada,0,3,8,11,23/06/2022,0,0,0,0,6,0,3,9,0,0,0,0,1,0,6,7,2,0,0,2
153395,2022,Brazil,Poland,4,1,10,15,22/06/2022,0,0,0,0,12,2,10,24,2,2,2,6,3,0,13,16,1,1,0,2
118614,2022,Italy,Poland,0,0,0,0,24/07/2022,0,0,1,1,0,0,0,0,0,0,0,0,6,1,8,15,5,2,0,7
118614,2022,Poland,USA,0,0,0,0,23/07/2022,0,0,1,1,0,0,0,0,0,0,0,0,3,2,3,8,2,2,0,4
118614,2022,Poland,Iran,0,0,0,0,21/07/2022,0,0,2,2,0,0,0,0,0,0,0,0,9,3,12,24,14,5,1,20
118614,2022,Poland,Slovenia,0,0,0,0,10/7/2022,0,0,2,2,0,0,0,0,0,0,0,0,1,4,12,17,5,5,0,10
118614,2022,Poland,Netherlands,0,0,0,0,9/7/2022,0,0,5,5,0,0,0,0,0,0,0,0,4,2,9,15,3,1,1,5
118614,2022,Poland,China,0,0,0,0,7/7/2022,0,0,0,0,0,0,0,0,0,0,0,0,0,0,0,0,0,0,0,0
118614,2022,Iran,Poland,0,0,0,0,5/7/2022,0,0,5,5,0,0,0,0,0,0,0,0,4,3,18,25,6,3,0,9
118614,2022,USA,Poland,0,0,0,0,26/06/2022,0,0,1,1,0,0,0,0,0,0,0,0,2,0,3,5,5,3,1,9
118614,2022,Poland,Australia,0,0,0,0,25/06/2022,1,0,1,2,0,0,0,0,0,0,0,0,4,1,7,12,3,1,1,5
118614,2022,Poland,Canada,0,0,0,0,23/06/2022,0,0,0,0,0,0,0,0,0,0,0,0,0,0,0,0,0,0,0,0
118614,2022,Brazil,Poland,0,0,0,0,22/06/2022,0,0,0,0,0,0,0,0,0,0,0,0,6,0,13,19,5,3,4,12
152873,2022,USA,Poland,1,1,3,5,26/06/2022,0,0,0,0,0,0,1,1,0,0,0,0,0,0,2,2,2,0,0,2
152873,2022,Poland,Australia,0,4,12,16,25/06/2022,1,0,0,1,8,2,4,14,1,3,1,5,7,0,13,20,2,0,2,4
152873,2022,Poland,Canada,0,0,2,2,23/06/2022,0,0,0,0,2,1,2,5,0,0,1,1,0,0,2,2,1,0,0,1
152873,2022,Brazil,Poland,0,0,0,0,22/06/2022,0,0,0,0,0,0,0,0,0,0,0,0,0,0,0,0,0,0,0,0
152873,2022,France,Poland,1,2,10,13,12/6/2022,1,0,3,4,10,1,5,16,0,1,2,3,7,0,19,26,5,2,0,7
152873,2022,Bulgaria,Poland,2,1,12,15,11/6/2022,0,1,2,3,10,2,8,20,0,3,1,4,7,1,14,22,3,1,2,6
152873,2022,Poland,Italy,0,0,3,3,9/6/2022,0,0,0,0,0,1,0,1,0,1,0,1,0,0,2,2,0,0,0,0
152873,2022,Poland,Argentina,0,3,7,10,8/6/2022,0,0,1,1,7,4,4,15,1,2,2,5,6,2,17,25,5,2,1,8
165942,2022,Italy,Poland,0,2,5,7,24/07/2022,13,1,51,65,0,0,0,0,1,2,5,8,0,0,0,0,4,1,0,5
165942,2022,Poland,USA,0,0,5,5,23/07/2022,11,0,50,61,0,0,0,0,1,0,1,2,0,1,0,1,1,0,2,3
165942,2022,Poland,Iran,0,1,11,12,21/07/2022,14,0,66,80,0,0,0,0,0,3,0,3,0,0,0,0,3,2,0,5
165942,2022,Poland,Slovenia,0,2,7,9,10/7/2022,15,0,61,76,0,0,0,0,0,0,0,0,0,0,0,0,0,1,1,2
165942,2022,Poland,Netherlands,0,0,9,9,9/7/2022,12,0,41,53,0,0,0,0,0,4,0,4,0,0,1,1,2,3,1,6
165942,2022,Poland,China,0,0,0,0,7/7/2022,0,0,4,4,0,0,0,0,0,0,0,0,0,0,0,0,0,0,0,0
165942,2022,Iran,Poland,1,2,5,8,5/7/2022,10,0,57,67,0,0,1,1,1,2,1,4,0,0,1,1,1,2,1,4
165942,2022,USA,Poland,0,2,7,9,26/06/2022,18,2,70,90,0,0,0,0,0,0,1,1,0,0,0,0,5,2,0,7
165942,2022,Poland,Australia,0,0,0,0,25/06/2022,3,0,2,5,0,0,0,0,0,0,0,0,0,0,0,0,0,1,0,1
165942,2022,Poland,Canada,2,1,6,9,23/06/2022,12,0,33,45,0,0,1,1,1,4,2,7,0,0,0,0,0,2,0,2
165942,2022,Brazil,Poland,0,1,8,9,22/06/2022,13,0,75,88,1,0,0,1,0,1,1,2,0,0,0,0,4,3,1,8
150734,2022,Italy,Poland,3,1,8,12,24/07/2022,0,0,3,3,6,2,2,10,1,6,5,12,0,0,0,0,1,0,0,1
150734,2022,Poland,USA,1,3,6,10,23/07/2022,0,0,0,0,4,0,2,6,0,2,3,5,0,0,1,1,1,0,0,1
150734,2022,Poland,Iran,1,3,14,18,21/07/2022,0,0,0,0,6,0,3,9,2,2,4,8,1,0,1,2,3,2,0,5
150734,2022,Poland,Slovenia,1,4,15,20,10/7/2022,0,0,0,0,7,0,2,9,1,5,0,6,0,0,1,1,0,0,0,0
150734,2022,Poland,Netherlands,1,2,10,13,9/7/2022,0,0,0,0,6,2,1,9,0,6,1,7,0,0,0,0,0,0,0,0
150734,2022,Poland,China,2,0,1,3,7/7/2022,0,0,0,0,0,0,0,0,0,0,0,0,0,0,0,0,0,1,0,1
150734,2022,Iran,Poland,4,4,14,22,5/7/2022,0,0,0,0,8,2,3,13,5,4,0,9,0,0,0,0,0,0,1,1
150734,2022,USA,Poland,0,4,15,19,26/06/2022,0,0,0,0,8,2,3,13,0,1,4,5,0,0,1,1,1,0,0,1
150734,2022,Poland,Australia,1,2,4,7,25/06/2022,0,0,0,0,6,1,1,8,0,2,2,4,0,0,0,0,1,0,0,1
150734,2022,Poland,Canada,0,1,0,1,23/06/2022,0,0,0,0,0,0,0,0,0,0,0,0,0,0,0,0,0,0,0,0
150734,2022,Brazil,Poland,7,5,16,28,22/06/2022,1,0,0,1,2,1,5,8,0,5,6,11,0,0,0,0,2,0,0,2
152866,2022,Italy,Poland,0,2,3,5,24/07/2022,0,0,3,3,6,0,2,8,0,0,0,0,9,0,8,17,3,0,0,3
152866,2022,Poland,USA,0,2,1,3,23/07/2022,0,0,0,0,2,0,2,4,0,0,0,0,4,2,5,11,1,0,0,1
152866,2022,Poland,Iran,0,2,0,2,21/07/2022,0,0,0,0,0,0,3,3,0,1,0,1,1,1,2,4,0,2,0,2
152866,2022,Poland,Slovenia,1,1,2,4,10/7/2022,0,0,0,0,5,1,2,8,1,0,0,1,2,0,4,6,3,0,0,3
152866,2022,Poland,Netherlands,0,2,4,6,9/7/2022,0,0,0,0,2,1,2,5,0,0,0,0,0,0,8,8,2,0,0,2
152866,2022,Poland,China,5,1,10,16,7/7/2022,0,0,1,1,14,1,2,17,1,3,0,4,3,1,8,12,1,0,0,1
152866,2022,Iran,Poland,2,0,3,5,5/7/2022,0,0,0,0,1,0,0,1,0,0,0,0,0,1,2,3,2,0,0,2
152866,2022,USA,Poland,0,0,0,0,26/06/2022,0,0,0,0,0,0,0,0,0,0,0,0,0,0,0,0,0,0,0,0
152866,2022,Poland,Australia,0,0,2,2,25/06/2022,0,0,1,1,4,0,3,7,0,0,1,1,2,0,1,3,2,0,0,2
152866,2022,Poland,Canada,1,4,8,13,23/06/2022,0,0,3,3,7,2,5,14,1,2,3,6,7,1,9,17,6,1,0,7
152866,2022,Brazil,Poland,0,0,0,0,22/06/2022,0,0,0,0,0,0,0,0,0,0,0,0,0,0,0,0,0,0,0,0
152866,2022,France,Poland,2,4,8,14,12/6/2022,0,0,1,1,12,6,12,30,2,4,4,10,2,3,13,18,6,1,1,8
152866,2022,Bulgaria,Poland,0,0,0,0,11/6/2022,0,0,0,0,0,0,0,0,0,0,0,0,0,0,0,0,0,0,0,0
152866,2022,Poland,Italy,0,8,3,11,9/6/2022,1,0,3,4,10,4,7,21,2,0,10,12,4,0,14,18,2,3,4,9
152866,2022,Poland,Argentina,0,4,8,12,8/6/2022,0,0,5,5,14,1,12,27,0,2,4,6,2,0,10,12,7,1,0,8
183851,2022,France,Poland,0,0,0,0,12/6/2022,0,0,0,0,0,0,0,0,0,0,0,0,0,0,0,0,0,0,0,0
183851,2022,Bulgaria,Poland,1,1,4,6,11/6/2022,0,0,2,2,3,2,3,8,0,3,4,7,0,0,2,2,1,0,1,2
183851,2022,Poland,Italy,0,0,0,0,9/6/2022,0,0,0,0,0,0,0,0,0,0,0,0,0,0,0,0,0,0,0,0
183851,2022,Poland,Argentina,0,0,0,0,8/6/2022,0,0,0,0,0,0,0,0,0,0,0,0,0,0,0,0,0,0,0,0
181100,2022,Italy,Poland,1,1,2,4,24/07/2022,0,0,0,0,0,0,0,0,0,0,0,0,0,0,0,0,1,0,0,1
181100,2022,Poland,USA,0,0,1,1,23/07/2022,0,0,1,1,0,0,0,0,0,0,0,0,0,0,0,0,0,1,0,1
181100,2022,Poland,Iran,0,2,6,8,21/07/2022,0,0,0,0,0,0,0,0,0,0,0,0,0,0,0,0,1,0,0,1
181100,2022,Poland,Slovenia,0,0,0,0,10/7/2022,0,0,0,0,0,0,0,0,0,0,0,0,0,0,0,0,0,0,0,0
181100,2022,Poland,Netherlands,0,2,9,11,9/7/2022,0,0,0,0,9,4,1,14,0,3,0,3,0,0,0,0,1,1,0,2
181100,2022,Poland,China,0,1,0,1,7/7/2022,0,0,0,0,0,1,0,1,0,0,0,0,0,0,0,0,0,0,0,0
181100,2022,Iran,Poland,0,1,0,1,5/7/2022,0,0,0,0,0,0,0,0,0,0,0,0,0,0,0,0,0,0,0,0
181100,2022,France,Poland,3,3,16,22,12/6/2022,0,0,4,4,16,7,6,29,3,3,1,7,0,0,0,0,6,3,2,11
181100,2022,Bulgaria,Poland,0,0,0,0,11/6/2022,0,0,0,0,0,0,0,0,0,0,0,0,0,0,0,0,0,0,0,0
181100,2022,Poland,Italy,2,3,12,17,9/6/2022,0,0,0,0,16,5,5,26,1,4,4,9,0,0,2,2,1,2,3,6
181100,2022,Poland,Argentina,0,2,1,3,8/6/2022,0,0,0,0,3,0,0,3,0,0,0,0,0,0,0,0,1,0,0,1
164127,2022,France,Poland,0,0,0,0,12/6/2022,0,0,0,0,0,0,0,0,0,0,0,0,0,0,0,0,0,0,0,0
164127,2022,Bulgaria,Poland,0,0,0,0,11/6/2022,0,0,4,4,0,0,0,0,0,0,0,0,1,0,6,7,8,2,3,13
164127,2022,Poland,Italy,0,0,0,0,9/6/2022,0,0,0,0,0,0,0,0,0,0,0,0,0,0,0,0,0,0,0,0
164127,2022,Poland,Argentina,0,0,0,0,8/6/2022,0,0,0,0,0,0,0,0,0,0,0,0,0,0,0,0,0,0,0,0
164124,2022,USA,Poland,0,0,0,0,26/06/2022,0,0,0,0,0,0,0,0,0,0,0,0,0,0,0,0,0,0,0,0
164124,2022,Poland,Australia,1,0,4,5,25/06/2022,0,0,0,0,2,0,1,3,1,2,1,4,0,0,0,0,0,0,0,0
164124,2022,Poland,Canada,1,0,4,5,23/06/2022,1,0,0,1,4,0,0,4,0,0,0,0,0,0,0,0,0,0,0,0
164124,2022,Brazil,Poland,0,0,0,0,22/06/2022,0,0,0,0,0,0,0,0,0,0,0,0,0,0,0,0,0,0,0,0
164124,2022,France,Poland,1,1,12,14,12/6/2022,0,0,3,3,2,0,1,3,0,2,3,5,0,0,0,0,1,1,1,3
164124,2022,Bulgaria,Poland,1,0,12,13,11/6/2022,0,0,0,0,4,1,0,5,1,4,4,9,1,0,0,1,1,1,1,3
164124,2022,Poland,Italy,2,3,14,19,9/6/2022,0,0,1,1,4,3,2,9,2,6,3,11,0,0,1,1,5,0,2,7
164124,2022,Poland,Argentina,0,0,0,0,8/6/2022,0,0,0,0,0,0,0,0,0,0,0,0,0,0,0,0,0,0,0,0
153387,2022,Poland,Slovenia,0,0,0,0,10/7/2022,5,0,4,9,0,0,0,0,0,0,0,0,0,0,0,0,0,0,0,0
153387,2022,Poland,Netherlands,0,0,0,0,9/7/2022,1,0,0,1,0,0,0,0,0,0,0,0,0,0,0,0,0,0,0,0
153387,2022,Poland,China,0,0,6,6,7/7/2022,17,0,33,50,1,0,0,1,1,1,0,2,0,0,1,1,0,1,0,1
153387,2022,Iran,Poland,0,0,2,2,5/7/2022,3,1,26,30,0,0,0,0,0,0,0,0,0,0,0,0,1,2,0,3
153387,2022,France,Poland,0,1,13,14,12/6/2022,25,0,55,80,0,0,1,1,0,3,3,6,0,1,0,1,5,7,4,16
153387,2022,Bulgaria,Poland,0,0,0,0,11/6/2022,0,0,0,0,0,0,0,0,0,0,0,0,0,0,0,0,0,0,0,0
153387,2022,Poland,Italy,0,4,8,12,9/6/2022,43,1,36,80,0,0,2,2,0,5,1,6,0,0,0,0,6,1,1,8
153387,2022,Poland,Argentina,1,0,11,12,8/6/2022,26,0,40,66,2,0,0,2,1,2,3,6,0,1,1,2,9,4,0,13
152869,2022,,,-,-,-,-,-,-,-,-,-,-,-,-,-,-,-,-,-,-,-,-,-,-,-,-,-
181313,2022,Germany,Serbia,0,0,0,0,11/6/2022,0,0,0,0,0,0,0,0,0,0,0,0,0,0,0,0,0,0,0,0
181313,2022,Serbia,Argentina,0,0,0,0,10/6/2022,0,0,0,0,0,0,1,1,0,1,0,1,0,0,0,0,0,0,0,0
181313,2022,Serbia,France,0,2,11,13,9/6/2022,2,0,0,2,2,0,1,3,1,2,3,6,0,0,3,3,1,2,1,4
181313,2022,Bulgaria,Serbia,0,0,0,0,7/6/2022,0,0,0,0,0,0,0,0,0,0,0,0,0,0,0,0,0,0,0,0
120250,2022,China,Serbia,0,0,0,0,10/7/2022,0,0,0,0,0,0,0,0,0,0,0,0,0,0,0,0,0,0,0,0
120250,2022,Iran,Serbia,0,0,0,0,9/7/2022,0,0,0,0,0,0,0,0,0,0,0,0,0,0,0,0,0,0,0,0
120250,2022,Italy,Serbia,0,2,5,7,8/7/2022,0,0,1,1,7,4,8,19,1,0,0,1,2,2,21,25,0,0,1,1
120250,2022,Slovenia,Serbia,0,0,0,0,6/7/2022,0,0,0,0,0,0,0,0,0,0,0,0,0,0,0,0,0,0,0,0
120250,2022,Serbia,Australia,0,0,0,0,26/06/2022,0,0,0,0,0,0,0,0,0,0,0,0,0,0,0,0,0,0,0,0
120250,2022,Serbia,Canada,0,0,0,0,24/06/2022,0,0,0,0,0,0,0,0,0,0,0,0,0,0,0,0,0,1,0,1
120250,2022,Serbia,Brazil,0,0,0,0,23/06/2022,0,0,0,0,0,0,0,0,0,0,0,0,0,0,0,0,0,0,0,0
120250,2022,Serbia,USA,0,0,0,0,22/06/2022,0,0,0,0,0,0,0,0,0,0,0,0,0,0,0,0,0,0,0,0
132458,2022,China,Serbia,0,0,0,0,10/7/2022,0,0,0,0,0,0,0,0,0,0,0,0,0,0,0,0,0,0,0,0
132458,2022,Iran,Serbia,0,0,0,0,9/7/2022,0,0,0,0,0,0,0,0,0,0,0,0,0,1,0,1,0,0,0,0
132458,2022,Italy,Serbia,0,0,0,0,8/7/2022,0,0,0,0,0,0,0,0,0,0,0,0,0,0,0,0,0,0,0,0
132458,2022,Slovenia,Serbia,0,1,1,2,6/7/2022,0,0,1,1,1,1,3,5,0,1,0,1,1,1,0,2,0,0,0,0
132458,2022,Serbia,Australia,0,0,0,0,26/06/2022,0,0,1,1,0,0,0,0,0,0,0,0,1,0,2,3,1,0,0,1
132458,2022,Serbia,Canada,0,2,10,12,24/06/2022,0,0,0,0,6,2,4,12,0,1,1,2,2,2,6,10,2,2,0,4
132458,2022,Serbia,Brazil,0,1,9,10,23/06/2022,0,0,1,1,6,2,9,17,1,1,2,4,7,1,9,17,0,2,0,2
132458,2022,Serbia,USA,0,0,4,4,22/06/2022,0,0,0,0,2,0,1,3,1,0,0,1,1,0,5,6,0,0,0,0
132458,2022,Germany,Serbia,0,0,0,0,11/6/2022,0,0,1,1,1,0,0,1,0,0,1,1,0,0,6,6,0,0,0,0
132458,2022,Serbia,Argentina,1,0,4,5,10/6/2022,0,0,3,3,0,0,2,2,0,0,1,1,1,0,4,5,0,1,0,1
132458,2022,Serbia,France,0,0,0,0,9/6/2022,0,0,1,1,0,0,1,1,0,0,2,2,1,0,2,3,0,0,0,0
132458,2022,Bulgaria,Serbia,0,0,6,6,7/6/2022,0,0,4,4,7,0,4,11,0,2,0,2,1,0,7,8,1,2,1,4
150383,2022,China,Serbia,0,0,0,0,10/7/2022,0,0,3,3,0,0,0,0,0,0,0,0,6,0,10,16,7,4,0,11
150383,2022,Iran,Serbia,0,0,0,0,9/7/2022,0,0,0,0,0,0,0,0,0,0,0,0,0,0,0,0,1,0,0,1
150383,2022,Italy,Serbia,0,0,0,0,8/7/2022,0,0,0,0,0,0,0,0,0,0,0,0,0,0,0,0,1,0,0,1
150383,2022,Slovenia,Serbia,0,0,0,0,6/7/2022,0,0,1,1,0,0,0,0,0,0,0,0,2,1,13,16,4,2,0,6
150383,2022,Serbia,Australia,0,0,0,0,26/06/2022,0,0,0,0,0,0,0,0,0,0,0,0,0,0,0,0,0,0,0,0
150383,2022,Serbia,Canada,0,0,0,0,24/06/2022,0,1,2,3,0,0,0,0,0,0,0,0,5,0,15,20,8,3,0,11
150383,2022,Serbia,Brazil,0,0,0,0,23/06/2022,0,0,0,0,0,0,0,0,0,0,0,0,0,0,0,0,2,0,1,3
150383,2022,Serbia,USA,0,0,0,0,22/06/2022,0,0,0,0,0,0,0,0,0,0,0,0,1,0,17,18,4,1,2,7
150383,2022,Germany,Serbia,0,0,0,0,11/6/2022,0,0,2,2,0,0,0,0,0,0,0,0,0,0,0,0,9,1,2,12
150383,2022,Serbia,Argentina,0,0,0,0,10/6/2022,0,0,5,5,0,0,0,0,0,0,0,0,5,2,13,20,6,3,4,13
150383,2022,Serbia,France,0,0,0,0,9/6/2022,1,0,9,10,0,0,0,0,0,0,0,0,1,4,16,21,14,4,4,22
150383,2022,Bulgaria,Serbia,0,0,0,0,7/6/2022,0,0,3,3,0,0,0,0,0,0,0,0,0,0,0,0,1,12,5,18
146579,2022,China,Serbia,0,1,12,13,10/7/2022,0,1,2,3,5,2,1,8,1,8,0,9,0,0,1,1,3,0,1,4
146579,2022,Iran,Serbia,0,0,1,1,9/7/2022,0,0,0,0,0,0,0,0,0,0,0,0,0,0,0,0,0,0,0,0
146579,2022,Italy,Serbia,0,0,5,5,8/7/2022,0,0,0,0,0,1,3,4,0,0,0,0,0,0,2,2,0,1,0,1
146579,2022,Slovenia,Serbia,0,0,1,1,6/7/2022,0,0,0,0,0,0,0,0,0,0,0,0,0,0,0,0,0,1,0,1
146579,2022,Serbia,Australia,0,0,0,0,26/06/2022,0,0,0,0,0,0,0,0,0,0,0,0,0,0,0,0,0,0,0,0
146579,2022,Serbia,Canada,0,0,2,2,24/06/2022,0,0,0,0,0,0,0,0,0,0,0,0,0,0,0,0,0,0,0,0
146579,2022,Serbia,Brazil,0,3,5,8,23/06/2022,0,0,0,0,4,0,2,6,0,4,5,9,0,0,1,1,1,0,0,1
146579,2022,Serbia,USA,0,1,3,4,22/06/2022,0,0,1,1,0,0,0,0,0,0,0,0,0,0,0,0,0,1,0,1
132022,2022,,,-,-,-,-,-,-,-,-,-,-,-,-,-,-,-,-,-,-,-,-,-,-,-,-,-
124911,2022,China,Serbia,0,0,0,0,10/7/2022,0,0,0,0,0,0,0,0,0,0,0,0,0,0,0,0,0,0,0,0
124911,2022,Iran,Serbia,0,0,10,10,9/7/2022,14,0,64,78,0,0,0,0,0,0,1,1,0,0,1,1,2,1,1,4
124911,2022,Italy,Serbia,0,0,7,7,8/7/2022,14,0,71,85,0,0,0,0,0,1,0,1,0,0,0,0,0,1,0,1
124911,2022,Slovenia,Serbia,0,1,7,8,6/7/2022,15,2,59,76,0,0,1,1,0,1,0,1,0,0,0,0,2,0,0,2
124911,2022,Serbia,Australia,0,0,10,10,26/06/2022,25,0,47,72,2,0,0,2,0,2,1,3,0,0,0,0,3,1,0,4
124911,2022,Serbia,Canada,0,1,11,12,24/06/2022,31,0,56,87,1,0,0,1,0,2,1,3,0,0,0,0,2,3,0,5
124911,2022,Serbia,Brazil,0,0,0,0,23/06/2022,0,0,0,0,0,0,0,0,0,0,0,0,0,0,0,0,0,0,0,0
124911,2022,Serbia,USA,0,1,8,9,22/06/2022,23,0,56,79,0,0,0,0,0,2,1,3,0,1,0,1,2,3,0,5
124911,2022,Germany,Serbia,0,0,13,13,11/6/2022,13,0,99,112,4,1,0,5,1,3,3,7,0,1,0,1,4,3,4,11
124911,2022,Serbia,Argentina,1,0,13,14,10/6/2022,36,0,35,71,0,0,1,1,2,3,7,12,0,0,0,0,3,3,3,9
124911,2022,Serbia,France,0,0,0,0,9/6/2022,0,0,0,0,0,0,0,0,0,0,0,0,0,0,0,0,0,0,0,0
124911,2022,Bulgaria,Serbia,0,0,14,14,7/6/2022,32,0,56,88,0,0,1,1,0,2,4,6,0,0,0,0,0,3,6,9
162122,2022,China,Serbia,1,2,18,21,10/7/2022,0,0,0,0,9,2,2,13,0,3,0,3,1,0,13,14,5,0,1,6
162122,2022,Iran,Serbia,1,2,8,11,9/7/2022,0,0,2,2,7,4,6,17,1,0,0,1,1,0,28,29,2,0,0,2
162122,2022,Italy,Serbia,0,2,3,5,8/7/2022,0,0,1,1,3,7,5,15,1,0,0,1,0,1,7,8,1,0,0,1
162122,2022,Slovenia,Serbia,0,2,5,7,6/7/2022,0,0,0,0,4,3,5,12,0,0,0,0,0,2,11,13,3,1,0,4
162122,2022,Serbia,Australia,0,3,10,13,26/06/2022,0,0,0,0,13,2,2,17,0,1,0,1,4,0,7,11,0,1,0,1
162122,2022,Serbia,Canada,2,5,10,17,24/06/2022,0,0,1,1,12,4,5,21,1,2,1,4,7,4,32,43,2,2,0,4
162122,2022,Serbia,Brazil,0,0,1,1,23/06/2022,0,0,0,0,2,2,0,4,0,2,0,2,0,0,1,1,0,0,0,0
162122,2022,Serbia,USA,1,5,11,17,22/06/2022,0,0,0,0,11,0,7,18,0,3,0,3,9,2,21,32,2,1,2,5
162122,2022,Germany,Serbia,3,6,12,21,11/6/2022,0,0,1,1,13,7,13,33,0,1,0,1,8,3,30,41,9,1,2,12
162122,2022,Serbia,Argentina,1,0,9,10,10/6/2022,0,0,1,1,11,2,7,20,2,3,1,6,4,4,22,30,3,4,1,8
162122,2022,Serbia,France,0,0,0,0,9/6/2022,0,0,0,0,0,0,0,0,0,0,0,0,0,0,0,0,0,0,0,0
162122,2022,Bulgaria,Serbia,6,2,17,25,7/6/2022,0,0,1,1,13,6,6,25,1,1,2,4,2,2,21,25,6,5,5,16
173251,2022,China,Serbia,1,3,13,17,10/7/2022,0,0,2,2,12,2,10,24,2,4,0,6,3,2,25,30,2,2,0,4
173251,2022,Iran,Serbia,0,3,7,10,9/7/2022,0,0,1,1,10,7,9,26,0,3,0,3,0,2,19,21,0,0,0,0
173251,2022,Italy,Serbia,0,1,3,4,8/7/2022,0,0,2,2,4,4,2,10,0,0,0,0,1,0,10,11,0,0,0,0
173251,2022,Slovenia,Serbia,2,1,9,12,6/7/2022,0,0,1,1,7,3,12,22,1,0,0,1,3,0,28,31,0,0,2,2
173251,2022,Serbia,Australia,0,0,10,10,26/06/2022,0,0,0,0,10,2,3,15,1,1,1,3,3,1,21,25,1,1,0,2
173251,2022,Serbia,Canada,0,2,3,5,24/06/2022,0,0,0,0,1,3,2,6,1,0,1,2,0,2,4,6,2,1,0,3
173251,2022,Serbia,Brazil,1,5,3,9,23/06/2022,0,0,2,2,4,2,10,16,1,2,2,5,4,5,13,22,4,0,0,4
173251,2022,Serbia,USA,1,5,5,11,22/06/2022,0,0,1,1,14,3,6,23,1,1,0,2,1,2,18,21,0,1,1,2
173251,2022,Germany,Serbia,3,6,11,20,11/6/2022,0,0,7,7,18,4,14,36,1,0,4,5,1,3,17,21,5,1,3,9
173251,2022,Serbia,Argentina,1,2,9,12,10/6/2022,0,1,0,1,9,5,7,21,2,4,2,8,0,2,14,16,6,5,1,12
173251,2022,Serbia,France,1,3,13,17,9/6/2022,0,1,2,3,19,3,14,36,1,2,5,8,2,2,14,18,10,3,1,14
173251,2022,Bulgaria,Serbia,0,0,1,1,7/6/2022,0,0,0,0,1,1,0,2,0,0,0,0,0,0,2,2,0,0,0,0
124915,2022,China,Serbia,0,0,0,0,10/7/2022,0,0,0,0,0,0,0,0,0,0,0,0,0,0,0,0,0,0,0,0
124915,2022,Iran,Serbia,0,2,11,13,9/7/2022,0,0,1,1,14,5,7,26,0,0,0,0,0,0,0,0,2,1,0,3
124915,2022,Italy,Serbia,2,3,5,10,8/7/2022,0,0,0,0,12,8,11,31,0,1,0,1,0,0,0,0,1,1,2,4
124915,2022,Slovenia,Serbia,0,5,6,11,6/7/2022,0,0,0,0,11,4,9,24,0,2,0,2,0,0,0,0,0,2,0,2
124915,2022,Serbia,Australia,0,4,10,14,26/06/2022,0,0,0,0,14,5,7,26,1,2,4,7,0,0,1,1,3,2,1,6
124915,2022,Serbia,Canada,1,6,15,22,24/06/2022,0,0,3,3,21,6,9,36,0,2,3,5,0,0,0,0,1,4,2,7
124915,2022,Serbia,Brazil,0,0,0,0,23/06/2022,0,0,0,0,0,0,0,0,0,0,0,0,0,0,0,0,0,0,0,0
124915,2022,Serbia,USA,3,4,9,16,22/06/2022,0,0,0,0,17,5,4,26,0,3,0,3,0,0,1,1,0,2,0,2
150382,2022,China,Serbia,0,0,11,11,10/7/2022,0,0,0,0,5,1,6,12,3,3,2,8,0,0,0,0,1,0,0,1
150382,2022,Iran,Serbia,0,0,0,0,9/7/2022,0,0,1,1,0,0,0,0,0,0,0,0,0,0,0,0,0,0,0,0
150382,2022,Italy,Serbia,0,0,8,8,8/7/2022,0,0,0,0,5,1,3,9,0,3,0,3,0,0,0,0,1,2,0,3
150382,2022,Slovenia,Serbia,0,0,0,0,6/7/2022,0,0,0,0,0,0,0,0,0,0,0,0,0,0,0,0,0,0,0,0
150382,2022,Serbia,Australia,0,0,0,0,26/06/2022,0,0,0,0,0,0,0,0,0,0,0,0,0,0,0,0,0,0,0,0
150382,2022,Serbia,Canada,0,1,7,8,24/06/2022,0,0,0,0,3,2,2,7,0,4,1,5,0,0,1,1,0,0,1,1
150382,2022,Serbia,Brazil,1,0,11,12,23/06/2022,0,0,0,0,4,0,3,7,0,2,1,3,0,0,1,1,1,0,1,2
150382,2022,Serbia,USA,0,0,1,1,22/06/2022,1,0,0,1,0,0,1,1,0,1,1,2,0,0,0,0,0,0,0,0
150382,2022,Germany,Serbia,0,0,16,16,11/6/2022,0,0,3,3,9,0,6,15,4,8,13,25,0,0,1,1,5,1,2,8
150382,2022,Serbia,Argentina,0,1,21,22,10/6/2022,0,0,2,2,9,0,3,12,2,4,10,16,0,0,1,1,0,0,1,1
150382,2022,Serbia,France,0,0,10,10,9/6/2022,0,0,2,2,9,1,2,12,2,4,8,14,0,0,0,0,3,1,1,5
150382,2022,Bulgaria,Serbia,1,1,11,13,7/6/2022,0,0,0,0,8,0,3,11,0,6,4,10,0,0,1,1,1,2,1,4
116525,2022,China,Serbia,0,0,0,0,10/7/2022,0,0,0,0,0,0,0,0,0,0,0,0,0,0,0,0,0,0,0,0
116525,2022,Iran,Serbia,0,1,9,10,9/7/2022,0,0,0,0,4,1,2,7,4,4,1,9,0,0,1,1,0,1,0,1
116525,2022,Italy,Serbia,0,0,0,0,8/7/2022,0,0,0,0,0,0,0,0,0,0,0,0,0,0,0,0,0,0,0,0
116525,2022,Slovenia,Serbia,0,1,5,6,6/7/2022,1,0,0,1,4,0,1,5,2,5,0,7,0,0,0,0,0,1,0,1
116525,2022,Serbia,Australia,1,1,13,15,26/06/2022,0,0,0,0,4,0,3,7,1,5,2,8,0,0,0,0,3,0,0,3
116525,2022,Serbia,Canada,0,1,6,7,24/06/2022,0,0,0,0,2,0,0,2,1,2,0,3,0,0,0,0,1,0,0,1
116525,2022,Serbia,Brazil,0,0,0,0,23/06/2022,0,0,0,0,0,0,0,0,0,0,0,0,0,0,0,0,0,0,0,0
116525,2022,Serbia,USA,1,2,11,14,22/06/2022,0,0,1,1,4,2,5,11,0,4,1,5,0,0,1,1,2,0,0,2
136362,2022,China,Serbia,0,0,1,1,10/7/2022,0,0,0,0,0,0,0,0,0,0,0,0,0,0,0,0,0,0,0,0
136362,2022,Iran,Serbia,0,1,10,11,9/7/2022,0,0,0,0,4,1,0,5,1,3,0,4,0,0,1,1,1,0,0,1
136362,2022,Italy,Serbia,0,0,12,12,8/7/2022,0,0,0,0,3,0,1,4,1,0,0,1,0,0,1,1,0,0,1,1
136362,2022,Slovenia,Serbia,0,5,7,12,6/7/2022,0,0,1,1,9,1,2,12,0,3,0,3,0,0,0,0,0,0,0,0
136362,2022,Serbia,Australia,1,2,8,11,26/06/2022,1,0,0,1,8,1,3,12,2,5,1,8,0,0,0,0,2,0,1,3
136362,2022,Serbia,Canada,0,3,14,17,24/06/2022,0,0,0,0,12,1,3,16,3,7,1,11,0,0,0,0,0,0,0,0
136362,2022,Serbia,Brazil,0,0,0,0,23/06/2022,0,0,0,0,0,0,0,0,0,0,0,0,0,0,0,0,0,0,0,0
136362,2022,Serbia,USA,0,2,7,9,22/06/2022,0,0,0,0,4,0,3,7,1,6,4,11,0,0,1,1,0,0,0,0
173250,2022,China,Serbia,0,1,14,15,10/7/2022,20,0,63,83,1,0,0,1,0,3,0,3,0,0,0,0,1,0,1,2
173250,2022,Iran,Serbia,0,0,0,0,9/7/2022,0,0,0,0,0,0,0,0,0,0,0,0,0,0,0,0,0,0,0,0
173250,2022,Italy,Serbia,0,0,1,1,8/7/2022,0,0,4,4,0,0,0,0,0,0,0,0,0,0,0,0,0,0,0,0
173250,2022,Slovenia,Serbia,0,0,0,0,6/7/2022,0,0,4,4,0,0,0,0,0,0,0,0,0,0,0,0,0,0,0,0
173250,2022,Germany,Serbia,0,0,0,0,11/6/2022,0,0,0,0,0,0,0,0,0,0,0,0,0,0,0,0,0,0,0,0
173250,2022,Serbia,Argentina,0,0,1,1,10/6/2022,5,0,4,9,0,0,0,0,0,0,1,1,0,0,0,0,2,0,0,2
173250,2022,Serbia,France,0,1,13,14,9/6/2022,22,0,64,86,0,0,0,0,0,1,3,4,0,1,3,4,5,2,4,11
173250,2022,Bulgaria,Serbia,0,0,0,0,7/6/2022,0,0,0,0,0,0,0,0,0,0,0,0,0,0,0,0,0,0,0,0
168275,2022,,,-,-,-,-,-,-,-,-,-,-,-,-,-,-,-,-,-,-,-,-,-,-,-,-,-
168276,2022,China,Serbia,4,4,11,19,10/7/2022,0,1,0,1,12,6,12,30,2,1,0,3,0,0,0,0,2,0,1,3
168276,2022,Iran,Serbia,0,0,1,1,9/7/2022,0,0,0,0,1,3,1,5,0,1,0,1,0,1,0,1,0,0,0,0
168276,2022,Italy,Serbia,0,0,0,0,8/7/2022,0,0,0,0,0,0,0,0,0,0,0,0,0,0,0,0,0,0,0,0
168276,2022,Slovenia,Serbia,0,0,0,0,6/7/2022,0,0,0,0,0,2,1,3,0,0,0,0,0,0,0,0,0,0,0,0
173252,2022,,,-,-,-,-,-,-,-,-,-,-,-,-,-,-,-,-,-,-,-,-,-,-,-,-,-
189274,2022,Germany,Serbia,0,0,0,0,11/6/2022,0,0,0,0,0,0,0,0,0,0,0,0,0,0,0,0,0,0,0,0
189274,2022,Serbia,Argentina,0,0,1,1,10/6/2022,0,1,1,2,0,0,0,0,0,0,0,0,0,0,0,0,0,0,0,0
189274,2022,Serbia,France,0,4,10,14,9/6/2022,1,0,3,4,8,7,6,21,1,1,6,8,5,3,19,27,6,1,1,8
189274,2022,Bulgaria,Serbia,0,3,2,5,7/6/2022,0,0,2,2,3,4,3,10,0,2,3,5,1,0,9,10,1,1,0,2
164985,2022,Germany,Serbia,0,0,24,24,11/6/2022,0,1,1,2,6,2,3,11,2,12,8,22,0,0,0,0,5,2,0,7
164985,2022,Serbia,Argentina,2,1,14,17,10/6/2022,0,0,0,0,6,3,2,11,2,5,8,15,0,0,0,0,0,0,0,0
164985,2022,Serbia,France,0,0,2,2,9/6/2022,0,0,0,0,1,0,0,1,0,1,0,1,0,0,0,0,0,2,0,2
164985,2022,Bulgaria,Serbia,1,0,16,17,7/6/2022,0,1,0,1,5,1,4,10,3,3,4,10,0,0,1,1,2,4,0,6
124920,2022,China,Serbia,0,0,0,0,10/7/2022,0,0,0,0,0,0,0,0,0,0,0,0,0,0,0,0,0,0,0,0
124920,2022,Iran,Serbia,0,0,0,0,9/7/2022,0,0,4,4,0,0,0,0,0,0,0,0,1,3,13,17,4,3,0,7
124920,2022,Italy,Serbia,0,0,0,0,8/7/2022,0,0,1,1,0,0,0,0,0,0,0,0,0,3,14,17,2,1,0,3
124920,2022,Slovenia,Serbia,0,0,0,0,6/7/2022,0,0,0,0,0,0,0,0,0,0,0,0,0,0,0,0,0,0,0,0
124920,2022,Serbia,Australia,0,0,0,0,26/06/2022,0,0,1,1,0,0,0,0,0,0,0,0,3,0,5,8,5,3,0,8
124920,2022,Serbia,Canada,0,0,0,0,24/06/2022,0,0,0,0,0,0,0,0,0,0,0,0,0,0,0,0,0,0,0,0
124920,2022,Serbia,Brazil,0,0,0,0,23/06/2022,0,0,3,3,0,0,0,0,0,0,0,0,6,1,12,19,1,2,0,3
124920,2022,Serbia,USA,0,0,0,0,22/06/2022,0,0,0,0,0,0,0,0,0,0,0,0,0,0,0,0,0,0,0,0
124920,2022,Germany,Serbia,0,0,0,0,11/6/2022,0,1,3,4,0,0,0,0,0,0,0,0,6,2,18,26,8,0,0,8
124920,2022,Serbia,Argentina,0,0,0,0,10/6/2022,0,0,0,0,0,0,0,0,0,0,0,0,0,0,0,0,0,0,0,0
124920,2022,Serbia,France,0,0,0,0,9/6/2022,0,0,0,0,0,0,0,0,0,0,0,0,0,0,0,0,0,0,0,0
124920,2022,Bulgaria,Serbia,0,0,0,0,7/6/2022,0,0,3,3,0,0,0,0,0,0,0,0,6,1,20,27,3,1,1,5
189272,2022,Serbia,Australia,0,0,0,0,26/06/2022,0,0,0,0,0,0,0,0,0,0,0,0,0,0,0,0,0,0,0,0
189272,2022,Serbia,Canada,0,0,0,0,24/06/2022,0,0,0,0,0,0,0,0,0,0,0,0,0,0,0,0,0,0,0,0
189272,2022,Serbia,Brazil,1,5,5,11,23/06/2022,0,0,1,1,13,8,5,26,0,1,1,2,0,0,0,0,3,1,1,5
189272,2022,Serbia,USA,0,1,5,6,22/06/2022,0,0,0,0,4,3,0,7,0,0,0,0,0,0,0,0,1,0,0,1
189272,2022,Germany,Serbia,0,0,0,0,11/6/2022,0,0,0,0,0,0,0,0,0,0,0,0,0,0,0,0,0,0,0,0
189272,2022,Serbia,Argentina,0,1,1,2,10/6/2022,0,0,0,0,3,1,0,4,0,0,0,0,0,0,0,0,0,1,0,1
189272,2022,Serbia,France,1,6,9,16,9/6/2022,0,0,3,3,18,6,14,38,1,4,2,7,0,0,0,0,1,3,4,8
189272,2022,Bulgaria,Serbia,0,0,1,1,7/6/2022,0,0,0,0,4,0,0,4,0,0,0,0,0,0,0,0,0,1,0,1
124912,2022,Germany,Serbia,4,5,16,25,11/6/2022,0,0,6,6,20,11,9,40,1,4,5,10,0,0,0,0,7,4,2,13
124912,2022,Serbia,Argentina,0,3,6,9,10/6/2022,0,0,0,0,9,5,10,24,1,0,4,5,0,0,0,0,4,2,1,7
124912,2022,Serbia,France,1,1,3,5,9/6/2022,0,0,0,0,0,0,0,0,0,0,0,0,0,0,0,0,0,1,0,1
124912,2022,Bulgaria,Serbia,0,2,9,11,7/6/2022,0,1,2,3,13,9,9,31,0,1,1,2,0,0,0,0,4,2,5,11
189276,2022,Germany,Serbia,0,1,0,1,11/6/2022,0,0,0,0,0,0,0,0,0,0,0,0,0,0,0,0,0,0,0,0
189276,2022,Serbia,Argentina,0,0,0,0,10/6/2022,0,0,0,0,0,0,0,0,0,0,0,0,0,0,0,0,0,0,0,0
189276,2022,Serbia,France,0,0,3,3,9/6/2022,0,0,0,0,0,0,0,0,0,0,0,0,0,0,0,0,0,2,0,2
189276,2022,Bulgaria,Serbia,0,0,0,0,7/6/2022,0,0,0,0,0,0,0,0,0,0,0,0,0,0,0,0,0,0,0,0
166724,2022,Serbia,Australia,0,0,0,0,26/06/2022,0,0,0,0,0,0,0,0,0,0,0,0,0,0,0,0,0,0,0,0
166724,2022,Serbia,Canada,0,0,2,2,24/06/2022,0,0,6,6,0,0,0,0,0,0,0,0,0,0,0,0,1,0,0,1
166724,2022,Serbia,Brazil,0,0,9,9,23/06/2022,13,3,57,73,0,0,2,2,1,0,1,2,0,1,0,1,0,3,0,3
166724,2022,Serbia,USA,0,1,1,2,22/06/2022,1,0,13,14,1,0,0,1,0,0,0,0,0,0,0,0,0,2,2,4
189278,2022,,,-,-,-,-,-,-,-,-,-,-,-,-,-,-,-,-,-,-,-,-,-,-,-,-,-
151390,2022,Poland,Slovenia,3,5,7,15,10/7/2022,0,0,2,2,15,5,4,24,2,6,0,8,0,0,1,1,3,0,2,5
151390,2022,Slovenia,Iran,1,3,7,11,8/7/2022,0,0,0,0,5,3,4,12,1,3,0,4,0,0,1,1,2,2,0,4
151390,2022,Bulgaria,Slovenia,3,3,16,22,7/7/2022,0,0,0,0,14,10,8,32,1,0,0,1,0,0,0,0,2,0,1,3
151390,2022,Slovenia,Serbia,1,2,12,15,6/7/2022,0,0,1,1,8,4,6,18,1,0,0,1,0,0,0,0,1,0,0,1
151390,2022,Japan,Slovenia,1,4,10,15,26/06/2022,0,0,2,2,14,9,3,26,1,6,3,10,0,0,0,0,3,2,0,5
151390,2022,Italy,Slovenia,0,0,4,4,25/06/2022,0,0,0,0,1,0,0,1,0,0,1,1,0,0,0,0,1,0,0,1
151390,2022,Slovenia,China,0,0,2,2,11/6/2022,0,0,0,0,4,1,3,8,0,1,2,3,0,0,0,0,1,0,0,1
151390,2022,Australia,Slovenia,1,4,6,11,11/6/2022,0,0,0,0,9,5,5,19,0,4,1,5,0,0,0,0,2,1,1,4
151390,2022,Brazil,Slovenia,0,1,0,1,10/6/2022,0,0,0,0,1,1,2,4,1,1,0,2,0,0,0,0,0,0,0,0
151390,2022,Slovenia,USA,1,3,4,8,8/6/2022,0,0,2,2,7,6,9,22,0,2,2,4,0,0,0,0,4,2,0,6
114962,2022,Poland,Slovenia,1,3,10,14,10/7/2022,0,0,0,0,6,1,3,10,2,2,0,4,0,0,1,1,1,0,1,2
114962,2022,Slovenia,Iran,0,2,2,4,8/7/2022,0,0,0,0,1,1,1,3,0,1,0,1,0,0,0,0,0,0,0,0
114962,2022,Bulgaria,Slovenia,0,3,12,15,7/7/2022,0,0,0,0,6,0,2,8,3,0,1,4,0,0,1,1,1,2,0,3
114962,2022,Slovenia,Serbia,0,3,9,12,6/7/2022,0,0,0,0,6,1,1,8,1,3,0,4,0,0,0,0,1,0,0,1
114962,2022,Japan,Slovenia,0,6,4,10,26/06/2022,1,0,0,1,6,1,3,10,2,3,6,11,0,0,0,0,2,0,0,2
114962,2022,Italy,Slovenia,0,0,0,0,25/06/2022,0,0,0,0,0,0,0,0,0,0,0,0,0,0,0,0,0,0,0,0
114962,2022,Argentina,Slovenia,0,2,11,13,23/06/2022,1,0,1,2,6,2,5,13,0,2,6,8,0,0,0,0,2,1,0,3
114962,2022,Slovenia,Netherlands,1,2,8,11,21/06/2022,0,0,1,1,5,1,5,11,0,3,5,8,0,0,1,1,2,0,0,2
114962,2022,Slovenia,China,0,1,3,4,11/6/2022,1,0,0,1,5,0,0,5,1,1,2,4,0,0,1,1,1,1,1,3
114962,2022,Australia,Slovenia,0,0,0,0,11/6/2022,0,0,0,0,0,0,0,0,0,0,0,0,0,0,0,0,0,0,0,0
114962,2022,Brazil,Slovenia,0,4,6,10,10/6/2022,1,1,0,2,9,0,4,13,2,3,3,8,0,0,0,0,1,0,0,1
114962,2022,Slovenia,USA,2,2,7,11,8/6/2022,0,0,1,1,4,2,2,8,1,2,3,6,0,0,0,0,2,0,0,2
168715,2022,Slovenia,China,0,0,1,1,11/6/2022,5,1,15,21,0,0,0,0,0,0,2,2,0,0,0,0,0,0,0,0
168715,2022,Australia,Slovenia,0,0,0,0,11/6/2022,0,0,0,0,0,0,0,0,0,0,0,0,0,0,0,0,0,0,0,0
168715,2022,Brazil,Slovenia,0,0,0,0,10/6/2022,2,0,2,4,0,0,0,0,0,0,0,0,0,0,0,0,1,0,0,1
168715,2022,Slovenia,USA,0,0,0,0,8/6/2022,0,0,1,1,0,0,0,0,0,0,0,0,0,0,0,0,0,0,0,0
151391,2022,Poland,Slovenia,1,3,8,12,10/7/2022,0,0,0,0,4,0,1,5,1,2,0,3,0,0,1,1,2,0,0,2
151391,2022,Slovenia,Iran,0,1,10,11,8/7/2022,0,0,1,1,5,0,2,7,2,1,2,5,0,0,0,0,1,0,0,1
151391,2022,Bulgaria,Slovenia,0,0,19,19,7/7/2022,0,0,0,0,5,0,0,5,3,2,0,5,0,0,1,1,1,0,0,1
151391,2022,Slovenia,Serbia,0,1,9,10,6/7/2022,0,0,0,0,2,0,3,5,2,2,0,4,0,0,1,1,0,1,0,1
151391,2022,Japan,Slovenia,0,1,20,21,26/06/2022,0,0,1,1,5,0,4,9,3,5,3,11,0,0,0,0,6,1,0,7
151391,2022,Italy,Slovenia,0,2,7,9,25/06/2022,0,0,1,1,3,2,3,8,0,3,3,6,0,0,2,2,0,1,0,1
151391,2022,Argentina,Slovenia,1,2,14,17,23/06/2022,0,0,0,0,5,1,2,8,3,7,8,18,0,0,0,0,4,1,2,7
151391,2022,Slovenia,Netherlands,0,2,7,9,21/06/2022,0,0,1,1,2,2,3,7,4,4,4,12,0,0,1,1,2,0,1,3
151391,2022,Slovenia,China,0,1,3,4,11/6/2022,0,0,0,0,2,0,0,2,1,2,0,3,0,0,0,0,0,0,0,0
151391,2022,Australia,Slovenia,1,1,6,8,11/6/2022,0,0,1,1,2,0,1,3,3,2,1,6,0,0,0,0,1,0,0,1
151391,2022,Brazil,Slovenia,1,2,12,15,10/6/2022,0,0,0,0,6,0,2,8,0,4,4,8,1,0,0,1,4,0,1,5
151391,2022,Slovenia,USA,0,2,5,7,8/6/2022,0,0,0,0,4,2,0,6,0,2,5,7,0,0,1,1,1,0,0,1
119022,2022,,,-,-,-,-,-,-,-,-,-,-,-,-,-,-,-,-,-,-,-,-,-,-,-,-,-
114952,2022,Poland,Slovenia,0,1,0,1,10/7/2022,0,0,0,0,0,0,0,0,0,0,0,0,0,0,0,0,0,0,0,0
114952,2022,Slovenia,Iran,0,0,0,0,8/7/2022,0,0,0,0,1,0,0,1,0,0,0,0,0,0,0,0,0,0,0,0
114952,2022,Bulgaria,Slovenia,0,0,0,0,7/7/2022,0,0,0,0,0,0,0,0,0,0,0,0,0,0,0,0,0,0,0,0
114952,2022,Slovenia,Serbia,0,0,0,0,6/7/2022,0,0,0,0,0,0,0,0,0,0,0,0,0,0,0,0,0,0,0,0
114952,2022,Slovenia,China,0,3,13,16,11/6/2022,0,1,0,1,12,4,4,20,1,2,2,5,0,0,0,0,3,3,1,7
114952,2022,Australia,Slovenia,0,0,0,0,11/6/2022,0,0,0,0,0,0,0,0,0,0,0,0,0,0,0,0,0,0,0,0
114952,2022,Brazil,Slovenia,3,4,16,23,10/6/2022,1,0,2,3,7,4,9,20,1,2,0,3,0,0,0,0,3,0,0,3
114952,2022,Slovenia,USA,0,0,0,0,8/6/2022,0,0,0,0,0,0,0,0,0,0,0,0,0,0,0,0,0,0,0,0
153301,2022,Poland,Slovenia,0,0,0,0,10/7/2022,0,0,0,0,0,0,0,0,0,0,0,0,0,0,0,0,0,0,0,0
153301,2022,Slovenia,Iran,0,0,0,0,8/7/2022,0,0,0,0,0,0,0,0,0,0,0,0,0,0,0,0,0,0,0,0
153301,2022,Bulgaria,Slovenia,0,0,0,0,7/7/2022,0,0,0,0,0,0,0,0,0,0,0,0,0,0,0,0,0,0,0,0
153301,2022,Slovenia,Serbia,0,0,0,0,6/7/2022,0,0,0,0,0,0,0,0,0,0,0,0,0,0,0,0,0,0,0,0
153301,2022,Japan,Slovenia,0,0,0,0,26/06/2022,0,0,0,0,0,0,0,0,0,0,0,0,0,0,0,0,0,0,0,0
153301,2022,Italy,Slovenia,0,0,0,0,25/06/2022,0,0,1,1,0,0,0,0,0,0,0,0,3,1,14,18,2,9,0,11
153301,2022,Argentina,Slovenia,0,0,0,0,23/06/2022,1,0,4,5,0,0,0,0,0,0,0,0,9,3,22,34,9,3,3,15
153301,2022,Slovenia,Netherlands,0,0,0,0,21/06/2022,0,0,2,2,0,0,0,0,0,0,0,0,2,3,12,17,10,4,0,14
153301,2022,Slovenia,China,0,0,0,0,11/6/2022,0,0,0,0,0,0,0,0,0,0,0,0,0,0,0,0,0,0,0,0
153301,2022,Australia,Slovenia,0,0,0,0,11/6/2022,1,0,1,2,0,0,0,0,0,0,0,0,3,1,14,18,3,2,3,8
153301,2022,Brazil,Slovenia,0,0,0,0,10/6/2022,0,0,0,0,0,0,0,0,0,0,0,0,0,0,0,0,0,0,0,0
153301,2022,Slovenia,USA,0,0,0,0,8/6/2022,0,0,0,0,0,0,0,0,0,0,0,0,0,0,0,0,0,0,0,0
154046,2022,Japan,Slovenia,0,0,0,0,26/06/2022,0,0,0,0,0,0,0,0,0,0,0,0,0,0,0,0,0,0,0,0
154046,2022,Italy,Slovenia,0,1,1,2,25/06/2022,0,0,0,0,2,1,0,3,0,0,0,0,0,0,2,2,1,0,0,1
154046,2022,Argentina,Slovenia,0,0,0,0,23/06/2022,0,0,0,0,0,0,0,0,0,0,0,0,0,0,0,0,0,0,0,0
154046,2022,Slovenia,Netherlands,0,0,0,0,21/06/2022,0,0,0,0,0,0,0,0,0,0,0,0,0,0,0,0,0,0,0,0
154046,2022,Slovenia,China,0,0,0,0,11/6/2022,0,0,0,0,0,0,0,0,0,0,0,0,0,0,0,0,0,0,0,0
154046,2022,Australia,Slovenia,0,2,7,9,11/6/2022,0,0,0,0,7,1,4,12,2,1,2,5,2,0,8,10,6,0,1,7
154046,2022,Brazil,Slovenia,0,1,0,1,10/6/2022,0,0,0,0,0,0,0,0,0,0,0,0,0,0,1,1,0,0,0,0
154046,2022,Slovenia,USA,0,0,0,0,8/6/2022,0,0,0,0,0,2,1,3,0,0,0,0,0,0,0,0,0,0,0,0
114956,2022,Poland,Slovenia,1,0,2,3,10/7/2022,1,0,22,23,0,0,1,1,0,1,0,1,0,0,0,0,0,0,0,0
114956,2022,Slovenia,Iran,1,0,8,9,8/7/2022,15,1,42,58,0,0,1,1,1,1,0,2,0,0,1,1,0,2,0,2
114956,2022,Bulgaria,Slovenia,0,0,0,0,7/7/2022,0,0,0,0,0,0,0,0,0,0,0,0,0,0,0,0,0,0,0,0
114956,2022,Slovenia,Serbia,0,1,9,10,6/7/2022,12,0,48,60,2,0,1,3,0,3,0,3,0,0,0,0,0,0,0,0
114956,2022,Japan,Slovenia,0,0,1,1,26/06/2022,0,0,0,0,0,0,0,0,0,0,0,0,0,0,0,0,0,0,0,0
114956,2022,Italy,Slovenia,0,0,7,7,25/06/2022,12,0,49,61,1,0,1,2,0,0,2,2,0,0,0,0,6,1,1,8
114956,2022,Argentina,Slovenia,0,0,1,1,23/06/2022,0,0,0,0,0,0,0,0,0,0,0,0,0,0,0,0,0,0,0,0
114956,2022,Slovenia,Netherlands,0,0,1,1,21/06/2022,1,0,0,1,0,0,0,0,0,0,0,0,0,0,1,1,0,0,0,0
151404,2022,Japan,Slovenia,0,0,0,0,26/06/2022,0,0,0,0,0,0,0,0,0,1,0,1,0,0,0,0,0,0,0,0
151404,2022,Italy,Slovenia,0,0,9,9,25/06/2022,0,0,1,1,1,0,4,5,1,4,5,10,0,0,3,3,2,0,0,2
151404,2022,Argentina,Slovenia,0,0,0,0,23/06/2022,0,0,0,0,0,0,0,0,0,0,0,0,0,0,0,0,0,0,0,0
151404,2022,Slovenia,Netherlands,0,0,0,0,21/06/2022,0,0,0,0,0,0,0,0,0,0,0,0,0,0,0,0,0,0,0,0
144483,2022,Poland,Slovenia,0,0,0,0,10/7/2022,0,0,0,0,0,0,0,0,0,0,0,0,0,0,0,0,0,0,0,0
144483,2022,Slovenia,Iran,0,1,3,4,8/7/2022,0,0,0,0,1,0,3,4,0,3,0,3,0,0,0,0,0,0,1,1
144483,2022,Bulgaria,Slovenia,0,0,0,0,7/7/2022,0,0,0,0,0,0,0,0,0,0,0,0,0,0,0,0,0,0,0,0
144483,2022,Slovenia,Serbia,0,0,0,0,6/7/2022,0,0,0,0,0,0,0,0,0,0,0,0,0,0,0,0,0,0,0,0
144483,2022,Japan,Slovenia,0,0,0,0,26/06/2022,0,0,0,0,0,0,0,0,0,0,1,1,0,0,0,0,0,0,1,1
144483,2022,Italy,Slovenia,0,2,1,3,25/06/2022,0,0,0,0,1,0,1,2,1,1,0,2,0,0,0,0,0,0,0,0
144483,2022,Argentina,Slovenia,0,0,0,0,23/06/2022,0,0,0,0,0,0,0,0,0,0,0,0,0,0,0,0,0,0,0,0
144483,2022,Slovenia,Netherlands,0,4,4,8,21/06/2022,0,0,1,1,8,3,9,20,0,3,2,5,0,1,0,1,0,2,1,3
144483,2022,Slovenia,China,0,2,9,11,11/6/2022,1,0,0,1,9,1,2,12,1,2,3,6,1,0,0,1,3,0,0,3
144483,2022,Australia,Slovenia,0,4,4,8,11/6/2022,0,0,0,0,6,0,4,10,2,3,5,10,0,1,0,1,2,0,0,2
144483,2022,Brazil,Slovenia,0,0,0,0,10/6/2022,0,0,0,0,0,0,1,1,0,0,0,0,0,0,0,0,0,0,0,0
144483,2022,Slovenia,USA,0,0,0,0,8/6/2022,0,0,0,0,0,0,0,0,0,0,0,0,0,0,0,0,0,0,0,0
154546,2022,Japan,Slovenia,0,0,0,0,26/06/2022,0,0,0,0,0,0,0,0,0,0,0,0,0,0,0,0,0,0,0,0
154546,2022,Italy,Slovenia,0,0,6,6,25/06/2022,0,0,2,2,3,1,5,9,0,1,1,2,4,1,8,13,6,3,0,9
154546,2022,Argentina,Slovenia,0,0,0,0,23/06/2022,0,0,0,0,0,0,0,0,0,0,0,0,0,0,0,0,0,0,0,0
154546,2022,Slovenia,Netherlands,0,0,0,0,21/06/2022,0,0,0,0,0,0,0,0,0,0,0,0,0,0,3,3,0,0,0,0
154546,2022,Slovenia,China,0,0,1,1,11/6/2022,0,0,0,0,0,0,0,0,0,0,0,0,1,0,0,1,0,0,0,0
154546,2022,Australia,Slovenia,0,0,7,7,11/6/2022,0,0,0,0,0,0,0,0,0,0,0,0,1,0,0,1,2,0,0,2
154546,2022,Brazil,Slovenia,0,0,0,0,10/6/2022,0,0,0,0,0,0,3,3,0,0,1,1,0,1,2,3,1,0,0,1
154546,2022,Slovenia,USA,0,1,1,2,8/6/2022,0,0,0,0,2,1,2,5,1,0,0,1,0,2,5,7,1,0,0,1
144415,2022,Poland,Slovenia,0,0,0,0,10/7/2022,0,0,0,0,0,0,0,0,0,0,0,0,2,5,15,22,1,4,0,5
144415,2022,Slovenia,Iran,0,0,0,0,8/7/2022,0,0,3,3,0,0,0,0,0,0,0,0,2,4,21,27,1,2,1,4
144415,2022,Bulgaria,Slovenia,0,0,0,0,7/7/2022,0,0,0,0,0,0,0,0,0,0,0,0,1,0,18,19,8,2,1,11
144415,2022,Slovenia,Serbia,0,0,0,0,6/7/2022,0,0,1,1,0,0,0,0,0,0,0,0,2,0,8,10,4,1,0,5
144415,2022,Japan,Slovenia,0,0,0,0,26/06/2022,0,0,4,4,0,0,0,0,0,0,0,0,11,1,11,23,6,8,2,16
144415,2022,Italy,Slovenia,0,0,0,0,25/06/2022,0,0,0,0,0,0,0,0,0,0,0,0,0,0,0,0,0,0,0,0
144415,2022,Slovenia,China,0,0,0,0,11/6/2022,3,0,1,4,0,0,0,0,0,0,0,0,9,1,18,28,12,4,0,16
144415,2022,Australia,Slovenia,0,0,0,0,11/6/2022,0,0,0,0,0,0,0,0,0,0,0,0,0,0,0,0,0,0,0,0
144415,2022,Brazil,Slovenia,0,0,0,0,10/6/2022,5,0,2,7,0,0,0,0,0,0,0,0,6,0,21,27,9,1,4,14
144415,2022,Slovenia,USA,0,0,0,0,8/6/2022,0,0,5,5,0,0,0,0,0,0,0,0,6,1,11,18,5,4,1,10
155920,2022,Poland,Slovenia,0,0,0,0,10/7/2022,0,0,0,0,0,0,0,0,0,0,0,0,0,0,0,0,0,0,0,0
155920,2022,Slovenia,Iran,0,0,0,0,8/7/2022,0,0,0,0,0,0,0,0,0,0,0,0,0,0,0,0,0,0,0,0
155920,2022,Bulgaria,Slovenia,0,0,0,0,7/7/2022,0,0,0,0,2,0,2,4,0,1,0,1,0,1,1,2,0,0,0,0
155920,2022,Slovenia,Serbia,0,0,0,0,6/7/2022,0,0,0,0,0,0,0,0,0,0,0,0,0,0,0,0,0,0,0,0
155920,2022,Japan,Slovenia,0,1,1,2,26/06/2022,0,0,2,2,0,0,0,0,0,0,0,0,1,0,1,2,2,0,0,2
155920,2022,Italy,Slovenia,0,2,5,7,25/06/2022,0,0,3,3,11,1,6,18,1,0,1,2,2,3,4,9,2,2,1,5
155920,2022,Argentina,Slovenia,0,3,14,17,23/06/2022,0,0,3,3,8,4,5,17,1,0,3,4,3,0,6,9,5,2,1,8
155920,2022,Slovenia,Netherlands,0,3,9,12,21/06/2022,0,0,0,0,11,3,9,23,0,1,3,4,5,2,6,13,6,1,1,8
155920,2022,Slovenia,China,0,2,13,15,11/6/2022,1,0,3,4,9,7,7,23,0,2,0,2,10,1,15,26,5,0,2,7
155920,2022,Australia,Slovenia,0,0,0,0,11/6/2022,0,0,0,0,0,0,0,0,0,0,0,0,0,0,0,0,0,0,0,0
155920,2022,Brazil,Slovenia,0,3,7,10,10/6/2022,1,1,4,6,7,4,6,17,1,1,1,3,7,6,19,32,3,3,1,7
155920,2022,Slovenia,USA,0,1,7,8,8/6/2022,0,0,0,0,2,3,3,8,0,0,0,0,3,1,10,14,7,1,0,8
161754,2022,Poland,Slovenia,0,0,0,0,10/7/2022,0,0,0,0,0,0,0,0,0,0,0,0,0,0,0,0,0,0,0,0
161754,2022,Slovenia,Iran,0,0,1,1,8/7/2022,0,0,0,0,0,0,0,0,0,0,0,0,0,0,1,1,0,0,0,0
161754,2022,Bulgaria,Slovenia,0,0,0,0,7/7/2022,0,0,0,0,0,0,0,0,0,0,0,0,0,0,0,0,0,0,0,0
161754,2022,Slovenia,Serbia,0,0,0,0,6/7/2022,0,0,0,0,0,0,0,0,0,0,0,0,0,0,0,0,0,0,0,0
161754,2022,Slovenia,China,0,0,5,5,11/6/2022,0,0,1,1,1,2,1,4,1,1,2,4,3,0,0,3,1,0,0,1
161754,2022,Australia,Slovenia,1,0,5,6,11/6/2022,0,0,1,1,2,0,0,2,0,0,1,1,0,0,0,0,1,0,0,1
161754,2022,Brazil,Slovenia,0,0,0,0,10/6/2022,0,0,0,0,0,0,0,0,0,0,0,0,0,0,0,0,0,0,0,0
161754,2022,Slovenia,USA,0,0,2,2,8/6/2022,0,0,0,0,0,0,0,0,0,0,0,0,0,0,0,0,0,0,0,0
119018,2022,Poland,Slovenia,0,2,5,7,10/7/2022,11,1,60,72,0,0,0,0,0,1,0,1,0,0,1,1,0,0,1,1
119018,2022,Slovenia,Iran,0,0,0,0,8/7/2022,0,0,0,0,0,0,0,0,0,0,0,0,0,0,0,0,0,0,0,0
119018,2022,Bulgaria,Slovenia,0,2,10,12,7/7/2022,24,2,64,90,0,0,1,1,1,2,0,3,0,1,0,1,1,0,1,2
119018,2022,Slovenia,Serbia,0,0,0,0,6/7/2022,0,0,0,0,0,0,0,0,0,0,0,0,0,0,0,0,0,0,0,0
119018,2022,Japan,Slovenia,0,1,10,11,26/06/2022,24,0,64,88,0,0,0,0,0,2,1,3,0,0,0,0,8,1,1,10
119018,2022,Italy,Slovenia,0,0,1,1,25/06/2022,0,0,4,4,0,0,0,0,0,0,0,0,0,0,1,1,0,1,0,1
119018,2022,Argentina,Slovenia,2,2,16,20,23/06/2022,15,0,76,91,1,0,1,2,1,1,3,5,0,0,1,1,14,3,0,17
119018,2022,Slovenia,Netherlands,0,2,11,13,21/06/2022,16,1,53,70,1,0,0,1,1,2,0,3,0,0,0,0,4,0,1,5
119018,2022,Slovenia,China,2,3,18,23,11/6/2022,37,0,36,73,0,0,1,1,1,0,1,2,0,0,2,2,6,0,1,7
119018,2022,Australia,Slovenia,0,1,12,13,11/6/2022,31,2,29,62,0,0,0,0,0,2,2,4,0,0,0,0,2,1,1,4
119018,2022,Brazil,Slovenia,1,3,7,11,10/6/2022,42,0,38,80,2,1,0,3,0,4,0,4,0,0,0,0,7,2,0,9
119018,2022,Slovenia,USA,0,1,7,8,8/6/2022,20,0,16,36,0,0,0,0,1,0,1,2,0,0,0,0,2,1,0,3
114957,2022,Poland,Slovenia,1,3,9,13,10/7/2022,0,0,0,0,7,2,16,25,1,0,0,1,1,2,18,21,3,1,0,4
114957,2022,Slovenia,Iran,2,1,2,5,8/7/2022,0,0,2,2,2,4,2,8,0,0,0,0,0,0,7,7,0,1,0,1
114957,2022,Bulgaria,Slovenia,0,0,0,0,7/7/2022,0,0,0,0,0,0,0,0,0,0,0,0,0,0,0,0,0,0,0,0
114957,2022,Slovenia,Serbia,0,1,7,8,6/7/2022,0,0,1,1,11,0,4,15,1,3,1,5,0,0,14,14,0,1,0,1
114957,2022,Japan,Slovenia,1,2,11,14,26/06/2022,0,0,2,2,9,3,11,23,1,2,1,4,6,3,22,31,4,4,1,9
114957,2022,Italy,Slovenia,0,0,0,0,25/06/2022,0,0,0,0,0,0,0,0,0,0,0,0,0,0,0,0,0,0,0,0
114957,2022,Argentina,Slovenia,2,3,15,20,23/06/2022,0,0,5,5,17,3,14,34,0,4,3,7,9,0,10,19,9,4,0,13
114957,2022,Slovenia,Netherlands,0,0,0,0,21/06/2022,0,0,1,1,0,0,0,0,0,0,0,0,0,0,5,5,0,0,1,1
136918,2022,Poland,Slovenia,0,4,9,13,10/7/2022,0,0,0,0,9,7,12,28,0,3,0,3,0,2,29,31,2,0,1,3
136918,2022,Slovenia,Iran,0,3,8,11,8/7/2022,0,0,0,0,10,6,6,22,1,3,0,4,2,0,10,12,1,0,0,1
136918,2022,Bulgaria,Slovenia,0,2,9,11,7/7/2022,0,0,0,0,13,2,9,24,1,1,1,3,3,2,26,31,2,0,1,3
136918,2022,Slovenia,Serbia,3,3,12,18,6/7/2022,0,0,0,0,7,1,7,15,1,3,0,4,4,2,12,18,5,0,0,5
168747,2022,Poland,Slovenia,0,0,1,1,10/7/2022,0,0,1,1,0,3,2,5,0,0,0,0,0,0,0,0,0,0,0,0
168747,2022,Slovenia,Iran,0,3,2,5,8/7/2022,0,0,0,0,2,2,1,5,0,0,0,0,0,2,6,8,1,0,0,1
168747,2022,Bulgaria,Slovenia,0,3,14,17,7/7/2022,0,0,4,4,13,3,1,17,1,2,0,3,0,0,9,9,1,1,2,4
168747,2022,Slovenia,Serbia,0,0,0,0,6/7/2022,0,0,0,0,0,0,0,0,0,0,0,0,0,0,0,0,0,0,0,0
168747,2022,Japan,Slovenia,0,4,6,10,26/06/2022,0,0,3,3,18,4,15,37,2,6,3,11,6,1,16,23,0,0,2,2
168747,2022,Italy,Slovenia,0,3,7,10,25/06/2022,0,0,0,0,10,5,9,24,1,1,2,4,3,1,8,12,4,2,1,7
168747,2022,Argentina,Slovenia,1,2,9,12,23/06/2022,0,0,5,5,13,6,19,38,3,4,6,13,0,1,1,2,5,0,0,5
168747,2022,Slovenia,Netherlands,1,4,5,10,21/06/2022,0,0,4,4,8,2,9,19,3,1,2,6,3,3,16,22,7,0,1,8
168747,2022,Slovenia,China,0,3,9,12,11/6/2022,1,0,0,1,14,1,13,28,3,3,1,7,6,1,6,13,6,0,0,6
168747,2022,Australia,Slovenia,0,4,8,12,11/6/2022,0,0,0,0,17,1,3,21,0,3,2,5,11,0,10,21,3,0,2,5
168747,2022,Brazil,Slovenia,1,5,6,12,10/6/2022,0,0,0,0,20,6,8,34,1,1,0,2,6,1,10,17,5,0,2,7
168747,2022,Slovenia,USA,0,2,5,7,8/6/2022,0,0,0,0,8,4,13,25,1,1,1,3,5,3,13,21,4,0,2,6
182325,2022,,,-,-,-,-,-,-,-,-,-,-,-,-,-,-,-,-,-,-,-,-,-,-,-,-,-
181130,2022,,,-,-,-,-,-,-,-,-,-,-,-,-,-,-,-,-,-,-,-,-,-,-,-,-,-
185708,2022,,,-,-,-,-,-,-,-,-,-,-,-,-,-,-,-,-,-,-,-,-,-,-,-,-,-
151399,2022,,,-,-,-,-,-,-,-,-,-,-,-,-,-,-,-,-,-,-,-,-,-,-,-,-,-
132624,2022,France,USA,0,3,13,16,24/07/2022,1,0,2,3,20,4,7,31,0,4,1,5,5,2,17,24,8,4,1,13
132624,2022,Poland,USA,0,3,7,10,23/07/2022,0,0,0,0,9,4,5,18,0,1,1,2,6,1,12,19,5,4,0,9
132624,2022,USA,Brazil,0,2,12,14,20/07/2022,0,0,1,1,14,2,10,26,0,0,1,1,9,1,17,27,12,3,1,16
132624,2022,USA,Argentina,0,0,0,0,10/7/2022,0,0,0,0,0,0,0,0,0,0,0,0,0,0,0,0,0,0,0,0
132624,2022,Canada,USA,0,4,4,8,9/7/2022,1,0,2,3,10,1,12,23,1,3,4,8,4,1,7,12,7,2,1,10
132624,2022,France,USA,2,3,15,20,7/7/2022,0,0,1,1,13,2,15,30,3,5,3,11,7,2,16,25,6,1,1,8
132624,2022,USA,Germany,3,1,12,16,5/7/2022,0,0,4,4,19,3,12,34,1,4,2,7,5,0,6,11,4,1,1,6
132624,2022,USA,Poland,3,4,10,17,26/06/2022,0,0,1,1,13,6,10,29,0,4,0,4,6,0,15,21,1,1,1,3
132624,2022,USA,Bulgaria,4,5,8,17,25/06/2022,0,0,0,0,10,5,8,23,2,3,1,6,5,1,17,23,1,2,0,3
132624,2022,USA,Iran,0,0,0,0,23/06/2022,0,0,0,0,0,0,0,0,0,0,0,0,0,0,0,0,0,0,0,0
132624,2022,Serbia,USA,1,2,11,14,22/06/2022,1,0,1,2,10,3,3,16,1,2,0,3,3,2,12,17,2,4,0,6
132624,2022,USA,Brazil,1,5,9,15,11/6/2022,2,0,0,2,9,6,9,24,0,5,1,6,14,0,20,34,7,2,2,11
132624,2022,Japan,USA,3,4,13,20,10/6/2022,2,0,1,3,16,3,14,33,1,2,7,10,8,0,26,34,7,1,1,9
132624,2022,Netherlands,USA,2,1,11,14,9/6/2022,5,0,5,10,11,2,4,17,1,3,2,6,4,0,3,7,3,3,4,10
132624,2022,Slovenia,USA,2,2,8,12,8/6/2022,0,0,0,0,8,5,7,20,4,2,1,7,3,1,16,20,6,0,3,9
136078,2022,USA,Poland,0,0,1,1,26/06/2022,1,0,3,4,0,0,0,0,0,1,0,1,0,0,0,0,0,0,0,0
136078,2022,USA,Bulgaria,0,1,3,4,25/06/2022,2,0,6,8,0,0,0,0,0,0,0,0,0,0,0,0,0,1,0,1
136078,2022,USA,Iran,0,0,2,2,23/06/2022,5,0,16,21,0,0,1,1,0,1,0,1,0,0,0,0,0,0,0,0
136078,2022,Serbia,USA,0,0,0,0,22/06/2022,0,0,0,0,0,0,0,0,0,0,0,0,0,0,0,0,0,0,0,0
136078,2022,USA,Brazil,0,0,2,2,11/6/2022,3,0,7,10,0,1,0,1,0,0,0,0,0,0,0,0,0,0,0,0
136078,2022,Japan,USA,0,0,0,0,10/6/2022,5,0,6,11,0,0,0,0,0,0,0,0,0,0,0,0,2,0,0,2
136078,2022,Netherlands,USA,0,1,1,2,9/6/2022,6,0,6,12,1,0,1,2,1,0,0,1,0,0,0,0,0,0,0,0
136078,2022,Slovenia,USA,0,0,0,0,8/6/2022,1,0,1,2,1,0,0,1,1,0,1,2,0,0,0,0,0,0,0,0
147721,2022,France,USA,0,3,7,10,24/07/2022,0,0,1,1,6,0,3,9,3,11,3,17,1,0,1,2,3,1,0,4
147721,2022,Poland,USA,1,1,8,10,23/07/2022,0,0,0,0,6,0,2,8,1,4,6,11,0,0,0,0,0,1,0,1
147721,2022,USA,Brazil,0,0,8,8,20/07/2022,0,0,0,0,6,0,4,10,2,6,4,12,0,0,0,0,2,1,0,3
147721,2022,USA,Argentina,0,0,0,0,10/7/2022,0,0,0,0,0,0,0,0,0,0,0,0,0,0,0,0,0,0,0,0
147721,2022,Canada,USA,1,0,13,14,9/7/2022,0,0,1,1,4,0,0,4,1,4,4,9,1,0,1,2,1,2,0,3
147721,2022,France,USA,0,3,9,12,7/7/2022,0,0,0,0,5,2,1,8,1,4,9,14,0,1,0,1,4,1,2,7
147721,2022,USA,Germany,0,1,9,10,5/7/2022,0,0,1,1,5,0,2,7,0,6,9,15,2,0,2,4,2,0,0,2
147721,2022,USA,Poland,0,0,8,8,26/06/2022,0,0,0,0,3,1,1,5,0,2,0,2,0,1,1,2,0,1,0,1
147721,2022,USA,Bulgaria,0,1,14,15,25/06/2022,1,0,0,1,7,0,3,10,1,2,4,7,0,0,0,0,2,1,0,3
147721,2022,USA,Iran,2,2,7,11,23/06/2022,0,0,1,1,5,1,3,9,2,4,2,8,0,0,2,2,0,0,0,0
147721,2022,Serbia,USA,0,1,14,15,22/06/2022,0,0,0,0,5,1,6,12,0,9,3,12,0,0,4,4,0,0,0,0
147721,2022,USA,Brazil,1,3,11,15,11/6/2022,0,0,1,1,9,1,0,10,2,4,3,9,0,0,2,2,1,1,0,2
147721,2022,Japan,USA,1,3,15,19,10/6/2022,0,0,0,0,11,1,5,17,4,8,10,22,0,0,0,0,2,3,1,6
147721,2022,Netherlands,USA,1,1,13,15,9/6/2022,0,0,0,0,3,0,0,3,1,4,1,6,0,0,0,0,4,1,0,5
147721,2022,Slovenia,USA,0,2,7,9,8/6/2022,0,0,1,1,4,0,4,8,3,2,4,9,0,0,0,0,1,0,0,1
147417,2022,France,USA,0,0,1,1,24/07/2022,0,0,0,0,1,0,4,5,0,0,0,0,0,0,0,0,2,0,0,2
147417,2022,Poland,USA,0,2,8,10,23/07/2022,0,0,2,2,8,1,6,15,0,2,2,4,0,0,2,2,3,0,0,3
147417,2022,USA,Brazil,1,2,3,6,20/07/2022,0,0,0,0,4,3,7,14,1,5,2,8,0,0,0,0,3,0,1,4
147417,2022,USA,Argentina,0,2,11,13,10/7/2022,1,0,1,2,7,1,5,13,1,3,4,8,0,0,0,0,6,1,1,8
147417,2022,Canada,USA,2,1,10,13,9/7/2022,0,0,1,1,10,0,6,16,1,3,1,5,0,0,1,1,5,2,3,10
147417,2022,France,USA,2,2,11,15,7/7/2022,0,0,3,3,10,3,12,25,0,8,4,12,0,0,0,0,6,4,2,12
147417,2022,USA,Germany,1,3,6,10,5/7/2022,0,0,1,1,12,5,8,25,0,1,7,8,0,0,0,0,4,0,2,6
147417,2022,USA,Poland,0,3,7,10,26/06/2022,0,0,2,2,8,4,6,18,0,2,0,2,0,0,0,0,0,1,1,2
147417,2022,USA,Bulgaria,1,5,4,10,25/06/2022,0,0,1,1,17,2,3,22,2,0,3,5,0,0,0,0,1,3,0,4
147417,2022,USA,Iran,0,1,8,9,23/06/2022,0,0,0,0,11,6,5,22,0,3,0,3,0,0,0,0,1,1,0,2
147417,2022,Serbia,USA,0,3,11,14,22/06/2022,0,0,0,0,13,4,6,23,0,5,3,8,0,0,0,0,2,1,1,4
147417,2022,USA,Brazil,0,0,0,0,11/6/2022,0,0,0,0,0,0,0,0,0,0,0,0,0,0,0,0,0,0,0,0
147417,2022,Japan,USA,0,4,13,17,10/6/2022,0,0,0,0,19,2,15,36,1,4,8,13,0,0,0,0,5,2,3,10
147417,2022,Netherlands,USA,1,3,9,13,9/6/2022,0,0,0,0,11,3,2,16,2,1,0,3,0,0,0,0,6,0,0,6
147417,2022,Slovenia,USA,2,1,13,16,8/6/2022,0,0,4,4,12,3,4,19,0,0,7,7,0,0,0,0,2,1,0,3
140185,2022,France,USA,0,0,0,0,24/07/2022,0,0,0,0,0,0,0,0,0,0,0,0,0,0,0,0,0,0,0,0
140185,2022,Poland,USA,0,0,0,0,23/07/2022,0,0,0,0,0,0,0,0,0,0,0,0,0,0,0,0,0,0,0,0
140185,2022,USA,Brazil,0,0,0,0,20/07/2022,0,0,0,0,0,0,0,0,0,0,0,0,0,0,0,0,0,0,0,0
140185,2022,USA,Argentina,1,8,9,18,10/7/2022,0,0,0,0,7,1,4,12,3,7,7,17,0,0,2,2,2,0,0,2
140185,2022,Canada,USA,0,0,0,0,9/7/2022,0,0,0,0,0,0,0,0,0,0,0,0,0,0,0,0,0,0,0,0
140185,2022,France,USA,0,0,0,0,7/7/2022,0,0,0,0,0,0,0,0,0,0,0,0,0,0,0,0,0,0,0,0
140185,2022,USA,Germany,0,0,0,0,5/7/2022,0,0,0,0,0,0,0,0,0,0,0,0,0,0,0,0,0,0,0,0
140185,2022,USA,Poland,2,3,5,10,26/06/2022,0,0,1,1,5,0,2,7,1,4,2,7,0,0,2,2,0,2,0,2
140185,2022,USA,Bulgaria,0,0,1,1,25/06/2022,0,0,0,0,0,0,1,1,0,0,0,0,0,0,0,0,0,0,0,0
140185,2022,USA,Iran,0,1,5,6,23/06/2022,0,0,0,0,3,1,3,7,1,2,2,5,0,0,1,1,0,0,0,0
140185,2022,Serbia,USA,0,0,0,0,22/06/2022,0,0,0,0,0,0,0,0,0,0,0,0,0,0,0,0,0,0,0,0
183140,2022,USA,Brazil,0,0,0,0,11/6/2022,0,0,0,0,0,0,0,0,0,0,0,0,0,0,0,0,0,0,0,0
183140,2022,Japan,USA,0,0,0,0,10/6/2022,0,0,0,0,0,0,0,0,0,0,0,0,0,0,0,0,0,0,0,0
183140,2022,Netherlands,USA,0,0,0,0,9/6/2022,0,0,0,0,0,0,0,0,0,0,0,0,0,0,0,0,0,0,0,0
183140,2022,Slovenia,USA,0,0,0,0,8/6/2022,0,0,0,0,0,0,0,0,0,0,0,0,0,0,0,0,0,0,0,0
139254,2022,France,USA,0,2,16,18,24/07/2022,0,1,0,1,13,6,6,25,0,2,4,6,2,1,9,12,2,3,1,6
139254,2022,Poland,USA,6,1,11,18,23/07/2022,0,0,2,2,6,2,6,14,1,2,0,3,2,0,5,7,4,1,1,6
139254,2022,USA,Brazil,1,6,11,18,20/07/2022,0,0,0,0,16,4,9,29,0,5,2,7,11,1,10,22,2,6,0,8
139254,2022,USA,Argentina,0,3,13,16,10/7/2022,0,0,7,7,25,6,12,43,3,7,1,11,5,1,24,30,5,3,1,9
139254,2022,Canada,USA,1,2,8,11,9/7/2022,0,0,5,5,17,1,5,23,0,2,4,6,5,0,9,14,2,1,0,3
139254,2022,France,USA,1,3,13,17,7/7/2022,0,0,7,7,12,5,8,25,2,2,8,12,2,2,16,20,6,2,2,10
139254,2022,USA,Germany,1,4,16,21,5/7/2022,0,0,4,4,11,2,6,19,0,3,7,10,14,1,18,33,4,1,1,6
139254,2022,USA,Poland,2,0,17,19,26/06/2022,0,0,0,0,11,3,12,26,1,2,1,4,9,3,24,36,1,1,1,3
139254,2022,USA,Bulgaria,2,3,17,22,25/06/2022,0,0,1,1,10,4,11,25,0,1,1,2,6,1,17,24,1,2,1,4
139254,2022,USA,Iran,0,3,8,11,23/06/2022,1,0,0,1,13,4,7,24,0,2,0,2,4,2,23,29,0,1,1,2
139254,2022,Serbia,USA,0,6,12,18,22/06/2022,0,0,0,0,23,3,6,32,2,3,1,6,5,3,16,24,0,4,0,4
170104,2022,USA,Argentina,0,2,4,6,10/7/2022,0,0,1,1,7,1,6,14,0,1,2,3,0,0,0,0,2,0,0,2
170104,2022,Canada,USA,0,0,0,0,9/7/2022,0,0,0,0,0,0,0,0,0,0,0,0,0,0,0,0,0,0,0,0
170104,2022,France,USA,0,2,0,2,7/7/2022,0,0,0,0,0,0,1,1,0,2,2,4,0,0,0,0,0,0,1,1
170104,2022,USA,Germany,0,2,4,6,5/7/2022,0,0,0,0,4,3,3,10,0,1,2,3,0,0,0,0,0,0,0,0
170104,2022,USA,Brazil,1,2,18,21,11/6/2022,0,0,0,0,17,4,16,37,2,3,1,6,0,0,0,0,7,3,2,12
170104,2022,Japan,USA,0,1,0,1,10/6/2022,0,0,1,1,2,0,1,3,0,0,0,0,0,0,0,0,0,0,0,0
170104,2022,Netherlands,USA,0,0,2,2,9/6/2022,0,0,0,0,3,0,1,4,0,0,0,0,0,0,0,0,0,0,0,0
170104,2022,Slovenia,USA,0,0,0,0,8/6/2022,0,0,0,0,0,0,0,0,0,0,0,0,0,0,0,0,0,0,0,0
142445,2022,France,USA,0,0,0,0,24/07/2022,0,0,0,0,0,0,0,0,0,0,0,0,0,0,0,0,0,0,0,0
142445,2022,Poland,USA,0,0,0,0,23/07/2022,0,0,0,0,0,0,0,0,0,0,0,0,0,0,1,1,0,0,0,0
142445,2022,USA,Brazil,0,0,0,0,20/07/2022,0,0,0,0,0,0,0,0,0,0,0,0,0,0,0,0,0,0,0,0
142445,2022,USA,Argentina,0,0,0,0,10/7/2022,0,0,5,5,0,0,0,0,0,0,0,0,10,0,12,22,10,6,5,21
142445,2022,Canada,USA,0,0,0,0,9/7/2022,0,0,0,0,0,0,0,0,0,0,0,0,0,0,0,0,0,0,0,0
142445,2022,France,USA,0,0,0,0,7/7/2022,0,0,0,0,0,0,0,0,0,0,0,0,0,0,0,0,0,0,0,0
142445,2022,USA,Germany,0,0,0,0,5/7/2022,0,0,0,0,0,0,0,0,0,0,0,0,0,0,0,0,0,0,0,0
142445,2022,USA,Poland,0,0,0,0,26/06/2022,0,0,0,0,0,0,0,0,0,0,0,0,0,0,0,0,0,0,0,0
142445,2022,USA,Bulgaria,0,0,0,0,25/06/2022,0,0,0,0,0,0,0,0,0,0,0,0,0,0,0,0,0,0,0,0
142445,2022,USA,Iran,0,0,0,0,23/06/2022,1,0,1,2,0,0,0,0,0,0,0,0,5,1,16,22,3,3,2,8
142445,2022,Serbia,USA,0,0,0,0,22/06/2022,0,0,0,0,0,0,0,0,0,0,0,0,0,0,0,0,0,0,0,0
142445,2022,USA,Brazil,0,0,0,0,11/6/2022,7,0,1,8,0,0,0,0,0,0,0,0,11,1,6,18,12,1,0,13
142445,2022,Japan,USA,0,0,0,0,10/6/2022,10,0,3,13,0,0,0,0,0,0,0,0,5,0,7,12,14,4,3,21
142445,2022,Netherlands,USA,0,0,0,0,9/6/2022,3,0,0,3,0,0,0,0,0,0,0,0,6,0,7,13,9,0,0,9
142445,2022,Slovenia,USA,0,0,0,0,8/6/2022,0,0,3,3,0,0,0,0,0,0,0,0,5,2,5,12,5,3,0,8
124879,2022,France,USA,1,3,15,19,24/07/2022,26,1,69,96,1,0,0,1,2,5,4,11,0,0,0,0,4,1,1,6
124879,2022,Poland,USA,0,1,12,13,23/07/2022,12,0,43,55,3,0,1,4,1,1,0,2,0,0,0,0,2,0,0,2
124879,2022,USA,Brazil,2,1,24,27,20/07/2022,34,0,66,100,0,0,1,1,1,0,0,1,0,0,0,0,4,2,0,6
124879,2022,USA,Argentina,0,2,7,9,10/7/2022,28,0,32,60,0,0,1,1,3,3,3,9,0,0,1,1,6,3,1,10
124879,2022,Canada,USA,1,3,11,15,9/7/2022,33,1,22,56,1,0,0,1,1,1,2,4,0,0,0,0,4,1,1,6
124879,2022,France,USA,0,3,11,14,7/7/2022,23,1,53,77,1,0,3,4,2,4,5,11,0,1,1,2,5,2,1,8
124879,2022,USA,Germany,1,3,11,15,5/7/2022,33,1,53,87,3,0,1,4,1,1,4,6,0,0,0,0,10,4,1,15
147542,2022,USA,Brazil,0,0,0,0,11/6/2022,0,0,0,0,0,0,0,0,0,0,0,0,0,0,0,0,0,0,0,0
147542,2022,Japan,USA,0,0,0,0,10/6/2022,0,0,0,0,0,0,0,0,0,0,0,0,0,0,0,0,0,0,0,0
147542,2022,Netherlands,USA,0,0,0,0,9/6/2022,0,0,0,0,0,0,0,0,0,0,0,0,0,0,0,0,0,0,0,0
147542,2022,Slovenia,USA,0,0,0,0,8/6/2022,0,0,0,0,0,0,0,0,0,0,0,0,0,0,0,0,0,0,0,0
189158,2022,,,-,-,-,-,-,-,-,-,-,-,-,-,-,-,-,-,-,-,-,-,-,-,-,-,-
136077,2022,France,USA,0,2,5,7,24/07/2022,0,0,0,0,4,2,5,11,0,1,2,3,0,0,0,0,1,0,0,1
136077,2022,Poland,USA,1,2,4,7,23/07/2022,0,0,0,0,0,0,0,0,0,0,0,0,0,0,0,0,0,0,0,0
136077,2022,USA,Brazil,0,0,7,7,20/07/2022,0,0,0,0,8,2,6,16,0,1,2,3,0,0,0,0,4,1,1,6
136077,2022,USA,Poland,0,1,5,6,26/06/2022,0,0,0,0,3,0,2,5,0,1,0,1,0,0,0,0,0,1,0,1
136077,2022,USA,Bulgaria,0,1,1,2,25/06/2022,0,0,0,0,3,0,0,3,0,1,1,2,0,0,0,0,0,0,0,0
136077,2022,USA,Iran,1,2,2,5,23/06/2022,0,0,0,0,2,0,2,4,0,0,0,0,0,0,0,0,1,0,0,1
136077,2022,Serbia,USA,0,0,0,0,22/06/2022,0,0,0,0,0,0,0,0,0,0,0,0,0,0,0,0,0,0,0,0
147543,2022,France,USA,0,0,0,0,24/07/2022,0,0,0,0,0,0,0,0,0,0,0,0,0,0,0,0,0,0,0,0
147543,2022,Poland,USA,0,0,0,0,23/07/2022,0,0,0,0,0,0,0,0,0,0,0,0,0,0,0,0,0,0,0,0
147543,2022,USA,Brazil,0,0,0,0,20/07/2022,0,0,0,0,0,0,0,0,0,0,0,0,0,0,0,0,0,0,0,0
147543,2022,USA,Argentina,0,0,7,7,10/7/2022,20,0,18,38,0,0,1,1,0,1,2,3,0,0,0,0,1,1,2,4
147543,2022,Canada,USA,0,0,0,0,9/7/2022,0,0,0,0,0,0,0,0,0,0,0,0,0,0,0,0,0,0,0,0
147543,2022,France,USA,0,0,0,0,7/7/2022,5,0,3,8,0,0,0,0,0,0,0,0,0,0,0,0,1,0,0,1
147543,2022,USA,Germany,0,0,0,0,5/7/2022,0,0,0,0,0,0,0,0,0,0,0,0,0,0,0,0,0,0,0,0
147543,2022,USA,Poland,0,3,12,15,26/06/2022,21,0,64,85,1,0,0,1,0,2,3,5,0,0,0,0,2,1,0,3
147543,2022,USA,Bulgaria,0,1,12,13,25/06/2022,24,1,50,75,1,0,1,2,0,5,0,5,0,0,0,0,5,4,3,12
147543,2022,USA,Iran,0,1,8,9,23/06/2022,21,0,41,62,0,1,2,3,0,1,2,3,0,0,0,0,0,2,0,2
147543,2022,Serbia,USA,2,3,14,19,22/06/2022,37,0,52,89,0,0,2,2,0,1,2,3,0,0,0,0,2,4,0,6
147543,2022,USA,Brazil,0,3,10,13,11/6/2022,43,0,42,85,3,0,1,4,2,3,4,9,0,0,1,1,4,2,0,6
147543,2022,Japan,USA,0,5,15,20,10/6/2022,52,0,43,95,2,1,1,4,1,2,6,9,0,0,0,0,7,0,1,8
147543,2022,Netherlands,USA,0,1,6,7,9/6/2022,17,0,20,37,2,1,0,3,0,2,2,4,0,0,0,0,3,0,0,3
147543,2022,Slovenia,USA,1,3,9,13,8/6/2022,17,0,12,29,2,0,0,2,0,3,4,7,0,0,0,0,5,0,1,6
143682,2022,USA,Poland,0,0,0,0,26/06/2022,0,0,0,0,0,0,0,0,0,0,0,0,0,0,0,0,0,0,0,0
143682,2022,USA,Bulgaria,0,0,0,0,25/06/2022,0,0,0,0,0,0,0,0,0,0,0,0,0,0,0,0,0,0,0,0
143682,2022,USA,Iran,0,1,5,6,23/06/2022,0,0,1,1,3,2,6,11,1,0,0,1,3,1,4,8,3,1,1,5
143682,2022,Serbia,USA,0,0,0,0,22/06/2022,0,0,0,0,0,0,0,0,0,0,0,0,0,0,0,0,0,0,0,0
143682,2022,USA,Brazil,0,0,0,0,11/6/2022,0,0,0,0,0,0,0,0,0,0,0,0,0,0,0,0,0,0,0,0
143682,2022,Japan,USA,0,5,11,16,10/6/2022,3,0,0,3,9,2,16,27,2,2,1,5,13,1,20,34,10,1,0,11
143682,2022,Netherlands,USA,1,2,6,9,9/6/2022,1,0,0,1,7,4,5,16,1,2,2,5,3,0,15,18,5,1,0,6
143682,2022,Slovenia,USA,2,3,9,14,8/6/2022,0,0,0,0,6,1,6,13,1,2,1,4,2,0,6,8,5,1,1,7
133463,2022,France,USA,0,1,9,10,24/07/2022,0,0,1,1,11,0,4,15,0,4,3,7,10,2,6,18,6,1,0,7
133463,2022,Poland,USA,0,0,0,0,23/07/2022,0,0,0,0,0,0,0,0,0,0,0,0,0,0,0,0,0,0,0,0
133463,2022,USA,Brazil,0,1,2,3,20/07/2022,0,0,0,0,0,0,0,0,0,0,0,0,0,0,0,0,0,1,0,1
133463,2022,USA,Argentina,0,1,21,22,10/7/2022,1,0,1,2,10,5,7,22,0,3,1,4,11,1,14,26,5,1,3,9
133463,2022,Canada,USA,0,0,0,0,9/7/2022,0,0,0,0,0,0,0,0,0,0,0,0,0,0,0,0,0,0,0,0
133463,2022,France,USA,0,2,0,2,7/7/2022,0,0,0,0,0,0,0,0,0,0,0,0,0,0,0,0,0,0,0,0
133463,2022,USA,Germany,0,2,2,4,5/7/2022,0,0,0,0,0,0,0,0,0,0,0,0,0,0,0,0,1,0,0,1
133463,2022,USA,Poland,0,0,0,0,26/06/2022,0,0,0,0,0,1,0,1,0,1,0,1,0,0,1,1,0,0,0,0
133463,2022,USA,Bulgaria,0,0,1,1,25/06/2022,0,0,0,0,3,0,0,3,0,0,0,0,0,2,2,4,2,1,0,3
133463,2022,USA,Iran,0,0,7,7,23/06/2022,0,1,0,1,3,1,3,7,0,0,0,0,0,1,3,4,0,0,0,0
133463,2022,Serbia,USA,0,0,0,0,22/06/2022,0,0,0,0,0,0,0,0,0,0,0,0,0,0,0,0,0,0,0,0
116069,2022,France,USA,0,0,15,15,24/07/2022,1,0,1,2,4,4,2,10,2,6,6,14,0,0,0,0,1,1,0,2
116069,2022,Poland,USA,1,1,4,6,23/07/2022,0,0,1,1,6,1,1,8,3,4,4,11,0,0,0,0,3,0,0,3
116069,2022,USA,Brazil,0,1,10,11,20/07/2022,0,0,0,0,8,0,3,11,3,6,9,18,1,0,1,2,5,2,0,7
116069,2022,USA,Argentina,2,3,17,22,10/7/2022,0,0,0,0,9,1,2,12,3,2,7,12,0,0,0,0,1,0,0,1
116069,2022,Canada,USA,0,3,10,13,9/7/2022,1,0,2,3,5,0,3,8,1,2,5,8,0,0,0,0,1,1,0,2
116069,2022,France,USA,1,2,17,20,7/7/2022,0,0,3,3,5,0,1,6,1,0,5,6,0,0,2,2,3,1,0,4
116069,2022,USA,Germany,1,2,11,14,5/7/2022,0,0,1,1,5,0,4,9,2,7,5,14,2,0,3,5,3,0,1,4
116069,2022,USA,Poland,1,3,5,9,26/06/2022,0,1,0,1,5,1,3,9,3,7,2,12,1,0,0,1,0,1,0,1
116069,2022,USA,Bulgaria,1,1,8,10,25/06/2022,0,0,1,1,4,0,1,5,2,3,3,8,0,0,0,0,0,0,1,1
116069,2022,USA,Iran,0,0,0,0,23/06/2022,0,0,0,0,0,0,0,0,0,0,0,0,0,0,0,0,0,0,0,0
116069,2022,Serbia,USA,2,2,14,18,22/06/2022,0,0,0,0,5,1,2,8,4,3,1,8,0,0,2,2,2,1,1,4
116069,2022,USA,Brazil,0,0,0,0,11/6/2022,0,0,0,0,0,0,0,0,0,0,0,0,0,0,0,0,0,0,0,0
116069,2022,Japan,USA,0,3,9,12,10/6/2022,1,0,1,2,5,2,4,11,1,6,10,17,0,0,1,1,3,0,2,5
116069,2022,Netherlands,USA,0,0,12,12,9/6/2022,2,0,0,2,3,1,1,5,2,1,4,7,0,0,0,0,1,0,0,1
116069,2022,Slovenia,USA,0,2,8,10,8/6/2022,0,0,1,1,3,0,1,4,5,0,2,7,0,0,1,1,4,0,0,4
168461,2022,USA,Brazil,0,0,0,0,11/6/2022,0,0,0,0,0,0,0,0,0,0,0,0,0,0,0,0,0,0,0,0
168461,2022,Japan,USA,0,0,0,0,10/6/2022,0,0,0,0,0,0,0,0,0,0,0,0,0,0,0,0,0,0,0,0
168461,2022,Netherlands,USA,0,0,0,0,9/6/2022,0,0,0,0,0,0,0,0,0,0,0,0,0,0,0,0,0,0,0,0
168461,2022,Slovenia,USA,0,0,0,0,8/6/2022,0,0,0,0,0,0,0,0,0,0,0,0,0,0,0,0,0,0,0,0
119732,2022,France,USA,0,0,0,0,24/07/2022,0,0,2,2,0,0,0,0,0,0,0,0,9,1,14,24,9,2,2,13
119732,2022,Poland,USA,0,0,0,0,23/07/2022,0,0,3,3,0,0,0,0,0,0,0,0,5,3,6,14,9,2,0,11
119732,2022,USA,Brazil,0,0,0,0,20/07/2022,0,0,3,3,0,0,0,0,0,0,0,0,9,0,9,18,5,5,0,10
119732,2022,USA,Argentina,0,0,0,0,10/7/2022,0,0,0,0,0,0,0,0,0,0,0,0,0,0,0,0,0,0,0,0
119732,2022,Canada,USA,0,0,0,0,9/7/2022,0,1,2,3,0,0,0,0,0,0,0,0,7,1,8,16,8,3,2,13
119732,2022,France,USA,0,0,0,0,7/7/2022,0,1,4,5,0,0,0,0,0,0,0,0,5,1,12,18,7,3,0,10
119732,2022,USA,Germany,0,0,0,0,5/7/2022,1,0,7,8,0,0,0,0,0,0,0,0,10,1,3,14,11,2,2,15
119732,2022,USA,Poland,0,0,0,0,26/06/2022,1,0,1,2,0,0,0,0,0,0,0,0,4,0,12,16,7,4,0,11
119732,2022,USA,Bulgaria,0,0,0,0,25/06/2022,1,0,2,3,0,0,0,0,0,0,0,0,7,2,9,18,8,3,2,13
119732,2022,USA,Iran,0,0,0,0,23/06/2022,0,0,0,0,0,0,0,0,0,0,0,0,0,0,0,0,0,0,0,0
119732,2022,Serbia,USA,0,0,0,0,22/06/2022,0,0,1,1,0,0,0,0,0,0,0,0,9,1,14,24,4,0,2,6
153472,2022,France,USA,0,0,0,0,24/07/2022,0,0,0,0,0,0,0,0,0,0,0,0,0,0,0,0,0,0,0,0
153472,2022,Poland,USA,0,0,0,0,23/07/2022,0,0,0,0,0,0,0,0,0,0,0,0,0,0,0,0,0,0,0,0
153472,2022,USA,Brazil,0,0,0,0,20/07/2022,0,0,0,0,0,0,0,0,0,0,0,0,0,0,0,0,0,0,0,0
153472,2022,USA,Argentina,0,0,0,0,10/7/2022,0,0,0,0,0,0,0,0,0,0,0,0,0,0,0,0,0,0,0,0
153472,2022,Canada,USA,0,0,0,0,9/7/2022,0,0,0,0,0,0,0,0,0,0,0,0,0,0,0,0,0,0,0,0
153472,2022,France,USA,0,0,0,0,7/7/2022,0,0,0,0,0,0,0,0,0,0,0,0,0,0,0,0,0,0,0,0
153472,2022,USA,Germany,0,0,0,0,5/7/2022,0,0,0,0,0,0,0,0,0,0,0,0,0,0,0,0,0,0,0,0
153472,2022,USA,Brazil,0,1,14,15,11/6/2022,0,0,1,1,8,3,9,20,0,4,3,7,6,2,6,14,7,1,1,9
153472,2022,Japan,USA,0,0,2,2,10/6/2022,0,0,0,0,0,0,0,0,0,0,0,0,0,0,0,0,0,0,0,0
153472,2022,Netherlands,USA,0,0,0,0,9/6/2022,0,0,0,0,0,0,0,0,0,0,0,0,0,0,0,0,0,0,0,0
153472,2022,Slovenia,USA,0,0,0,0,8/6/2022,0,0,0,0,0,0,0,0,0,0,0,0,0,0,0,0,0,0,0,0
164133,2022,,,-,-,-,-,-,-,-,-,-,-,-,-,-,-,-,-,-,-,-,-,-,-,-,-,-
182750,2022,,,-,-,-,-,-,-,-,-,-,-,-,-,-,-,-,-,-,-,-,-,-,-,-,-,-
169728,2022,,,-,-,-,-,-,-,-,-,-,-,-,-,-,-,-,-,-,-,-,-,-,-,-,-,-
162551,2022,France,USA,0,0,0,0,24/07/2022,0,0,0,0,0,0,0,0,0,0,0,0,0,0,0,0,0,0,0,0
162551,2022,Poland,USA,0,0,0,0,23/07/2022,0,0,0,0,0,0,0,0,0,0,0,0,0,0,0,0,0,0,0,0
162551,2022,USA,Brazil,0,0,0,0,20/07/2022,0,0,0,0,0,0,0,0,0,0,0,0,0,0,0,0,0,0,0,0
162551,2022,USA,Argentina,0,0,0,0,10/7/2022,0,0,0,0,0,0,0,0,0,0,0,0,0,0,0,0,0,0,0,0
162551,2022,Canada,USA,0,0,0,0,9/7/2022,0,0,0,0,0,0,0,0,0,0,0,0,0,0,0,0,0,0,0,0
162551,2022,France,USA,0,0,0,0,7/7/2022,0,0,0,0,0,0,0,0,0,0,0,0,0,0,0,0,0,0,0,0
162551,2022,USA,Germany,0,0,0,0,5/7/2022,0,0,0,0,0,0,0,0,0,0,0,0,0,0,0,0,0,0,0,0
162551,2022,USA,Poland,0,0,0,0,26/06/2022,0,0,0,0,0,0,0,0,0,0,0,0,0,0,0,0,0,0,0,0
162551,2022,USA,Bulgaria,0,0,0,0,25/06/2022,0,0,0,0,0,0,0,0,0,0,0,0,0,0,0,0,0,0,0,0
162551,2022,USA,Iran,0,1,5,6,23/06/2022,0,0,0,0,2,1,2,5,0,3,0,3,0,0,0,0,0,0,0,0
162551,2022,Serbia,USA,0,0,0,0,22/06/2022,0,0,0,0,0,0,0,0,0,0,0,0,0,0,0,0,0,0,0,0
162551,2022,USA,Brazil,2,2,12,16,11/6/2022,0,0,0,0,9,0,2,11,2,7,4,13,0,0,0,0,5,0,0,5
162551,2022,Japan,USA,0,0,1,1,10/6/2022,0,0,0,0,0,0,0,0,0,0,0,0,0,0,1,1,0,0,0,0
162551,2022,Netherlands,USA,0,0,0,0,9/6/2022,0,0,0,0,1,0,1,2,0,0,0,0,0,0,0,0,0,0,0,0
162551,2022,Slovenia,USA,0,0,0,0,8/6/2022,0,0,0,0,0,0,0,0,0,0,0,0,0,0,0,0,0,0,0,0
156751,2022,,,-,-,-,-,-,-,-,-,-,-,-,-,-,-,-,-,-,-,-,-,-,-,-,-,-
142412,2023,Italy,Argentina,0,0,1,1,19/07/2023,5,0,9,14,0,0,0,0,0,0,0,0,0,0,0,0,1,0,0,1
142412,2023,Argentina,Iran,0,0,2,2,9/7/2023,0,0,1,1,0,0,0,0,0,0,0,0,0,0,0,0,0,0,0,0
142412,2023,USA,Argentina,1,2,2,5,8/7/2023,3,0,5,8,0,0,0,0,0,0,1,1,0,0,1,1,4,1,0,5
142412,2023,Argentina,Germany,0,0,0,0,6/7/2023,2,1,10,13,0,0,0,0,0,0,0,0,0,0,0,0,0,0,0,0
142412,2023,Argentina,Serbia,0,0,0,0,4/7/2023,1,0,3,4,0,0,0,0,0,1,0,1,0,0,0,0,0,0,0,0
142412,2023,Japan,Argentina,0,1,14,15,24/06/2023,29,0,65,94,0,0,0,0,0,7,0,7,0,0,1,1,1,6,0,7
142412,2023,Argentina,Bulgaria,0,0,10,10,23/06/2023,20,0,27,47,0,0,0,0,0,0,1,1,0,0,0,0,5,0,3,8
142412,2023,Argentina,France,0,2,13,15,21/06/2023,38,0,53,91,0,0,0,0,0,2,0,2,0,0,0,0,5,2,0,7
142412,2023,Argentina,Slovenia,0,1,12,13,20/06/2023,28,2,52,82,0,0,1,1,0,0,0,0,0,0,0,0,2,1,2,5
142412,2023,Argentina,Netherlands,0,0,0,0,11/6/2023,1,0,4,5,0,0,0,0,0,0,0,0,0,0,0,0,1,1,1,3
142412,2023,Canada,Argentina,0,0,1,1,10/6/2023,0,0,2,2,0,0,0,0,0,0,0,0,0,1,0,1,1,0,0,1
142412,2023,Argentina,Brazil,0,0,0,0,9/6/2023,1,0,7,8,0,0,0,0,0,0,0,0,0,0,0,0,0,2,0,2
142412,2023,Italy,Argentina,0,0,0,0,6/6/2023,1,0,2,3,0,0,0,0,0,0,0,0,0,0,0,0,0,0,0,0
142410,2023,Italy,Argentina,0,1,1,2,19/07/2023,0,0,2,2,2,0,4,6,0,0,0,0,2,0,4,6,0,0,0,0
142410,2023,Argentina,Iran,1,3,6,10,9/7/2023,0,0,2,2,5,1,9,15,0,2,1,3,4,2,9,15,6,0,0,6
142410,2023,USA,Argentina,0,2,8,10,8/7/2023,0,0,6,6,9,0,6,15,1,1,2,4,3,0,11,14,3,2,2,7
142410,2023,Argentina,Germany,0,0,1,1,6/7/2023,0,0,0,0,2,0,2,4,0,0,2,2,1,0,2,3,3,0,0,3
142410,2023,Argentina,Serbia,0,0,0,0,4/7/2023,0,0,0,0,0,0,0,0,0,0,0,0,0,0,0,0,0,0,0,0
142410,2023,Japan,Argentina,0,0,0,0,24/06/2023,0,0,0,0,0,0,0,0,0,0,0,0,0,0,2,2,0,0,0,0
142410,2023,Argentina,Bulgaria,0,0,0,0,23/06/2023,0,0,0,0,0,0,0,0,0,0,0,0,0,0,0,0,0,0,0,0
142410,2023,Argentina,France,0,0,0,0,21/06/2023,0,0,0,0,0,0,0,0,0,0,0,0,0,0,0,0,0,0,0,0
142410,2023,Argentina,Slovenia,0,2,1,3,20/06/2023,0,0,0,0,0,0,2,2,0,1,0,1,5,1,4,10,3,0,0,3
142410,2023,Argentina,Netherlands,0,0,1,1,11/6/2023,0,0,0,0,2,1,2,5,0,1,1,2,0,0,9,9,2,3,1,6
142410,2023,Canada,Argentina,0,1,4,5,10/6/2023,0,0,1,1,3,0,5,8,1,1,0,2,4,0,6,10,9,1,2,12
142410,2023,Argentina,Brazil,0,2,1,3,9/6/2023,0,0,1,1,2,0,8,10,0,1,1,2,6,0,7,13,4,2,0,6
142410,2023,Italy,Argentina,0,0,0,0,6/6/2023,0,0,0,0,0,0,0,0,0,0,0,0,0,0,0,0,0,0,0,0
142411,2023,Italy,Argentina,0,0,0,0,19/07/2023,0,0,0,0,0,0,0,0,0,0,0,0,0,0,0,0,0,0,0,0
142411,2023,Argentina,Iran,0,0,0,0,9/7/2023,0,0,0,0,0,0,0,0,0,0,0,0,0,0,0,0,0,0,0,0
142411,2023,USA,Argentina,0,0,0,0,8/7/2023,0,0,0,0,0,0,0,0,0,0,0,0,0,0,0,0,0,0,0,0
142411,2023,Argentina,Germany,0,0,0,0,6/7/2023,0,0,0,0,0,0,0,0,0,0,0,0,0,0,0,0,0,0,0,0
142411,2023,Argentina,Serbia,0,0,0,0,4/7/2023,0,0,0,0,0,0,0,0,0,0,0,0,0,0,0,0,0,0,0,0
142411,2023,Japan,Argentina,0,0,0,0,24/06/2023,0,0,0,0,0,0,0,0,0,0,0,0,0,0,0,0,0,0,0,0
142411,2023,Argentina,Bulgaria,0,0,0,0,23/06/2023,0,0,0,0,0,0,0,0,0,0,0,0,0,0,0,0,0,0,0,0
142411,2023,Argentina,France,0,0,0,0,21/06/2023,0,0,0,0,0,0,0,0,0,0,0,0,0,0,0,0,0,0,0,0
142411,2023,Argentina,Slovenia,0,0,0,0,20/06/2023,0,0,0,0,0,0,0,0,0,0,0,0,0,0,0,0,0,0,0,0
142411,2023,Argentina,Netherlands,0,0,0,0,11/6/2023,0,0,0,0,0,0,0,0,0,0,0,0,0,0,0,0,0,0,0,0
142411,2023,Canada,Argentina,0,2,11,13,10/6/2023,0,0,2,2,8,2,5,15,1,3,6,10,0,0,0,0,2,1,1,4
142411,2023,Argentina,Brazil,0,1,21,22,9/6/2023,0,0,1,1,5,0,7,12,3,7,7,17,0,0,1,1,6,1,0,7
142411,2023,Italy,Argentina,0,0,4,4,6/6/2023,0,0,0,0,1,0,2,3,2,1,1,4,0,0,0,0,0,0,0,0
162546,2023,Italy,Argentina,0,4,4,8,19/07/2023,0,0,2,2,5,2,8,15,0,2,0,2,0,1,19,20,3,1,2,6
162546,2023,Argentina,Iran,0,6,10,16,9/7/2023,0,0,5,5,16,7,9,32,1,4,2,7,5,0,18,23,4,1,0,5
162546,2023,USA,Argentina,1,3,16,20,8/7/2023,0,1,2,3,12,4,10,26,0,4,4,8,4,1,25,30,6,4,4,14
162546,2023,Argentina,Germany,2,5,7,14,6/7/2023,0,0,4,4,9,4,10,23,3,2,0,5,2,1,13,16,1,2,0,3
162546,2023,Argentina,Serbia,1,6,9,16,4/7/2023,0,0,3,3,12,2,13,27,1,2,1,4,5,1,13,19,8,4,1,13
162546,2023,Japan,Argentina,1,3,12,16,24/06/2023,0,0,2,2,21,2,10,33,0,5,1,6,9,1,17,27,3,3,3,9
162546,2023,Argentina,Bulgaria,4,2,9,15,23/06/2023,0,0,2,2,12,2,7,21,1,3,1,5,4,1,21,26,5,3,0,8
162546,2023,Argentina,France,3,3,16,22,21/06/2023,0,1,2,3,13,4,11,28,0,4,1,5,4,0,8,12,6,3,0,9
162546,2023,Argentina,Slovenia,0,3,11,14,20/06/2023,0,0,0,0,16,4,7,27,2,0,3,5,10,1,13,24,10,2,1,13
162546,2023,Argentina,Netherlands,3,5,11,19,11/6/2023,0,0,6,6,9,4,3,16,2,2,0,4,1,2,9,12,8,0,0,8
162546,2023,Canada,Argentina,2,1,11,14,10/6/2023,0,0,2,2,4,3,8,15,0,2,0,2,5,0,10,15,4,5,0,9
162546,2023,Argentina,Brazil,0,4,12,16,9/6/2023,0,0,5,5,14,1,12,27,2,4,7,13,2,3,21,26,11,5,0,16
162546,2023,Italy,Argentina,2,3,9,14,6/6/2023,0,0,0,0,8,3,5,16,1,0,2,3,6,1,8,15,4,0,1,5
152692,2023,Italy,Argentina,1,0,10,11,19/07/2023,0,0,0,0,7,2,5,14,2,1,4,7,0,0,2,2,1,0,0,1
152692,2023,Argentina,Iran,0,5,14,19,9/7/2023,0,0,5,5,11,2,8,21,10,10,9,29,1,0,1,2,3,1,0,4
152692,2023,USA,Argentina,0,4,13,17,8/7/2023,0,0,0,0,9,2,5,16,6,3,8,17,2,0,1,3,0,1,3,4
152692,2023,Argentina,Germany,1,2,7,10,6/7/2023,0,0,5,5,6,0,0,6,6,3,0,9,0,1,3,4,2,1,0,3
152692,2023,Argentina,Serbia,1,1,15,17,4/7/2023,0,0,0,0,7,0,3,10,8,4,2,14,0,0,0,0,3,0,0,3
152692,2023,Japan,Argentina,2,2,17,21,24/06/2023,0,0,0,0,6,0,5,11,3,8,4,15,3,0,1,4,2,3,0,5
152692,2023,Argentina,Bulgaria,2,0,11,13,23/06/2023,0,0,1,1,8,2,1,11,6,4,2,12,0,0,0,0,1,1,0,2
152692,2023,Argentina,France,0,2,14,16,21/06/2023,0,0,0,0,11,0,4,15,5,9,1,15,0,0,0,0,5,1,0,6
152692,2023,Argentina,Slovenia,0,5,11,16,20/06/2023,0,0,0,0,10,1,4,15,0,7,4,11,1,0,1,2,2,1,0,3
152692,2023,Argentina,Netherlands,1,2,19,22,11/6/2023,0,0,1,1,7,1,0,8,1,4,4,9,1,0,3,4,5,1,1,7
152692,2023,Canada,Argentina,1,2,17,20,10/6/2023,0,0,0,0,8,0,5,13,2,1,2,5,1,0,0,1,2,0,0,2
152692,2023,Argentina,Brazil,1,3,16,20,9/6/2023,0,0,1,1,10,0,3,13,2,7,3,12,0,0,1,1,4,1,0,5
152692,2023,Italy,Argentina,2,3,9,14,6/6/2023,0,0,0,0,3,1,4,8,2,1,5,8,0,0,2,2,0,0,0,0
153053,2023,Italy,Argentina,0,0,0,0,19/07/2023,0,0,4,4,0,0,0,0,0,0,0,0,4,1,9,14,5,5,0,10
153053,2023,Argentina,Iran,0,0,0,0,9/7/2023,0,0,8,8,0,0,0,0,0,0,0,0,5,0,12,17,6,1,1,8
153053,2023,USA,Argentina,0,0,0,0,8/7/2023,0,0,4,4,0,0,0,0,0,0,0,0,9,2,15,26,8,7,1,16
153053,2023,Argentina,Germany,0,0,0,0,6/7/2023,0,0,0,0,0,0,0,0,0,0,0,0,3,0,10,13,7,4,1,12
153053,2023,Argentina,Serbia,0,0,0,0,4/7/2023,0,0,6,6,0,0,0,0,0,0,0,0,9,1,14,24,7,4,2,13
153053,2023,Japan,Argentina,0,0,0,0,24/06/2023,0,0,6,6,0,0,0,0,0,0,0,0,5,0,17,22,8,6,3,17
153053,2023,Argentina,Bulgaria,0,0,0,0,23/06/2023,0,0,6,6,0,0,0,0,0,0,0,0,2,1,7,10,13,3,1,17
153053,2023,Argentina,France,0,0,0,0,21/06/2023,0,0,7,7,0,0,0,0,0,0,0,0,8,0,10,18,11,1,0,12
153053,2023,Argentina,Slovenia,0,0,0,0,20/06/2023,0,0,2,2,0,0,0,0,0,0,0,0,10,1,9,20,11,3,0,14
153053,2023,Argentina,Netherlands,0,0,0,0,11/6/2023,0,0,10,10,0,0,0,0,0,0,0,0,3,2,24,29,9,7,0,16
153053,2023,Canada,Argentina,0,0,0,0,10/6/2023,0,0,9,9,0,0,0,0,0,0,0,0,11,0,13,24,13,9,2,24
153053,2023,Argentina,Brazil,0,0,0,0,9/6/2023,0,0,4,4,0,0,0,0,0,0,0,0,5,0,10,15,9,8,1,18
153053,2023,Italy,Argentina,0,0,0,0,6/6/2023,0,0,4,4,0,0,0,0,0,0,0,0,6,1,10,17,6,5,2,13
160816,2023,Italy,Argentina,0,1,0,1,19/07/2023,0,0,0,0,1,0,0,1,0,0,0,0,0,0,0,0,0,0,0,0
160816,2023,Argentina,Iran,0,0,0,0,9/7/2023,0,0,0,0,0,0,0,0,0,0,0,0,0,0,0,0,0,0,0,0
160816,2023,USA,Argentina,0,0,0,0,8/7/2023,0,0,0,0,0,0,0,0,0,0,0,0,0,0,0,0,0,0,0,0
160816,2023,Argentina,Germany,0,0,0,0,6/7/2023,0,0,0,0,0,0,0,0,0,0,0,0,0,0,0,0,0,0,0,0
160816,2023,Argentina,Serbia,0,0,0,0,4/7/2023,0,0,0,0,0,0,0,0,0,0,0,0,0,0,0,0,0,0,0,0
160816,2023,Japan,Argentina,0,0,0,0,24/06/2023,0,0,0,0,0,0,0,0,0,0,0,0,0,0,0,0,0,0,0,0
160816,2023,Argentina,Bulgaria,0,0,0,0,23/06/2023,0,0,0,0,0,0,0,0,0,0,0,0,0,0,0,0,0,0,0,0
160816,2023,Argentina,France,0,0,0,0,21/06/2023,0,0,0,0,0,0,0,0,0,0,0,0,0,0,0,0,0,0,0,0
160816,2023,Argentina,Slovenia,0,0,0,0,20/06/2023,0,0,0,0,0,0,0,0,0,0,0,0,0,0,0,0,0,0,0,0
160816,2023,Argentina,Netherlands,0,0,0,0,11/6/2023,0,0,0,0,0,0,0,0,0,0,0,0,0,0,0,0,0,0,0,0
160816,2023,Canada,Argentina,0,0,0,0,10/6/2023,0,0,0,0,0,0,0,0,0,0,0,0,0,0,0,0,0,0,0,0
160816,2023,Argentina,Brazil,0,0,0,0,9/6/2023,0,0,0,0,0,0,0,0,0,0,0,0,0,0,0,0,0,0,0,0
160816,2023,Italy,Argentina,0,0,0,0,6/6/2023,0,0,0,0,0,0,0,0,0,0,0,0,0,0,0,0,0,0,0,0
174853,2023,Italy,Argentina,1,0,2,3,19/07/2023,0,0,0,0,1,3,3,7,0,1,0,1,1,0,6,7,0,0,1,1
174853,2023,Argentina,Iran,2,1,1,4,9/7/2023,0,0,0,0,2,1,0,3,0,0,1,1,0,0,3,3,0,0,0,0
174853,2023,USA,Argentina,0,1,3,4,8/7/2023,0,0,2,2,1,1,1,3,0,1,0,1,0,0,2,2,0,0,0,0
174853,2023,Argentina,Germany,0,0,0,0,6/7/2023,0,0,0,0,0,0,0,0,0,0,0,0,0,0,0,0,0,0,0,0
174853,2023,Argentina,Serbia,0,0,3,3,4/7/2023,0,0,3,3,4,0,2,6,1,0,0,1,1,0,3,4,0,0,0,0
174853,2023,Japan,Argentina,0,0,0,0,24/06/2023,0,0,0,0,0,0,0,0,0,0,0,0,0,0,0,0,0,0,0,0
174853,2023,Argentina,Bulgaria,0,0,0,0,23/06/2023,0,0,0,0,0,0,0,0,0,0,0,0,0,0,0,0,0,0,0,0
174853,2023,Argentina,France,0,1,2,3,21/06/2023,0,0,0,0,0,0,0,0,0,0,0,0,0,0,0,0,0,0,0,0
174853,2023,Argentina,Slovenia,0,0,0,0,20/06/2023,0,0,0,0,0,0,0,0,0,0,0,0,0,0,0,0,0,0,0,0
174853,2023,Argentina,Netherlands,0,0,1,1,11/6/2023,0,0,1,1,1,1,0,2,0,0,0,0,0,0,0,0,0,0,0,0
174853,2023,Canada,Argentina,0,0,0,0,10/6/2023,0,0,0,0,0,0,0,0,0,0,0,0,0,0,0,0,0,0,0,0
174853,2023,Argentina,Brazil,0,0,1,1,9/6/2023,0,0,0,0,1,0,0,1,0,0,0,0,0,0,3,3,0,2,1,3
174853,2023,Italy,Argentina,0,0,0,0,6/6/2023,0,0,0,0,0,0,0,0,0,0,0,0,0,0,0,0,0,0,0,0
142415,2023,Italy,Argentina,0,0,0,0,19/07/2023,0,0,0,0,0,0,0,0,0,0,0,0,0,0,0,0,0,0,0,0
142415,2023,Argentina,Iran,1,0,3,4,9/7/2023,0,0,0,0,1,0,2,3,0,0,1,1,0,0,0,0,2,0,0,2
142415,2023,USA,Argentina,0,4,11,15,8/7/2023,0,0,1,1,13,3,8,24,1,3,1,5,0,0,0,0,2,1,1,4
142415,2023,Argentina,Germany,2,2,11,15,6/7/2023,0,0,2,2,8,3,5,16,0,3,4,7,0,0,0,0,4,1,0,5
142415,2023,Argentina,Serbia,1,3,14,18,4/7/2023,0,0,1,1,16,3,5,24,1,6,6,13,0,0,1,1,3,1,0,4
142415,2023,Japan,Argentina,0,0,6,6,24/06/2023,0,0,2,2,11,2,7,20,1,3,0,4,0,0,3,3,1,1,0,2
142415,2023,Argentina,Bulgaria,1,3,8,12,23/06/2023,0,2,0,2,7,2,6,15,0,3,4,7,0,0,0,0,4,1,1,6
142415,2023,Argentina,France,0,3,2,5,21/06/2023,0,0,0,0,6,3,6,15,0,1,1,2,0,0,0,0,1,1,1,3
142415,2023,Argentina,Slovenia,2,4,10,16,20/06/2023,0,0,1,1,14,6,11,31,0,3,2,5,0,0,0,0,3,1,0,4
142415,2023,Argentina,Netherlands,0,2,1,3,11/6/2023,0,0,0,0,2,2,4,8,2,1,2,5,0,0,0,0,0,2,1,3
142415,2023,Canada,Argentina,0,2,7,9,10/6/2023,0,0,2,2,6,0,3,9,0,2,0,2,0,0,0,0,2,0,0,2
142415,2023,Argentina,Brazil,0,3,15,18,9/6/2023,0,0,2,2,18,10,11,39,2,4,4,10,2,0,0,2,5,7,0,12
142415,2023,Italy,Argentina,0,2,11,13,6/6/2023,0,0,0,0,17,0,5,22,0,0,0,0,0,0,1,1,3,0,0,3
117457,2023,Italy,Argentina,0,0,6,6,19/07/2023,19,0,36,55,0,0,0,0,0,0,0,0,0,0,0,0,3,5,0,8
117457,2023,Argentina,Iran,0,1,25,26,9/7/2023,37,0,70,107,2,0,0,2,1,2,3,6,0,0,0,0,14,3,1,18
117457,2023,USA,Argentina,0,2,17,19,8/7/2023,37,1,80,118,0,0,2,2,0,5,4,9,0,0,0,0,7,0,0,7
117457,2023,Argentina,Germany,1,0,15,16,6/7/2023,23,0,27,50,1,0,0,1,1,1,0,2,0,0,0,0,4,2,2,8
117457,2023,Argentina,Serbia,0,1,14,15,4/7/2023,39,0,41,80,0,0,1,1,0,2,2,4,0,1,0,1,8,2,0,10
117457,2023,Argentina,Netherlands,1,0,10,11,11/6/2023,24,3,78,105,1,1,1,3,1,4,4,9,0,0,0,0,7,3,1,11
117457,2023,Canada,Argentina,0,1,8,9,10/6/2023,16,0,84,100,2,0,0,2,0,2,1,3,0,0,0,0,5,2,1,8
117457,2023,Argentina,Brazil,2,1,13,16,9/6/2023,28,0,79,107,1,0,1,2,1,3,1,5,0,0,0,0,6,3,0,9
117457,2023,Italy,Argentina,0,2,12,14,6/6/2023,19,0,46,65,0,0,1,1,1,1,1,3,0,0,1,1,3,0,2,5
141282,2023,Italy,Argentina,0,1,5,6,19/07/2023,0,0,1,1,5,6,12,23,1,2,1,4,0,0,0,0,0,0,0,0
141282,2023,Argentina,Iran,0,3,8,11,9/7/2023,0,0,1,1,8,9,5,22,1,2,1,4,0,0,0,0,2,0,0,2
141282,2023,USA,Argentina,1,0,7,8,8/7/2023,0,0,1,1,12,4,11,27,1,0,0,1,1,0,0,1,2,0,1,3
141282,2023,Argentina,Germany,1,0,3,4,6/7/2023,0,0,0,0,2,2,3,7,0,1,0,1,0,0,0,0,0,0,0,0
141282,2023,Argentina,Serbia,0,0,1,1,4/7/2023,0,0,0,0,0,0,1,1,0,0,0,0,0,0,0,0,0,0,0,0
141282,2023,Japan,Argentina,0,2,6,8,24/06/2023,0,0,0,0,7,0,6,13,0,0,2,2,2,1,1,4,2,2,0,4
141282,2023,Argentina,Bulgaria,0,1,4,5,23/06/2023,0,0,0,0,2,1,1,4,0,1,0,1,0,0,0,0,0,0,0,0
141282,2023,Argentina,France,0,2,5,7,21/06/2023,0,0,0,0,8,2,11,21,1,1,3,5,1,0,0,1,2,0,0,2
141282,2023,Argentina,Slovenia,0,0,3,3,20/06/2023,0,0,0,0,2,2,2,6,0,0,0,0,0,0,0,0,1,0,0,1
141282,2023,Argentina,Netherlands,1,3,17,21,11/6/2023,0,0,1,1,24,1,12,37,0,4,2,6,0,0,0,0,7,1,1,9
141282,2023,Canada,Argentina,0,1,8,9,10/6/2023,0,1,1,2,9,3,11,23,2,1,2,5,1,0,0,1,9,1,1,11
141282,2023,Argentina,Brazil,0,1,0,1,9/6/2023,0,0,0,0,1,0,2,3,0,0,0,0,0,0,0,0,1,0,0,1
141282,2023,Italy,Argentina,0,0,0,0,6/6/2023,0,0,0,0,1,0,0,1,0,0,0,0,0,0,0,0,0,0,0,0
163555,2023,Italy,Argentina,0,1,2,3,19/07/2023,0,0,2,2,3,3,7,13,0,3,1,4,2,2,10,14,3,0,0,3
163555,2023,Argentina,Iran,0,4,4,8,9/7/2023,0,0,3,3,14,6,5,25,0,5,6,11,2,1,20,23,8,1,1,10
163555,2023,USA,Argentina,0,3,4,7,8/7/2023,0,0,1,1,5,3,10,18,3,0,3,6,5,3,10,18,4,2,3,9
163555,2023,Argentina,Germany,0,3,2,5,6/7/2023,0,0,2,2,7,4,5,16,0,1,1,2,4,0,7,11,5,0,0,5
163555,2023,Argentina,Serbia,2,2,5,9,4/7/2023,0,0,1,1,5,6,7,18,1,3,2,6,5,2,7,14,4,3,0,7
163555,2023,Japan,Argentina,0,9,15,24,24/06/2023,0,0,2,2,15,3,11,29,0,1,1,2,8,1,23,32,2,6,1,9
163555,2023,Argentina,Bulgaria,0,2,9,11,23/06/2023,0,0,0,0,9,2,9,20,0,3,4,7,2,0,9,11,5,3,1,9
163555,2023,Argentina,France,1,4,13,18,21/06/2023,0,0,2,2,7,3,7,17,1,2,2,5,7,2,29,38,6,1,0,7
163555,2023,Argentina,Slovenia,0,5,2,7,20/06/2023,0,0,1,1,5,2,10,17,0,0,3,3,6,2,10,18,5,1,1,7
163555,2023,Argentina,Netherlands,2,5,16,23,11/6/2023,0,0,1,1,10,8,16,34,4,3,2,9,7,3,22,32,9,4,3,16
163555,2023,Canada,Argentina,0,5,10,15,10/6/2023,0,0,2,2,15,2,20,37,4,5,5,14,4,2,15,21,7,2,1,10
163555,2023,Argentina,Brazil,1,4,4,9,9/6/2023,0,0,3,3,8,2,13,23,0,4,0,4,1,4,25,30,8,4,0,12
163555,2023,Italy,Argentina,0,5,6,11,6/6/2023,0,0,0,0,9,3,11,23,2,0,2,4,3,0,12,15,6,1,0,7
125047,2023,Italy,Argentina,0,1,4,5,19/07/2023,0,0,1,1,2,0,2,4,1,4,3,8,0,1,1,2,0,2,0,2
125047,2023,Argentina,Iran,0,0,10,10,9/7/2023,0,0,0,0,3,0,0,3,0,1,2,3,0,0,1,1,1,0,1,2
125047,2023,USA,Argentina,0,0,0,0,8/7/2023,0,0,0,0,0,0,0,0,0,0,0,0,0,0,0,0,0,0,0,0
125047,2023,Argentina,Germany,0,0,0,0,6/7/2023,0,0,0,0,0,0,0,0,0,0,0,0,0,0,0,0,0,0,0,0
125047,2023,Argentina,Serbia,0,0,0,0,4/7/2023,0,0,0,0,0,0,0,0,0,0,0,0,0,0,0,0,0,0,0,0
125047,2023,Japan,Argentina,0,1,11,12,24/06/2023,0,0,1,1,6,0,0,6,2,4,3,9,0,0,0,0,1,0,0,1
125047,2023,Argentina,Bulgaria,0,0,0,0,23/06/2023,0,0,0,0,0,0,0,0,0,0,0,0,0,0,0,0,0,0,0,0
125047,2023,Argentina,France,0,0,0,0,21/06/2023,0,0,0,0,0,0,0,0,0,0,0,0,0,0,0,0,0,0,0,0
125047,2023,Argentina,Slovenia,0,0,3,3,20/06/2023,0,0,0,0,0,0,0,0,0,0,0,0,0,0,0,0,0,1,0,1
125047,2023,Argentina,Netherlands,0,2,16,18,11/6/2023,0,0,2,2,7,0,10,17,5,4,3,12,0,0,2,2,3,1,2,6
125047,2023,Canada,Argentina,0,0,0,0,10/6/2023,0,0,0,0,0,0,0,0,0,0,0,0,0,0,0,0,0,0,0,0
125047,2023,Argentina,Brazil,0,0,0,0,9/6/2023,0,0,0,0,0,0,0,0,0,0,0,0,0,0,0,0,0,0,0,0
125047,2023,Italy,Argentina,0,0,0,0,6/6/2023,0,0,0,0,0,0,0,0,0,0,0,0,0,0,0,0,0,0,0,0
162543,2023,Italy,Argentina,0,0,0,0,19/07/2023,0,0,0,0,0,0,0,0,0,0,0,0,0,0,0,0,0,0,0,0
162543,2023,Argentina,Iran,1,3,7,11,9/7/2023,0,0,0,0,3,0,2,5,1,1,5,7,0,0,0,0,1,1,0,2
162543,2023,USA,Argentina,1,2,21,24,8/7/2023,0,0,0,0,12,0,6,18,1,6,10,17,1,0,0,1,0,2,1,3
162543,2023,Argentina,Germany,0,1,7,8,6/7/2023,0,0,2,2,3,0,4,7,1,1,5,7,0,0,0,0,2,0,0,2
162543,2023,Argentina,Serbia,0,2,12,14,4/7/2023,0,0,2,2,3,1,7,11,4,5,3,12,0,0,2,2,1,1,0,2
162543,2023,Japan,Argentina,1,1,5,7,24/06/2023,0,0,1,1,1,0,2,3,1,3,4,8,1,0,1,2,0,1,0,1
162543,2023,Argentina,Bulgaria,0,0,7,7,23/06/2023,0,0,1,1,4,1,2,7,0,2,7,9,0,0,0,0,1,1,0,2
162543,2023,Argentina,France,0,1,10,11,21/06/2023,0,0,1,1,6,1,4,11,0,10,4,14,1,0,0,1,2,1,1,4
162543,2023,Argentina,Slovenia,0,1,12,13,20/06/2023,0,0,0,0,7,1,2,10,1,2,3,6,0,0,2,2,6,2,0,8
162543,2023,Argentina,Netherlands,0,0,0,0,11/6/2023,0,0,0,0,0,0,0,0,0,0,0,0,0,0,0,0,0,0,0,0
162543,2023,Canada,Argentina,0,0,0,0,10/6/2023,0,0,0,0,0,0,0,0,0,0,0,0,0,0,0,0,0,0,0,0
162543,2023,Argentina,Brazil,0,0,0,0,9/6/2023,0,0,0,0,0,0,0,0,0,0,0,0,0,0,0,0,0,0,0,0
162543,2023,Italy,Argentina,0,2,2,4,6/6/2023,0,0,0,0,1,0,2,3,0,1,5,6,0,0,0,0,1,0,0,1
116099,2023,Poland,Brazil,0,0,5,5,20/07/2023,9,0,25,34,0,0,0,0,0,1,0,1,0,0,0,0,1,2,0,3
116099,2023,Brazil,China,0,0,13,13,8/7/2023,12,1,42,55,0,0,0,0,0,3,5,8,0,0,0,0,4,2,2,8
116099,2023,Poland,Brazil,0,0,11,11,7/7/2023,17,0,51,68,2,0,0,2,0,4,1,5,0,0,0,0,7,2,2,11
116099,2023,Brazil,Netherlands,0,0,12,12,6/7/2023,11,1,40,52,1,0,1,2,0,2,2,4,0,0,0,0,4,1,0,5
116099,2023,Brazil,Italy,0,0,8,8,4/7/2023,22,0,64,86,1,0,2,3,0,1,6,7,0,0,1,1,3,3,2,8
116099,2023,Brazil,France,0,3,14,17,25/06/2023,28,1,60,89,0,0,0,0,1,0,2,3,0,0,1,1,3,6,2,11
116099,2023,Brazil,Slovenia,1,2,13,16,24/06/2023,30,0,69,99,1,0,1,2,1,2,3,6,0,0,0,0,7,3,2,12
116099,2023,Japan,Brazil,0,1,2,3,22/06/2023,8,0,16,24,0,0,0,0,1,2,0,3,0,0,0,0,1,2,0,3
116099,2023,Brazil,Bulgaria,0,1,6,7,20/06/2023,17,0,36,53,0,0,0,0,2,1,3,6,0,0,0,0,3,1,0,4
116099,2023,USA,Brazil,2,2,20,24,11/6/2023,22,0,62,84,0,0,0,0,1,3,5,9,0,0,0,0,2,3,1,6
116099,2023,Brazil,Cuba,0,2,14,16,10/6/2023,33,1,57,91,0,0,0,0,0,2,3,5,0,0,0,0,4,3,0,7
116099,2023,Argentina,Brazil,1,1,7,9,9/6/2023,12,1,51,64,0,0,1,1,0,1,1,2,0,0,0,0,6,3,0,9
116099,2023,Brazil,Germany,0,1,19,20,8/6/2023,18,1,47,66,0,0,1,1,0,4,0,4,0,0,1,1,8,5,1,14
125010,2023,Poland,Brazil,0,2,0,2,20/07/2023,0,0,0,0,0,0,0,0,0,1,1,2,0,0,0,0,0,0,0,0
125010,2023,Brazil,China,2,2,11,15,8/7/2023,0,0,1,1,8,0,0,8,2,1,3,6,0,0,0,0,1,0,0,1
125010,2023,Poland,Brazil,0,1,0,1,7/7/2023,0,0,0,0,0,0,0,0,0,0,0,0,0,0,0,0,0,0,0,0
125010,2023,Brazil,Netherlands,0,0,0,0,6/7/2023,0,0,0,0,0,0,0,0,0,0,0,0,0,0,0,0,0,0,0,0
125010,2023,Brazil,Italy,0,2,2,4,4/7/2023,0,0,0,0,1,0,2,3,0,0,1,1,0,0,0,0,2,0,0,2
125010,2023,Brazil,France,1,4,12,17,25/06/2023,0,0,0,0,4,1,0,5,0,5,5,10,0,0,0,0,2,0,0,2
125010,2023,Brazil,Slovenia,1,4,12,17,24/06/2023,0,0,0,0,8,0,1,9,1,4,2,7,0,0,1,1,2,2,0,4
125010,2023,Japan,Brazil,0,2,5,7,22/06/2023,0,0,1,1,3,0,2,5,2,3,2,7,0,0,0,0,0,0,0,0
125010,2023,Brazil,Bulgaria,0,1,4,5,20/06/2023,0,0,1,1,1,0,0,1,0,1,0,1,0,0,0,0,1,0,0,1
125010,2023,USA,Brazil,0,1,5,6,11/6/2023,0,0,0,0,2,1,3,6,0,3,1,4,0,0,1,1,0,0,0,0
125010,2023,Brazil,Cuba,0,5,11,16,10/6/2023,0,0,0,0,8,2,3,13,3,3,5,11,0,0,1,1,1,1,0,2
125010,2023,Argentina,Brazil,2,4,15,21,9/6/2023,0,0,0,0,5,1,4,10,3,4,10,17,0,0,1,1,5,1,0,6
125010,2023,Brazil,Germany,2,2,10,14,8/6/2023,0,0,0,0,7,0,3,10,2,4,8,14,0,0,1,1,1,2,1,4
174908,2023,Poland,Brazil,0,0,0,0,20/07/2023,0,0,0,0,0,0,0,0,0,0,0,0,0,0,0,0,0,0,0,0
174908,2023,Brazil,China,0,0,15,15,8/7/2023,0,0,1,1,7,2,4,13,0,2,5,7,1,2,14,17,3,0,2,5
174908,2023,Poland,Brazil,0,0,1,1,7/7/2023,0,0,0,0,0,1,0,1,1,1,0,2,1,0,1,2,0,0,0,0
174908,2023,Brazil,Netherlands,0,1,0,1,6/7/2023,0,0,0,0,1,0,1,2,0,2,0,2,0,0,2,2,1,0,0,1
174908,2023,Brazil,Italy,0,0,1,1,4/7/2023,0,0,0,0,0,0,1,1,0,0,0,0,1,1,3,5,0,0,0,0
174908,2023,Brazil,France,0,0,11,11,25/06/2023,0,0,2,2,11,1,4,16,0,2,1,3,2,2,19,23,3,2,0,5
174908,2023,Brazil,Slovenia,0,0,1,1,24/06/2023,0,0,1,1,1,1,2,4,0,1,0,1,1,0,3,4,0,0,0,0
174908,2023,Japan,Brazil,0,1,0,1,22/06/2023,0,0,0,0,0,1,2,3,0,1,0,1,0,0,1,1,0,0,0,0
174908,2023,Brazil,Bulgaria,0,0,0,0,20/06/2023,0,0,0,0,0,0,0,0,0,0,0,0,0,0,0,0,1,0,0,1
174908,2023,USA,Brazil,0,0,0,0,11/6/2023,0,0,0,0,0,0,0,0,0,0,0,0,0,0,0,0,0,0,0,0
174908,2023,Brazil,Cuba,0,0,1,1,10/6/2023,0,0,0,0,1,0,2,3,0,0,1,1,2,0,4,6,0,0,1,1
174908,2023,Argentina,Brazil,0,0,1,1,9/6/2023,0,0,1,1,3,4,6,13,1,2,0,3,0,0,5,5,0,2,0,2
174908,2023,Brazil,Germany,1,1,13,15,8/6/2023,0,0,5,5,6,3,8,17,1,3,0,4,3,0,11,14,3,3,1,7
161930,2023,Poland,Brazil,0,0,6,6,20/07/2023,0,0,2,2,4,4,5,13,2,1,1,4,4,3,10,17,4,1,1,6
161930,2023,Brazil,China,0,0,0,0,8/7/2023,0,0,2,2,0,0,0,0,1,0,0,1,0,0,0,0,1,0,0,1
161930,2023,Poland,Brazil,0,3,14,17,7/7/2023,0,1,3,4,8,2,9,19,1,4,2,7,1,1,13,15,5,4,0,9
161930,2023,Brazil,Netherlands,1,3,7,11,6/7/2023,0,0,1,1,7,1,5,13,2,4,0,6,2,0,13,15,3,3,0,6
161930,2023,Brazil,Italy,1,4,8,13,4/7/2023,0,0,4,4,14,7,15,36,0,5,4,9,2,3,8,13,1,4,1,6
161930,2023,Brazil,France,0,1,3,4,25/06/2023,0,0,2,2,0,0,2,2,1,1,0,2,0,0,2,2,1,0,0,1
161930,2023,Brazil,Slovenia,0,6,9,15,24/06/2023,0,0,5,5,6,1,10,17,2,4,1,7,2,0,18,20,4,0,0,4
161930,2023,Japan,Brazil,1,3,16,20,22/06/2023,0,0,4,4,11,2,8,21,4,3,3,10,8,3,13,24,3,2,0,5
161930,2023,Brazil,Bulgaria,0,2,8,10,20/06/2023,0,0,1,1,5,2,5,12,0,1,3,4,3,0,3,6,3,1,0,4
161930,2023,USA,Brazil,1,2,12,15,11/6/2023,0,0,2,2,4,5,7,16,2,5,0,7,3,1,10,14,4,0,0,4
161930,2023,Brazil,Cuba,0,5,11,16,10/6/2023,0,0,4,4,8,5,3,16,0,4,2,6,10,0,18,28,7,3,2,12
161930,2023,Argentina,Brazil,1,2,10,13,9/6/2023,0,0,2,2,10,2,6,18,0,1,0,1,4,1,23,28,6,2,0,8
161930,2023,Brazil,Germany,0,1,1,2,8/6/2023,0,0,0,0,0,0,0,0,0,0,0,0,0,0,0,0,0,0,0,0
118928,2023,Poland,Brazil,0,2,1,3,20/07/2023,0,0,0,0,2,0,2,4,0,1,0,1,0,1,9,10,0,0,0,0
142744,2023,Poland,Brazil,0,0,3,3,20/07/2023,9,0,29,38,0,0,0,0,0,0,2,2,0,0,0,0,3,2,2,7
142744,2023,Brazil,China,0,0,0,0,8/7/2023,1,0,0,1,0,0,0,0,0,0,0,0,0,0,0,0,0,0,0,0
142744,2023,Poland,Brazil,0,1,3,4,7/7/2023,5,0,10,15,0,0,0,0,0,1,0,1,0,0,0,0,1,0,0,1
142744,2023,Brazil,Netherlands,0,0,3,3,6/7/2023,5,0,7,12,0,0,0,0,0,1,1,2,0,0,0,0,0,0,0,0
142744,2023,Brazil,Italy,0,0,4,4,4/7/2023,5,0,13,18,0,0,0,0,0,0,0,0,0,0,0,0,1,1,0,2
142744,2023,Brazil,France,0,0,0,0,25/06/2023,1,0,1,2,0,0,0,0,0,0,0,0,0,0,0,0,0,2,0,2
142744,2023,Brazil,Slovenia,0,0,0,0,24/06/2023,2,0,4,6,0,0,0,0,0,0,0,0,0,0,0,0,0,0,0,0
142744,2023,Japan,Brazil,0,0,12,12,22/06/2023,24,1,55,80,1,0,0,1,0,1,4,5,0,0,0,0,2,1,0,3
142744,2023,Brazil,Bulgaria,0,0,0,0,20/06/2023,0,0,0,0,0,0,0,0,0,0,0,0,0,0,0,0,2,1,0,3
142744,2023,USA,Brazil,0,0,0,0,11/6/2023,0,0,3,3,0,0,0,0,0,0,0,0,0,0,0,0,0,0,0,0
142744,2023,Brazil,Cuba,0,1,1,2,10/6/2023,14,0,10,24,0,0,0,0,0,0,1,1,0,0,0,0,0,0,0,0
142744,2023,Argentina,Brazil,0,1,10,11,9/6/2023,14,0,33,47,0,0,2,2,0,1,1,2,0,0,0,0,6,5,0,11
142744,2023,Brazil,Germany,0,0,2,2,8/6/2023,3,0,8,11,0,0,0,0,0,0,0,0,0,0,0,0,3,0,0,3
161939,2023,Poland,Brazil,0,0,0,0,20/07/2023,0,0,0,0,0,0,0,0,0,0,0,0,0,0,0,0,0,0,0,0
161939,2023,Brazil,China,0,0,0,0,8/7/2023,0,0,0,0,0,0,0,0,0,0,0,0,0,0,0,0,0,0,0,0
161939,2023,Poland,Brazil,0,0,0,0,7/7/2023,0,0,2,2,0,0,0,0,0,0,0,0,6,1,19,26,8,5,1,14
161939,2023,Brazil,Netherlands,0,0,0,0,6/7/2023,0,0,2,2,0,0,0,0,0,0,0,0,4,0,8,12,9,2,3,14
161939,2023,Brazil,Italy,0,0,0,0,4/7/2023,0,0,0,0,0,0,0,0,0,0,0,0,0,1,2,3,4,3,0,7
161939,2023,Brazil,France,0,0,0,0,25/06/2023,0,0,2,2,0,0,0,0,0,0,0,0,5,2,16,23,7,5,2,14
161939,2023,Brazil,Slovenia,0,0,0,0,24/06/2023,0,0,2,2,0,0,0,0,0,0,0,0,5,1,16,22,10,5,0,15
161939,2023,Japan,Brazil,0,0,0,0,22/06/2023,0,0,1,1,0,0,0,0,0,0,0,0,2,1,5,8,4,3,1,8
161939,2023,Brazil,Bulgaria,0,0,0,0,20/06/2023,0,0,0,0,0,0,0,0,0,0,0,0,0,0,0,0,0,0,0,0
161939,2023,USA,Brazil,0,0,0,0,11/6/2023,0,0,0,0,0,0,0,0,0,0,0,0,0,0,0,0,0,0,0,0
161939,2023,Brazil,Cuba,0,0,0,0,10/6/2023,0,0,3,3,0,0,0,0,0,0,0,0,6,2,23,31,11,7,1,19
161939,2023,Argentina,Brazil,0,0,0,0,9/6/2023,0,0,0,0,0,0,0,0,0,0,0,0,0,0,0,0,0,0,0,0
161939,2023,Brazil,Germany,0,0,0,0,8/6/2023,0,0,3,3,0,0,0,0,0,0,0,0,4,2,16,22,13,4,0,17
116081,2023,Poland,Brazil,2,4,9,15,20/07/2023,0,0,0,0,3,1,5,9,1,3,2,6,0,0,1,1,1,0,0,1
116081,2023,Brazil,China,0,0,0,0,8/7/2023,0,0,0,0,0,0,0,0,0,0,0,0,0,0,0,0,0,0,0,0
116081,2023,Poland,Brazil,2,3,11,16,7/7/2023,0,0,0,0,6,0,2,8,1,5,6,12,0,0,0,0,0,1,0,1
116081,2023,Brazil,Netherlands,0,1,5,6,6/7/2023,0,0,0,0,4,2,8,14,6,3,10,19,0,0,1,1,1,0,0,1
116081,2023,Brazil,Italy,0,3,7,10,4/7/2023,0,0,0,0,5,1,4,10,0,3,1,4,0,0,1,1,3,0,0,3
116081,2023,Brazil,France,0,2,12,14,25/06/2023,0,0,0,0,5,3,1,9,1,2,6,9,0,0,1,1,3,1,1,5
116081,2023,Brazil,Slovenia,0,0,0,0,24/06/2023,0,0,0,0,0,0,0,0,0,0,0,0,0,0,0,0,0,0,0,0
116081,2023,Japan,Brazil,0,2,4,6,22/06/2023,0,0,0,0,5,0,4,9,0,4,3,7,0,0,0,0,1,1,1,3
116081,2023,Brazil,Bulgaria,1,4,3,8,20/06/2023,0,0,0,0,4,0,2,6,0,3,4,7,0,0,0,0,1,0,0,1
118916,2023,Poland,Brazil,0,0,0,0,20/07/2023,0,0,3,3,0,0,0,0,0,0,0,0,2,2,7,11,6,3,0,9
118916,2023,Brazil,China,0,0,0,0,8/7/2023,0,0,3,3,0,0,0,0,0,0,0,0,2,0,7,9,9,2,0,11
118916,2023,Poland,Brazil,0,0,0,0,7/7/2023,0,0,0,0,0,0,0,0,0,0,0,0,0,0,0,0,0,0,0,0
118916,2023,Brazil,Netherlands,0,0,0,0,6/7/2023,0,0,0,0,0,0,0,0,0,0,0,0,0,0,0,0,0,0,0,0
118916,2023,Brazil,Italy,0,0,0,0,4/7/2023,0,0,3,3,0,0,0,0,0,0,0,0,3,0,13,16,9,3,0,12
118916,2023,Brazil,France,0,0,0,0,25/06/2023,0,0,0,0,0,0,0,0,0,0,0,0,0,0,0,0,0,0,0,0
118916,2023,Brazil,Slovenia,0,0,0,0,24/06/2023,0,0,0,0,0,0,0,0,0,0,0,0,0,0,0,0,0,0,0,0
118916,2023,Japan,Brazil,0,0,0,0,22/06/2023,0,0,1,1,0,0,0,0,0,0,0,0,4,0,4,8,7,2,0,9
118916,2023,Brazil,Bulgaria,0,0,0,0,20/06/2023,0,0,2,2,0,0,0,0,0,0,0,0,1,1,10,12,3,4,2,9
118916,2023,USA,Brazil,0,0,0,0,11/6/2023,0,0,1,1,0,0,0,0,0,0,0,0,4,1,13,18,13,3,1,17
118916,2023,Brazil,Cuba,0,0,0,0,10/6/2023,0,0,0,0,0,0,0,0,0,0,0,0,0,0,0,0,0,0,0,0
118916,2023,Argentina,Brazil,0,0,0,0,9/6/2023,0,0,9,9,0,0,0,0,0,0,0,0,5,1,16,22,8,5,2,15
118916,2023,Brazil,Germany,0,0,0,0,8/6/2023,0,0,0,0,0,0,0,0,0,0,0,0,0,0,1,1,0,0,0,0
136468,2023,Poland,Brazil,2,1,7,10,20/07/2023,0,0,5,5,7,4,9,20,1,2,3,6,2,3,16,21,3,3,0,6
136468,2023,Brazil,China,0,2,7,9,8/7/2023,0,0,2,2,6,2,6,14,2,1,3,6,2,1,6,9,4,0,0,4
136468,2023,Poland,Brazil,2,5,11,18,7/7/2023,1,1,3,5,12,7,5,24,0,0,3,3,5,1,20,26,3,0,0,3
136468,2023,Brazil,Netherlands,2,2,12,16,6/7/2023,0,0,4,4,6,4,4,14,1,2,1,4,2,1,8,11,5,1,1,7
136468,2023,Brazil,Italy,2,1,12,15,4/7/2023,0,0,9,9,9,1,9,19,0,2,2,4,6,8,26,40,4,0,1,5
136468,2023,Brazil,France,3,4,12,19,25/06/2023,0,0,3,3,11,6,12,29,1,4,1,6,2,1,20,23,10,1,1,12
136468,2023,Brazil,Slovenia,1,3,11,15,24/06/2023,0,0,8,8,18,2,17,37,0,6,2,8,4,0,22,26,5,2,0,7
136468,2023,Japan,Brazil,1,2,20,23,22/06/2023,0,0,4,4,11,3,10,24,0,4,1,5,6,3,31,40,8,4,0,12
136468,2023,Brazil,Bulgaria,2,2,7,11,20/06/2023,0,0,5,5,10,1,3,14,0,1,0,1,7,0,14,21,1,1,2,4
136468,2023,USA,Brazil,1,4,11,16,11/6/2023,0,0,2,2,14,3,9,26,3,3,1,7,3,2,23,28,3,0,2,5
136468,2023,Brazil,Cuba,1,2,15,18,10/6/2023,0,1,4,5,19,7,12,38,0,4,3,7,2,2,18,22,6,8,1,15
136468,2023,Argentina,Brazil,0,3,16,19,9/6/2023,0,0,2,2,15,8,7,30,2,3,3,8,6,2,23,31,12,5,1,18
136468,2023,Brazil,Germany,2,1,15,18,8/6/2023,1,0,4,5,16,3,4,23,2,4,2,8,0,1,17,18,6,4,0,10
161921,2023,Poland,Brazil,0,0,1,1,20/07/2023,0,0,0,0,1,0,2,3,0,1,1,2,0,0,0,0,0,0,0,0
161921,2023,Brazil,China,1,1,9,11,8/7/2023,0,0,3,3,12,2,8,22,4,2,0,6,0,0,1,1,1,1,0,2
161921,2023,Poland,Brazil,0,0,2,2,7/7/2023,0,0,0,0,4,1,0,5,0,0,1,1,0,0,0,0,0,1,0,1
161921,2023,Brazil,Netherlands,0,1,1,2,6/7/2023,0,0,0,0,2,1,1,4,0,0,0,0,0,0,0,0,0,0,0,0
161921,2023,Brazil,Italy,0,1,6,7,4/7/2023,0,0,1,1,7,1,4,12,1,1,2,4,0,0,0,0,4,0,1,5
161921,2023,Brazil,France,0,0,0,0,25/06/2023,0,0,1,1,1,0,0,1,0,0,0,0,0,0,0,0,0,0,0,0
161921,2023,Brazil,Slovenia,0,0,0,0,24/06/2023,0,0,0,0,1,0,0,1,0,1,0,1,0,0,0,0,0,0,0,0
161921,2023,Japan,Brazil,0,0,2,2,22/06/2023,0,0,0,0,3,0,2,5,0,0,0,0,0,0,0,0,0,0,0,0
161921,2023,Brazil,Bulgaria,0,0,0,0,20/06/2023,0,0,1,1,1,0,0,1,1,0,2,3,0,0,0,0,0,0,0,0
136947,2023,Poland,Brazil,1,2,6,9,20/07/2023,0,0,2,2,14,5,10,29,0,2,3,5,0,0,1,1,3,2,0,5
136947,2023,Brazil,China,0,0,0,0,8/7/2023,0,0,0,0,0,0,0,0,0,0,0,0,0,0,0,0,0,0,0,0
136947,2023,Poland,Brazil,0,4,3,7,7/7/2023,0,0,2,2,15,3,11,29,2,4,2,8,0,0,0,0,3,1,1,5
136947,2023,Brazil,Netherlands,0,0,7,7,6/7/2023,0,0,1,1,8,3,5,16,1,1,4,6,0,0,0,0,7,2,0,9
136947,2023,Brazil,Italy,0,4,3,7,4/7/2023,0,0,1,1,9,5,8,22,0,2,5,7,0,0,0,0,4,2,0,6
136947,2023,Brazil,France,0,2,9,11,25/06/2023,0,0,1,1,23,6,10,39,1,5,6,12,0,0,1,1,5,2,1,8
136947,2023,Brazil,Slovenia,1,3,10,14,24/06/2023,0,0,1,1,18,7,12,37,0,4,3,7,0,0,0,0,7,5,1,13
136947,2023,Japan,Brazil,0,4,14,18,22/06/2023,0,0,2,2,20,2,10,32,0,5,2,7,0,0,2,2,9,5,0,14
136947,2023,Brazil,Bulgaria,2,3,11,16,20/06/2023,0,0,0,0,12,3,8,23,0,4,0,4,0,0,0,0,6,2,0,8
136947,2023,USA,Brazil,1,3,12,16,11/6/2023,0,0,2,2,15,2,13,30,1,2,1,4,0,0,0,0,5,2,0,7
136947,2023,Brazil,Cuba,0,0,0,0,10/6/2023,0,0,1,1,0,0,1,1,1,0,0,1,0,0,0,0,0,0,0,0
136947,2023,Argentina,Brazil,2,1,8,11,9/6/2023,0,0,3,3,10,2,8,20,1,6,7,14,0,0,0,0,3,4,0,7
136947,2023,Brazil,Germany,0,3,10,13,8/6/2023,0,0,3,3,18,2,10,30,1,3,10,14,0,0,0,0,2,5,0,7
136956,2023,Poland,Brazil,0,2,10,12,20/07/2023,0,0,0,0,4,1,2,7,1,1,4,6,0,0,2,2,1,0,1,2
136956,2023,Brazil,China,0,2,8,10,8/7/2023,0,0,1,1,5,1,2,8,1,8,8,17,0,0,4,4,2,0,0,2
136956,2023,Poland,Brazil,0,0,1,1,7/7/2023,0,0,1,1,0,1,0,1,0,1,0,1,0,0,0,0,0,0,0,0
136956,2023,Brazil,Netherlands,0,0,0,0,6/7/2023,0,0,0,0,0,0,0,0,0,0,0,0,0,0,0,0,0,0,0,0
136956,2023,Brazil,Italy,0,1,6,7,4/7/2023,0,1,1,2,8,1,2,11,2,3,7,12,1,0,4,5,1,2,0,3
136956,2023,Brazil,France,0,0,1,1,25/06/2023,0,0,1,1,1,0,0,1,2,0,0,2,0,0,0,0,0,0,0,0
136956,2023,Brazil,Slovenia,0,3,14,17,24/06/2023,0,0,1,1,10,0,1,11,2,4,2,8,1,0,2,3,1,1,0,2
136956,2023,Japan,Brazil,0,0,10,10,22/06/2023,0,0,0,0,5,0,4,9,3,3,5,11,0,0,0,0,0,1,1,2
136956,2023,Brazil,Bulgaria,1,1,15,17,20/06/2023,0,0,0,0,5,1,2,8,3,3,5,11,0,0,0,0,1,1,0,2
136956,2023,USA,Brazil,0,1,5,6,11/6/2023,0,0,0,0,3,0,2,5,1,3,2,6,0,0,0,0,0,1,0,1
136956,2023,Brazil,Cuba,0,0,14,14,10/6/2023,0,0,0,0,7,0,8,15,3,4,2,9,0,0,0,0,0,2,0,2
136956,2023,Argentina,Brazil,1,2,5,8,9/6/2023,0,0,0,0,6,2,2,10,0,5,6,11,0,0,0,0,2,2,0,4
136956,2023,Brazil,Germany,0,0,9,9,8/6/2023,0,0,0,0,2,0,3,5,4,7,5,16,0,1,2,3,2,4,0,6
187493,2023,Poland,Brazil,0,0,0,0,20/07/2023,0,0,0,0,0,0,0,0,0,0,0,0,0,0,0,0,0,0,0,0
187493,2023,Brazil,China,0,0,0,0,8/7/2023,0,0,0,0,0,0,0,0,0,0,0,0,0,0,0,0,0,0,0,0
187493,2023,Poland,Brazil,0,4,8,12,7/7/2023,0,0,1,1,5,2,4,11,2,5,3,10,2,0,2,4,0,2,0,2
187493,2023,Brazil,Netherlands,0,2,9,11,6/7/2023,0,0,1,1,5,0,0,5,1,4,3,8,0,0,0,0,2,1,0,3
187493,2023,Brazil,Italy,0,1,5,6,4/7/2023,0,0,0,0,5,0,1,6,1,1,0,2,2,0,0,2,1,1,0,2
187493,2023,Brazil,France,0,0,0,0,25/06/2023,0,0,0,0,0,0,0,0,0,0,0,0,0,0,0,0,0,0,0,0
187493,2023,Brazil,Slovenia,0,2,1,3,24/06/2023,0,0,0,0,3,0,2,5,0,2,2,4,0,0,0,0,2,0,0,2
187493,2023,Japan,Brazil,0,3,7,10,22/06/2023,0,0,0,0,8,0,4,12,1,5,5,11,1,0,1,2,1,0,0,1
187493,2023,Brazil,Bulgaria,0,0,0,0,20/06/2023,0,0,0,0,0,0,0,0,0,0,0,0,0,0,0,0,0,0,0,0
187493,2023,USA,Brazil,0,1,11,12,11/6/2023,0,0,0,0,12,0,0,12,1,3,6,10,0,0,0,0,3,0,0,3
187493,2023,Brazil,Cuba,0,0,4,4,10/6/2023,0,0,0,0,0,1,0,1,0,1,0,1,0,0,0,0,0,0,0,0
187493,2023,Argentina,Brazil,0,1,4,5,9/6/2023,0,0,0,0,7,1,2,10,0,1,3,4,0,0,0,0,1,1,0,2
187493,2023,Brazil,Germany,0,0,0,0,8/6/2023,0,0,0,0,0,0,0,0,0,0,0,0,0,0,0,0,0,0,0,0
173067,2023,USA,Bulgaria,0,1,4,5,10/7/2023,0,1,2,3,4,1,0,5,0,2,4,6,0,0,0,0,1,0,0,1
173067,2023,Bulgaria,Serbia,0,0,7,7,8/7/2023,0,0,1,1,6,0,1,7,2,1,5,8,0,0,0,0,0,0,0,0
173067,2023,Bulgaria,Iran,0,5,7,12,7/7/2023,0,0,0,0,6,0,2,8,3,4,5,12,0,0,0,0,2,0,0,2
173067,2023,Germany,Bulgaria,0,2,5,7,6/7/2023,0,0,1,1,5,0,3,8,0,4,9,13,0,0,0,0,1,1,0,2
173067,2023,Bulgaria,Cuba,0,0,18,18,25/06/2023,0,0,2,2,8,1,2,11,2,5,2,9,0,0,0,0,1,2,0,3
173067,2023,Argentina,Bulgaria,0,0,0,0,23/06/2023,0,0,0,0,0,0,0,0,0,0,0,0,0,0,0,0,0,0,0,0
173067,2023,Canada,Bulgaria,1,2,4,7,22/06/2023,0,0,0,0,4,0,2,6,1,2,0,3,0,0,0,0,0,0,0,0
173067,2023,Brazil,Bulgaria,0,0,0,0,20/06/2023,0,0,0,0,0,0,0,0,0,0,0,0,0,0,0,0,0,0,0,0
173067,2023,Japan,Bulgaria,0,2,5,7,10/6/2023,0,0,1,1,4,0,5,9,0,4,3,7,0,0,0,0,2,0,0,2
173067,2023,Poland,Bulgaria,0,2,2,4,9/6/2023,0,0,0,0,1,1,2,4,0,3,3,6,0,0,0,0,0,0,0,0
173067,2023,Slovenia,Bulgaria,3,1,9,13,8/6/2023,0,0,0,0,3,1,2,6,0,1,5,6,0,0,0,0,3,0,0,3
173067,2023,Bulgaria,China,0,0,5,5,6/6/2023,0,0,0,0,0,1,0,1,1,0,0,1,0,0,0,0,0,0,0,0
156676,2023,USA,Bulgaria,0,3,6,9,10/7/2023,0,0,1,1,7,0,5,12,2,0,4,6,4,1,12,17,3,1,1,5
156676,2023,Bulgaria,Serbia,0,1,5,6,8/7/2023,0,0,2,2,4,1,4,9,0,4,0,4,1,1,8,10,2,2,0,4
156676,2023,Bulgaria,Iran,2,6,14,22,7/7/2023,0,0,5,5,15,8,5,28,1,2,2,5,7,3,19,29,1,1,1,3
156676,2023,Germany,Bulgaria,0,4,5,9,6/7/2023,0,0,1,1,11,1,5,17,1,1,0,2,5,0,13,18,6,2,0,8
156676,2023,Bulgaria,Cuba,1,7,14,22,25/06/2023,0,0,6,6,8,1,7,16,3,7,3,13,10,1,20,31,4,4,0,8
156676,2023,Argentina,Bulgaria,0,0,0,0,23/06/2023,0,0,0,0,0,0,0,0,0,0,0,0,0,0,1,1,0,1,0,1
156676,2023,Canada,Bulgaria,1,7,6,14,22/06/2023,0,0,3,3,12,5,9,26,0,6,0,6,5,0,11,16,5,4,0,9
156676,2023,Brazil,Bulgaria,0,2,4,6,20/06/2023,0,0,0,0,4,2,6,12,1,2,0,3,3,4,6,13,2,1,1,4
156676,2023,Japan,Bulgaria,1,3,6,10,10/6/2023,0,0,1,1,4,3,2,9,2,0,1,3,4,2,11,17,4,0,1,5
156676,2023,Poland,Bulgaria,1,5,6,12,9/6/2023,0,0,4,4,14,5,12,31,0,1,1,2,10,2,5,17,6,0,0,6
156676,2023,Slovenia,Bulgaria,0,4,5,9,8/6/2023,0,0,3,3,11,2,10,23,2,2,2,6,7,1,8,16,4,0,0,4
156676,2023,Bulgaria,China,2,4,7,13,6/6/2023,0,0,2,2,10,5,4,19,1,1,1,3,7,3,10,20,1,0,2,3
132035,2023,USA,Bulgaria,0,1,9,10,10/7/2023,1,0,0,1,4,0,3,7,3,1,4,8,0,0,0,0,0,0,0,0
132035,2023,Bulgaria,Serbia,0,0,0,0,8/7/2023,0,0,0,0,0,0,0,0,0,0,0,0,0,0,0,0,0,0,0,0
132035,2023,Bulgaria,Iran,0,0,0,0,7/7/2023,0,0,0,0,0,0,0,0,0,0,0,0,0,0,0,0,0,0,0,0
132035,2023,Germany,Bulgaria,0,0,0,0,6/7/2023,0,0,0,0,0,0,0,0,0,0,0,0,0,0,0,0,0,0,0,0
132035,2023,Bulgaria,Cuba,0,0,0,0,25/06/2023,0,0,0,0,0,0,0,0,0,0,0,0,0,0,0,0,0,0,0,0
132035,2023,Argentina,Bulgaria,0,0,4,4,23/06/2023,0,0,1,1,1,1,2,4,0,0,1,1,0,0,0,0,0,0,0,0
132035,2023,Canada,Bulgaria,0,0,9,9,22/06/2023,0,0,3,3,4,2,4,10,3,3,3,9,0,0,0,0,1,0,0,1
132035,2023,Brazil,Bulgaria,0,1,4,5,20/06/2023,0,0,0,0,2,0,1,3,1,4,1,6,0,0,0,0,0,0,0,0
132035,2023,Japan,Bulgaria,0,0,0,0,10/6/2023,0,0,0,0,0,0,0,0,0,0,0,0,0,0,0,0,0,0,0,0
132035,2023,Poland,Bulgaria,0,0,0,0,9/6/2023,0,0,0,0,0,0,0,0,0,0,0,0,0,0,0,0,0,0,0,0
132035,2023,Slovenia,Bulgaria,0,0,0,0,8/6/2023,0,0,0,0,0,0,0,0,0,0,0,0,0,0,0,0,0,0,0,0
132035,2023,Bulgaria,China,0,1,9,10,6/6/2023,0,0,0,0,4,1,2,7,2,5,1,8,0,0,0,0,3,0,0,3
168269,2023,USA,Bulgaria,0,3,4,7,10/7/2023,0,0,0,0,3,1,8,12,0,0,0,0,0,0,0,0,1,1,0,2
168269,2023,Bulgaria,Serbia,1,5,3,9,8/7/2023,0,0,2,2,8,4,9,21,3,1,3,7,0,0,0,0,3,1,0,4
168269,2023,Bulgaria,Iran,0,2,9,11,7/7/2023,0,0,1,1,21,6,21,48,2,1,1,4,0,0,2,2,4,0,1,5
168269,2023,Germany,Bulgaria,0,3,5,8,6/7/2023,0,0,1,1,9,3,7,19,0,1,1,2,0,0,1,1,1,0,0,1
168269,2023,Bulgaria,Cuba,0,3,4,7,25/06/2023,0,0,1,1,7,2,4,13,0,6,3,9,0,0,0,0,1,1,0,2
168269,2023,Argentina,Bulgaria,0,2,4,6,23/06/2023,0,0,3,3,2,2,5,9,0,2,0,2,1,2,11,14,5,4,0,9
168269,2023,Canada,Bulgaria,0,1,2,3,22/06/2023,0,0,1,1,6,0,0,6,0,0,1,1,0,1,2,3,2,0,0,2
168269,2023,Brazil,Bulgaria,0,1,0,1,20/06/2023,0,0,0,0,0,0,1,1,0,1,0,1,0,0,0,0,0,0,0,0
168269,2023,Japan,Bulgaria,1,1,9,11,10/6/2023,0,0,0,0,7,2,8,17,1,1,5,7,0,0,0,0,1,1,0,2
168269,2023,Poland,Bulgaria,0,3,3,6,9/6/2023,0,0,0,0,8,1,4,13,0,0,1,1,0,0,0,0,3,0,0,3
168269,2023,Slovenia,Bulgaria,0,0,0,0,8/6/2023,0,0,0,0,0,0,0,0,0,0,0,0,0,0,0,0,0,0,0,0
168269,2023,Bulgaria,China,0,1,0,1,6/6/2023,0,0,0,0,0,1,1,2,0,0,0,0,0,0,0,0,1,0,0,1
137012,2023,USA,Bulgaria,0,0,9,9,10/7/2023,23,1,44,68,0,1,0,1,1,3,2,6,0,0,1,1,2,1,2,5
137012,2023,Bulgaria,Serbia,1,1,6,8,8/7/2023,21,1,47,69,0,0,0,0,0,1,2,3,0,0,1,1,4,4,1,9
137012,2023,Bulgaria,Iran,0,1,18,19,7/7/2023,24,1,77,102,0,1,1,2,1,3,2,6,0,0,2,2,7,2,0,9
137012,2023,Germany,Bulgaria,0,0,7,7,6/7/2023,16,0,39,55,0,1,0,1,0,0,1,1,0,0,0,0,4,3,0,7
137012,2023,Bulgaria,Cuba,0,0,9,9,25/06/2023,13,0,26,39,0,0,0,0,0,1,1,2,0,0,0,0,1,5,0,6
137012,2023,Argentina,Bulgaria,0,0,7,7,23/06/2023,11,1,50,62,0,0,2,2,0,0,0,0,0,0,0,0,5,5,1,11
137012,2023,Canada,Bulgaria,0,1,11,12,22/06/2023,24,0,58,82,1,1,1,3,1,2,1,4,0,0,0,0,5,0,1,6
137012,2023,Brazil,Bulgaria,0,1,8,9,20/06/2023,16,0,48,64,0,0,2,2,0,3,2,5,0,1,0,1,2,1,0,3
137012,2023,Japan,Bulgaria,0,0,10,10,10/6/2023,15,1,55,71,0,1,0,1,0,1,1,2,0,0,0,0,2,0,0,2
137012,2023,Poland,Bulgaria,0,1,14,15,9/6/2023,25,1,80,106,1,0,1,2,2,2,0,4,0,0,0,0,2,0,0,2
137012,2023,Slovenia,Bulgaria,0,1,10,11,8/6/2023,19,0,52,71,0,0,1,1,0,3,3,6,0,0,0,0,1,0,0,1
137012,2023,Bulgaria,China,0,0,7,7,6/6/2023,8,0,20,28,0,0,0,0,0,0,1,1,0,0,0,0,1,0,0,1
174445,2023,USA,Bulgaria,0,0,2,2,10/7/2023,0,0,1,1,3,0,1,4,0,0,4,4,0,0,0,0,2,1,0,3
174445,2023,Bulgaria,Serbia,0,5,5,10,8/7/2023,0,0,1,1,10,2,13,25,0,2,1,3,5,2,21,28,2,2,1,5
174445,2023,Bulgaria,Iran,0,0,0,0,7/7/2023,0,0,0,0,0,0,0,0,2,0,0,2,0,0,0,0,0,0,0,0
174445,2023,Germany,Bulgaria,0,4,2,6,6/7/2023,0,0,1,1,8,1,5,14,1,0,0,1,1,2,18,21,1,1,0,2
174445,2023,Bulgaria,Cuba,0,0,0,0,25/06/2023,0,0,0,0,0,0,0,0,0,0,0,0,0,0,0,0,0,0,0,0
174445,2023,Argentina,Bulgaria,0,1,1,2,23/06/2023,0,0,0,0,1,0,4,5,1,1,0,2,0,0,1,1,0,0,0,0
174445,2023,Canada,Bulgaria,0,0,0,0,22/06/2023,0,0,0,0,0,0,0,0,0,0,0,0,0,0,0,0,0,0,0,0
174445,2023,Brazil,Bulgaria,0,5,2,7,20/06/2023,0,0,2,2,5,3,7,15,0,5,3,8,2,1,26,29,6,2,1,9
174445,2023,Japan,Bulgaria,0,0,2,2,10/6/2023,0,0,0,0,3,0,1,4,0,1,0,1,3,0,2,5,1,0,1,2
174445,2023,Poland,Bulgaria,1,2,10,13,9/6/2023,0,0,2,2,6,3,6,15,1,1,0,2,2,0,15,17,6,0,0,6
174445,2023,Slovenia,Bulgaria,0,0,0,0,8/6/2023,0,0,0,0,0,0,0,0,0,0,0,0,0,0,0,0,0,0,0,0
174445,2023,Bulgaria,China,0,0,0,0,6/6/2023,0,0,0,0,0,0,0,0,0,0,0,0,0,0,0,0,0,0,0,0
152619,2023,USA,Bulgaria,0,0,0,0,10/7/2023,0,0,0,0,0,0,0,0,0,0,0,0,0,0,0,0,0,0,0,0
152619,2023,Bulgaria,Serbia,0,0,13,13,8/7/2023,0,0,3,3,7,3,3,13,2,2,3,7,0,0,1,1,2,1,0,3
152619,2023,Bulgaria,Iran,1,6,14,21,7/7/2023,0,0,5,5,4,3,4,11,1,3,3,7,0,0,2,2,1,0,0,1
152619,2023,Germany,Bulgaria,1,0,13,14,6/7/2023,0,0,1,1,5,1,3,9,1,3,3,7,0,0,0,0,1,1,0,2
152619,2023,Bulgaria,Cuba,1,2,11,14,25/06/2023,0,0,0,0,5,2,4,11,6,4,3,13,0,0,0,0,1,1,0,2
152619,2023,Argentina,Bulgaria,0,1,10,11,23/06/2023,0,0,1,1,2,2,3,7,1,3,4,8,0,0,0,0,1,0,0,1
152619,2023,Canada,Bulgaria,0,0,11,11,22/06/2023,0,0,0,0,7,0,1,8,5,7,8,20,0,0,1,1,2,1,0,3
152619,2023,Brazil,Bulgaria,0,1,8,9,20/06/2023,0,0,3,3,3,2,3,8,0,0,1,1,0,0,0,0,0,0,0,0
152619,2023,Japan,Bulgaria,0,1,10,11,10/6/2023,0,0,1,1,3,0,3,6,2,3,1,6,0,0,1,1,1,0,0,1
152619,2023,Poland,Bulgaria,0,3,11,14,9/6/2023,0,0,2,2,7,0,2,9,1,3,4,8,0,0,0,0,4,0,0,4
152619,2023,Slovenia,Bulgaria,0,1,12,13,8/6/2023,0,0,0,0,5,0,3,8,4,3,4,11,0,0,1,1,1,0,0,1
152619,2023,Bulgaria,China,0,1,17,18,6/6/2023,0,0,1,1,5,1,1,7,0,4,4,8,0,0,0,0,2,0,0,2
180587,2023,USA,Bulgaria,1,1,8,10,10/7/2023,0,0,0,0,5,7,9,21,0,0,2,2,0,0,0,0,2,3,0,5
180587,2023,Bulgaria,Serbia,0,2,0,2,8/7/2023,0,0,0,0,2,1,0,3,1,0,0,1,0,0,0,0,0,2,0,2
180587,2023,Bulgaria,Iran,1,1,1,3,7/7/2023,0,0,0,0,6,2,4,12,1,0,0,1,0,0,0,0,2,0,1,3
180587,2023,Germany,Bulgaria,0,1,5,6,6/7/2023,0,0,0,0,4,3,2,9,0,1,1,2,0,0,0,0,3,0,0,3
180587,2023,Bulgaria,Cuba,0,1,7,8,25/06/2023,0,0,1,1,5,3,9,17,1,0,4,5,1,0,0,1,2,1,0,3
180587,2023,Argentina,Bulgaria,0,4,5,9,23/06/2023,0,0,1,1,13,2,14,29,0,0,2,2,0,0,0,0,3,1,0,4
180587,2023,Canada,Bulgaria,0,5,8,13,22/06/2023,0,0,3,3,5,5,10,20,0,1,1,2,0,0,0,0,4,2,0,6
180587,2023,Brazil,Bulgaria,0,0,0,0,20/06/2023,0,0,0,0,0,0,0,0,0,0,0,0,0,0,0,0,0,0,0,0
180587,2023,Japan,Bulgaria,0,1,1,2,10/6/2023,0,0,0,0,1,2,4,7,1,1,1,3,0,0,0,0,3,0,0,3
180587,2023,Poland,Bulgaria,1,6,6,13,9/6/2023,0,0,0,0,9,1,10,20,1,2,2,5,0,0,0,0,5,0,0,5
180587,2023,Slovenia,Bulgaria,1,2,13,16,8/6/2023,0,0,0,0,7,4,8,19,1,0,0,1,0,0,0,0,8,0,0,8
180587,2023,Bulgaria,China,1,4,11,16,6/6/2023,0,0,3,3,12,7,10,29,2,4,1,7,0,0,0,0,6,1,1,8
113691,2023,USA,Bulgaria,0,0,0,0,10/7/2023,0,0,3,3,0,0,0,0,0,0,0,0,2,1,12,15,3,0,0,3
113691,2023,Bulgaria,Serbia,0,0,0,0,8/7/2023,0,0,6,6,0,0,0,0,0,0,0,0,3,1,7,11,4,2,0,6
113691,2023,Bulgaria,Iran,0,0,0,0,7/7/2023,0,0,6,6,0,0,0,0,0,0,0,0,5,1,15,21,2,0,1,3
113691,2023,Germany,Bulgaria,0,0,0,0,6/7/2023,0,0,5,5,0,0,0,0,0,0,0,0,3,1,10,14,5,3,3,11
113691,2023,Bulgaria,Cuba,0,0,0,0,25/06/2023,0,1,4,5,0,0,0,0,0,0,0,0,6,5,15,26,9,4,0,13
113691,2023,Argentina,Bulgaria,0,0,0,0,23/06/2023,0,0,6,6,0,0,0,0,0,0,0,0,4,0,8,12,5,0,0,5
113691,2023,Canada,Bulgaria,0,0,0,0,22/06/2023,0,0,7,7,0,0,0,0,0,0,0,0,6,1,29,36,7,2,1,10
113691,2023,Brazil,Bulgaria,0,0,0,0,20/06/2023,0,1,8,9,0,0,0,0,0,0,0,0,1,0,8,9,5,4,2,11
135372,2023,USA,Bulgaria,0,0,0,0,10/7/2023,0,0,2,2,0,0,0,0,0,0,0,0,0,0,0,0,5,3,1,9
135372,2023,Bulgaria,Serbia,0,0,0,0,8/7/2023,0,0,1,1,0,0,0,0,0,0,0,0,0,0,0,0,1,1,0,2
135372,2023,Bulgaria,Iran,0,0,0,0,7/7/2023,0,0,6,6,0,0,0,0,0,0,0,0,0,2,0,2,2,4,2,8
135372,2023,Germany,Bulgaria,0,0,0,0,6/7/2023,0,0,0,0,0,0,0,0,0,0,0,0,0,0,0,0,0,0,0,0
135372,2023,Japan,Bulgaria,0,0,0,0,10/6/2023,0,0,3,3,0,0,0,0,0,0,0,0,4,0,9,13,5,1,2,8
135372,2023,Poland,Bulgaria,0,0,0,0,9/6/2023,0,0,4,4,0,0,0,0,0,0,0,0,3,2,22,27,8,0,1,9
135372,2023,Slovenia,Bulgaria,0,0,0,0,8/6/2023,0,0,1,1,0,0,0,0,0,0,0,0,8,0,7,15,3,0,1,4
135372,2023,Bulgaria,China,0,0,0,0,6/6/2023,0,0,3,3,0,0,0,0,0,0,0,0,9,1,14,24,9,1,1,11
124986,2023,USA,Bulgaria,0,0,0,0,10/7/2023,0,0,0,0,0,0,0,0,0,0,0,0,0,0,0,0,0,0,0,0
124986,2023,Bulgaria,Serbia,0,0,0,0,8/7/2023,0,0,0,0,0,0,0,0,0,0,0,0,0,0,0,0,0,0,0,0
124986,2023,Bulgaria,Iran,0,0,0,0,7/7/2023,0,0,0,0,0,0,0,0,0,0,0,0,0,0,0,0,0,0,0,0
124986,2023,Germany,Bulgaria,0,0,1,1,6/7/2023,6,0,10,16,0,0,0,0,0,0,0,0,0,0,0,0,0,1,0,1
124986,2023,Bulgaria,Cuba,0,0,10,10,25/06/2023,21,0,26,47,0,0,0,0,0,2,1,3,0,0,0,0,3,2,0,5
124986,2023,Argentina,Bulgaria,0,0,2,2,23/06/2023,6,0,6,12,0,0,0,0,0,1,0,1,0,0,0,0,1,1,0,2
124986,2023,Canada,Bulgaria,0,0,0,0,22/06/2023,1,0,1,2,0,0,0,0,0,0,0,0,0,0,0,0,0,0,0,0
124986,2023,Brazil,Bulgaria,0,0,0,0,20/06/2023,0,0,1,1,0,0,0,0,0,0,0,0,0,0,0,0,0,0,0,0
132033,2023,USA,Bulgaria,0,0,1,1,10/7/2023,0,0,2,2,0,0,2,2,0,0,1,1,0,0,2,2,2,2,1,5
132033,2023,Bulgaria,Serbia,0,0,1,1,8/7/2023,0,0,1,1,1,0,3,4,0,0,0,0,1,0,3,4,0,1,0,1
132033,2023,Bulgaria,Iran,0,1,12,13,7/7/2023,0,0,3,3,7,3,10,20,1,3,2,6,7,0,18,25,7,1,3,11
132033,2023,Germany,Bulgaria,0,1,0,1,6/7/2023,0,0,0,0,2,0,1,3,0,1,1,2,1,1,3,5,0,0,0,0
132033,2023,Japan,Bulgaria,0,0,0,0,10/6/2023,0,0,0,0,0,0,0,0,0,0,0,0,0,0,3,3,0,0,0,0
132033,2023,Poland,Bulgaria,0,0,3,3,9/6/2023,0,0,1,1,1,0,0,1,0,0,0,0,4,0,2,6,1,0,0,1
132033,2023,Slovenia,Bulgaria,0,0,0,0,8/6/2023,0,0,0,0,0,0,0,0,0,0,0,0,1,0,2,3,1,0,0,1
132033,2023,Bulgaria,China,0,1,3,4,6/6/2023,0,0,2,2,2,3,1,6,1,2,2,5,2,1,2,5,3,0,0,3
118486,2023,USA,Bulgaria,0,2,9,11,10/7/2023,0,0,2,2,3,3,5,11,1,3,0,4,6,2,13,21,7,0,0,7
118486,2023,Bulgaria,Serbia,1,0,5,6,8/7/2023,0,0,3,3,1,1,1,3,0,1,0,1,2,1,6,9,2,0,0,2
118486,2023,Bulgaria,Iran,0,2,1,3,7/7/2023,0,0,0,0,0,0,0,0,0,0,0,0,1,0,0,1,0,0,0,0
118486,2023,Germany,Bulgaria,0,0,2,2,6/7/2023,0,0,1,1,1,1,1,3,0,2,0,2,0,0,6,6,0,2,0,2
168268,2023,USA,Bulgaria,0,5,0,5,10/7/2023,0,0,0,0,2,0,2,4,0,3,2,5,0,0,0,0,0,0,0,0
168268,2023,Bulgaria,Serbia,0,2,1,3,8/7/2023,0,0,0,0,0,0,0,0,0,0,0,0,0,0,0,0,1,0,0,1
168268,2023,Bulgaria,Iran,0,1,3,4,7/7/2023,0,0,0,0,0,0,0,0,0,0,0,0,0,0,0,0,0,1,0,1
168268,2023,Germany,Bulgaria,0,1,2,3,6/7/2023,0,0,0,0,0,0,0,0,0,0,0,0,0,0,0,0,0,0,0,0
168268,2023,Bulgaria,Cuba,0,2,0,2,25/06/2023,0,0,0,0,0,0,0,0,0,0,0,0,0,0,0,0,0,0,0,0
168268,2023,Argentina,Bulgaria,1,2,5,8,23/06/2023,0,0,0,0,5,0,3,8,1,2,4,7,0,0,0,0,2,0,0,2
168268,2023,Canada,Bulgaria,0,1,4,5,22/06/2023,0,0,0,0,0,0,0,0,0,0,0,0,0,0,0,0,0,0,0,0
168268,2023,Brazil,Bulgaria,0,0,5,5,20/06/2023,0,0,0,0,2,0,0,2,0,0,0,0,0,0,0,0,0,1,0,1
168268,2023,Japan,Bulgaria,2,2,0,4,10/6/2023,0,0,0,0,0,0,0,0,0,0,0,0,0,0,0,0,0,0,0,0
168268,2023,Poland,Bulgaria,0,4,7,11,9/6/2023,0,0,1,1,3,1,4,8,1,2,4,7,0,0,1,1,3,0,0,3
168268,2023,Slovenia,Bulgaria,0,1,0,1,8/6/2023,0,0,0,0,0,0,0,0,0,0,0,0,0,0,0,0,0,0,0,0
168268,2023,Bulgaria,China,0,0,1,1,6/6/2023,0,0,0,0,0,0,0,0,0,0,0,0,0,0,0,0,1,0,0,1
157324,2023,China,Canada,0,0,0,0,9/7/2023,0,0,0,0,0,0,0,0,0,0,0,0,0,0,0,0,0,0,0,0
157324,2023,Poland,Canada,0,1,7,8,8/7/2023,0,0,0,0,1,1,2,4,0,2,3,5,2,0,1,3,0,1,0,1
157324,2023,Canada,Italy,0,0,0,0,6/7/2023,0,0,0,0,0,0,0,0,0,0,0,0,0,0,0,0,0,0,0,0
157324,2023,Canada,Netherlands,0,2,9,11,5/7/2023,0,0,0,0,7,0,4,11,1,7,6,14,0,0,3,3,3,1,1,5
157324,2023,Canada,France,0,1,5,6,24/06/2023,0,0,0,0,3,0,1,4,0,3,3,6,0,0,2,2,2,0,0,2
157324,2023,Canada,Bulgaria,1,2,13,16,22/06/2023,0,0,1,1,6,1,3,10,0,2,4,6,0,0,1,1,1,0,0,1
157324,2023,Slovenia,Canada,0,0,12,12,21/06/2023,0,0,1,1,4,0,1,5,0,1,5,6,0,0,4,4,3,0,2,5
157324,2023,Japan,Canada,1,1,4,6,20/06/2023,0,0,1,1,0,1,2,3,0,3,1,4,1,0,2,3,1,0,0,1
157324,2023,Canada,Germany,0,1,5,6,11/6/2023,0,0,0,0,3,0,0,3,2,4,2,8,0,1,0,1,2,0,0,2
157324,2023,Canada,USA,0,1,12,13,11/6/2023,0,0,0,0,6,0,2,8,0,6,2,8,0,0,0,0,2,1,1,4
157324,2023,Canada,Argentina,0,0,0,0,10/6/2023,0,0,0,0,0,0,0,0,0,0,0,0,0,0,0,0,0,0,0,0
157324,2023,Canada,Cuba,0,0,8,8,7/6/2023,0,0,1,1,1,0,1,2,3,2,3,8,0,0,0,0,1,2,1,4
165212,2023,China,Canada,0,0,12,12,9/7/2023,18,1,59,78,0,0,0,0,1,3,3,7,0,0,0,0,5,2,0,7
165212,2023,Poland,Canada,0,0,0,0,8/7/2023,0,0,0,0,0,0,0,0,0,0,0,0,0,0,0,0,0,0,0,0
165212,2023,Canada,Italy,1,3,10,14,6/7/2023,23,1,79,103,0,0,0,0,1,0,4,5,0,0,0,0,6,2,0,8
165212,2023,Canada,Netherlands,1,1,11,13,5/7/2023,24,0,48,72,0,0,0,0,2,2,3,7,0,0,0,0,6,5,0,11
165212,2023,Canada,France,0,0,8,8,24/06/2023,16,1,40,57,0,0,0,0,0,2,0,2,0,0,0,0,4,2,0,6
165212,2023,Canada,Bulgaria,0,0,14,14,22/06/2023,23,1,60,84,0,0,0,0,2,1,1,4,0,0,0,0,5,1,0,6
165212,2023,Slovenia,Canada,0,1,4,5,21/06/2023,11,0,34,45,0,0,0,0,0,2,2,4,0,0,0,0,1,0,0,1
165212,2023,Japan,Canada,1,0,5,6,20/06/2023,8,0,38,46,0,0,0,0,1,1,1,3,0,0,0,0,0,1,0,1
165212,2023,Canada,Germany,0,2,3,5,11/6/2023,16,0,50,66,0,0,0,0,1,1,1,3,0,0,1,1,1,2,1,4
165212,2023,Canada,USA,0,1,6,7,11/6/2023,13,1,40,54,0,1,0,1,0,0,1,1,0,0,0,0,5,1,0,6
165212,2023,Canada,Argentina,0,1,9,10,10/6/2023,16,0,82,98,1,0,1,2,0,0,5,5,0,0,0,0,7,4,0,11
165212,2023,Canada,Cuba,0,1,19,20,7/6/2023,24,1,74,99,1,0,0,1,0,1,2,3,0,0,0,0,8,7,0,15
136291,2023,China,Canada,3,2,18,23,9/7/2023,0,0,3,3,9,2,7,18,0,3,2,5,1,3,20,24,2,0,0,2
136291,2023,Poland,Canada,0,0,4,4,8/7/2023,0,0,0,0,0,0,0,0,0,0,0,0,0,0,0,0,1,0,0,1
136291,2023,Canada,Italy,2,3,16,21,6/7/2023,0,0,4,4,12,3,12,27,0,1,3,4,6,2,20,28,6,3,0,9
136291,2023,Canada,Netherlands,1,1,17,19,5/7/2023,0,0,4,4,9,2,12,23,1,5,3,9,1,0,16,17,3,1,1,5
136291,2023,Canada,France,1,1,9,11,24/06/2023,0,0,4,4,7,2,5,14,0,1,2,3,2,2,12,16,2,2,1,5
136291,2023,Canada,Bulgaria,1,3,13,17,22/06/2023,0,0,3,3,8,4,10,22,1,1,0,2,1,0,11,12,7,3,1,11
136291,2023,Slovenia,Canada,0,0,1,1,21/06/2023,0,0,0,0,0,0,0,0,0,0,0,0,0,0,0,0,0,0,0,0
136291,2023,Japan,Canada,1,2,12,15,20/06/2023,0,0,3,3,7,3,8,18,1,5,1,7,8,2,25,35,7,4,2,13
136291,2023,Canada,Germany,1,6,16,23,11/6/2023,0,0,4,4,8,4,7,19,0,2,1,3,7,0,19,26,7,1,4,12
136291,2023,Canada,USA,0,1,4,5,11/6/2023,0,0,2,2,2,3,3,8,0,0,2,2,3,2,10,15,0,3,1,4
136291,2023,Canada,Argentina,0,3,10,13,10/6/2023,0,0,5,5,10,6,10,26,0,3,4,7,10,1,20,31,9,1,0,10
136291,2023,Canada,Cuba,0,2,15,17,7/6/2023,0,0,15,15,12,2,10,24,1,1,0,2,3,3,13,19,5,5,1,11
168914,2023,China,Canada,0,0,0,0,9/7/2023,0,0,0,0,0,0,0,0,0,0,0,0,0,0,0,0,0,0,0,0
168914,2023,Poland,Canada,1,1,10,12,8/7/2023,0,1,8,9,8,4,8,20,0,3,0,3,4,0,7,11,4,4,0,8
168914,2023,Canada,Italy,0,0,2,2,6/7/2023,0,0,0,0,0,0,0,0,0,0,0,0,0,0,0,0,0,0,0,0
168914,2023,Canada,Netherlands,0,0,0,0,5/7/2023,0,0,0,0,0,0,0,0,0,0,0,0,0,0,0,0,0,0,0,0
168914,2023,Canada,France,0,0,3,3,24/06/2023,0,0,0,0,0,0,0,0,0,0,0,0,0,0,0,0,0,0,0,0
168914,2023,Canada,Bulgaria,0,0,0,0,22/06/2023,0,0,0,0,0,0,0,0,0,0,0,0,0,0,0,0,0,0,0,0
168914,2023,Slovenia,Canada,0,2,5,7,21/06/2023,0,0,1,1,9,4,15,28,0,1,1,2,3,2,12,17,3,1,0,4
168914,2023,Japan,Canada,0,0,2,2,20/06/2023,0,0,0,0,0,0,0,0,0,0,0,0,0,0,0,0,0,0,0,0
168914,2023,Canada,Germany,0,0,2,2,11/6/2023,0,0,0,0,0,0,0,0,0,0,0,0,0,0,0,0,0,0,0,0
168914,2023,Canada,USA,0,0,2,2,11/6/2023,0,0,1,1,1,0,1,2,0,1,1,2,2,1,4,7,2,0,0,2
168914,2023,Canada,Argentina,0,0,3,3,10/6/2023,0,0,0,0,0,0,0,0,0,0,0,0,0,0,0,0,0,2,0,2
168914,2023,Canada,Cuba,0,1,2,3,7/6/2023,0,0,0,0,0,0,0,0,0,0,0,0,0,0,0,0,1,0,0,1
140042,2023,China,Canada,2,3,12,17,9/7/2023,0,0,0,0,8,0,1,9,4,3,4,11,0,0,0,0,0,2,0,2
140042,2023,Poland,Canada,0,0,0,0,8/7/2023,0,0,0,0,0,0,0,0,0,0,0,0,0,0,0,0,0,0,0,0
140042,2023,Canada,Italy,1,4,13,18,6/7/2023,0,0,1,1,6,2,3,11,0,6,4,10,0,1,1,2,1,2,2,5
140042,2023,Canada,Netherlands,1,2,13,16,5/7/2023,0,0,2,2,6,4,1,11,0,8,5,13,0,0,2,2,1,0,1,2
140042,2023,Canada,France,0,3,6,9,24/06/2023,0,0,0,0,4,0,2,6,0,6,5,11,0,0,0,0,0,2,0,2
140042,2023,Canada,Bulgaria,3,2,7,12,22/06/2023,0,0,2,2,10,1,3,14,2,5,10,17,0,0,2,2,4,1,0,5
140042,2023,Slovenia,Canada,0,0,0,0,21/06/2023,0,0,0,0,0,0,0,0,0,0,0,0,0,0,0,0,0,0,0,0
140042,2023,Japan,Canada,0,4,9,13,20/06/2023,0,0,1,1,6,0,2,8,1,5,4,10,2,0,3,5,5,0,0,5
140042,2023,Canada,Germany,0,1,6,7,11/6/2023,0,0,0,0,1,1,1,3,2,0,0,2,1,0,0,1,0,1,0,1
140042,2023,Canada,USA,0,1,7,8,11/6/2023,0,0,1,1,2,1,1,4,2,3,5,10,0,0,1,1,2,3,1,6
140042,2023,Canada,Argentina,0,3,11,14,10/6/2023,0,0,3,3,8,1,5,14,1,1,3,5,0,0,0,0,4,2,0,6
140042,2023,Canada,Cuba,0,7,16,23,7/6/2023,0,0,1,1,6,1,5,12,4,4,2,10,1,0,3,4,3,2,0,5
140061,2023,China,Canada,0,4,10,14,9/7/2023,0,0,4,4,14,3,5,22,4,3,4,11,7,2,28,37,9,3,1,13
140061,2023,Poland,Canada,0,0,0,0,8/7/2023,0,0,0,0,0,0,0,0,0,0,0,0,0,0,0,0,0,0,0,0
140061,2023,Canada,Italy,1,1,9,11,6/7/2023,0,0,7,7,15,6,22,43,2,2,5,9,2,4,22,28,7,3,0,10
140061,2023,Canada,Netherlands,0,2,0,2,5/7/2023,0,0,0,0,1,0,1,2,0,2,1,3,2,0,5,7,0,0,0,0
140061,2023,Canada,France,1,2,8,11,24/06/2023,0,0,3,3,13,3,12,28,0,6,3,9,6,0,14,20,5,2,1,8
140061,2023,Canada,Bulgaria,1,3,10,14,22/06/2023,1,0,5,6,14,4,10,28,1,1,2,4,10,2,24,36,6,3,3,12
140061,2023,Slovenia,Canada,0,0,0,0,21/06/2023,0,0,0,0,0,0,0,0,0,0,0,0,0,0,0,0,0,0,0,0
140061,2023,Japan,Canada,1,3,8,12,20/06/2023,0,0,3,3,16,4,15,35,0,4,2,6,3,2,12,17,4,5,2,11
140061,2023,Canada,Germany,0,0,13,13,11/6/2023,0,0,4,4,10,3,13,26,2,2,2,6,5,2,12,19,6,2,0,8
140061,2023,Canada,USA,1,3,5,9,11/6/2023,1,1,2,4,8,5,8,21,3,5,0,8,4,0,9,13,4,6,0,10
140061,2023,Canada,Argentina,1,3,10,14,10/6/2023,0,0,7,7,12,8,12,32,1,3,2,6,9,1,14,24,6,0,3,9
140061,2023,Canada,Cuba,2,4,11,17,7/6/2023,0,0,5,5,14,5,26,45,2,7,2,11,9,0,23,32,9,6,3,18
143745,2023,China,Canada,0,0,0,0,9/7/2023,0,0,0,0,0,0,0,0,0,0,0,0,0,0,0,0,0,0,0,0
143745,2023,Poland,Canada,2,3,7,12,8/7/2023,16,0,53,69,0,0,0,0,0,3,1,4,0,0,0,0,3,3,2,8
143745,2023,Canada,Italy,0,0,0,0,6/7/2023,0,0,6,6,0,0,0,0,0,0,0,0,0,0,0,0,0,0,0,0
143745,2023,Canada,Netherlands,0,0,1,1,5/7/2023,1,0,5,6,0,0,0,0,0,0,0,0,0,0,0,0,1,0,0,1
143745,2023,Canada,France,0,0,0,0,24/06/2023,1,0,6,7,0,0,0,0,0,0,1,1,0,0,0,0,0,0,0,0
143745,2023,Canada,Bulgaria,0,0,1,1,22/06/2023,0,0,2,2,0,0,0,0,0,0,0,0,0,0,0,0,0,0,0,0
143745,2023,Slovenia,Canada,0,1,2,3,21/06/2023,10,0,24,34,0,0,0,0,0,0,2,2,0,0,0,0,2,3,0,5
143745,2023,Japan,Canada,0,1,5,6,20/06/2023,21,0,30,51,0,0,0,0,1,2,3,6,0,0,0,0,1,2,1,4
140428,2023,China,Canada,0,2,11,13,9/7/2023,0,0,2,2,20,3,13,36,0,4,2,6,0,0,2,2,5,0,1,6
140428,2023,Poland,Canada,0,0,0,0,8/7/2023,0,0,0,0,0,0,0,0,0,0,0,0,0,0,0,0,0,0,0,0
140428,2023,Canada,Italy,1,3,10,14,6/7/2023,0,0,5,5,16,7,15,38,5,4,3,12,0,1,5,6,10,3,1,14
140428,2023,Canada,Netherlands,2,3,11,16,5/7/2023,0,0,4,4,18,2,13,33,0,2,2,4,0,0,0,0,5,2,0,7
140428,2023,Canada,France,0,0,0,0,24/06/2023,0,0,0,0,0,0,0,0,0,0,0,0,0,0,0,0,0,0,0,0
140428,2023,Canada,Bulgaria,1,2,1,4,22/06/2023,0,0,0,0,2,4,3,9,0,0,2,2,0,0,0,0,2,1,0,3
140428,2023,Slovenia,Canada,0,0,3,3,21/06/2023,0,0,1,1,3,0,4,7,1,2,0,3,0,0,0,0,5,3,1,9
140428,2023,Japan,Canada,0,0,4,4,20/06/2023,0,0,2,2,3,3,4,10,0,1,0,1,0,0,0,0,2,0,1,3
140428,2023,Canada,Germany,0,1,10,11,11/6/2023,0,0,0,0,15,4,12,31,1,1,0,2,0,0,1,1,3,1,1,5
140428,2023,Canada,USA,0,0,0,0,11/6/2023,0,0,0,0,1,0,0,1,0,0,1,1,0,0,0,0,0,0,0,0
140428,2023,Canada,Argentina,2,1,11,14,10/6/2023,0,0,0,0,14,9,9,32,0,0,2,2,0,0,0,0,6,3,1,10
140428,2023,Canada,Cuba,1,2,15,18,7/6/2023,0,0,1,1,22,3,20,45,4,4,4,12,0,0,2,2,13,7,1,21
136296,2023,China,Canada,0,1,15,16,9/7/2023,0,0,1,1,4,0,2,6,0,2,8,10,0,0,0,0,0,1,1,2
136296,2023,Poland,Canada,0,1,5,6,8/7/2023,0,0,3,3,3,0,3,6,0,5,6,11,0,0,0,0,1,2,0,3
136296,2023,Canada,Italy,0,0,9,9,6/7/2023,0,0,6,6,6,0,4,10,1,5,6,12,0,0,1,1,1,2,0,3
136296,2023,Canada,Netherlands,0,0,1,1,5/7/2023,0,0,0,0,0,0,0,0,1,0,0,1,0,0,0,0,0,0,0,0
136296,2023,Canada,France,0,0,0,0,24/06/2023,0,0,0,0,0,0,0,0,0,0,0,0,0,0,0,0,0,0,0,0
136296,2023,Canada,Bulgaria,0,0,0,0,22/06/2023,0,0,0,0,0,0,0,0,0,0,0,0,0,0,0,0,0,0,0,0
136296,2023,Slovenia,Canada,0,0,11,11,21/06/2023,0,0,1,1,4,0,2,6,1,6,3,10,0,0,1,1,4,0,0,4
136296,2023,Japan,Canada,0,0,5,5,20/06/2023,0,1,1,2,2,1,2,5,2,2,1,5,1,0,2,3,2,0,1,3
136296,2023,Canada,Germany,0,0,11,11,11/6/2023,0,0,0,0,7,2,2,11,0,8,2,10,0,0,1,1,1,0,0,1
136296,2023,Canada,USA,0,0,0,0,11/6/2023,0,0,0,0,0,0,0,0,0,0,0,0,0,0,0,0,0,0,0,0
136296,2023,Canada,Argentina,0,0,11,11,10/6/2023,0,1,1,2,4,0,4,8,1,7,5,13,0,0,1,1,3,0,0,3
136296,2023,Canada,Cuba,0,0,6,6,7/6/2023,0,0,3,3,0,0,4,4,3,4,7,14,0,0,1,1,2,2,0,4
182679,2023,China,Canada,0,0,0,0,9/7/2023,0,0,0,0,0,0,0,0,0,0,0,0,0,0,0,0,0,0,0,0
182679,2023,Poland,Canada,3,3,6,12,8/7/2023,0,0,3,3,15,4,12,31,1,1,0,2,4,1,24,29,3,4,0,7
182679,2023,Canada,Italy,0,0,0,0,6/7/2023,0,0,0,0,0,0,0,0,0,0,0,0,0,0,0,0,0,0,0,0
182679,2023,Canada,Netherlands,0,0,0,0,5/7/2023,0,0,1,1,1,0,1,2,0,0,0,0,0,0,3,3,0,0,0,0
182679,2023,Canada,France,0,0,0,0,24/06/2023,0,0,0,0,0,0,0,0,0,0,0,0,0,0,0,0,0,0,0,0
182679,2023,Canada,Bulgaria,0,0,0,0,22/06/2023,0,0,0,0,0,0,0,0,0,0,0,0,0,0,0,0,0,0,0,0
182679,2023,Slovenia,Canada,1,2,1,4,21/06/2023,0,0,3,3,5,5,5,15,1,0,1,2,2,0,7,9,2,1,1,4
182679,2023,Japan,Canada,0,0,0,0,20/06/2023,0,0,0,0,0,0,1,1,0,0,0,0,0,0,0,0,0,0,0,0
151871,2023,China,Canada,0,0,0,0,9/7/2023,0,0,0,0,0,0,0,0,0,0,0,0,0,0,0,0,0,0,0,0
151871,2023,Poland,Canada,0,5,8,13,8/7/2023,0,0,3,3,14,7,6,27,2,1,1,4,1,0,0,1,3,3,2,8
151871,2023,Canada,Italy,0,0,1,1,6/7/2023,0,0,0,0,0,2,0,2,0,0,1,1,0,0,0,0,0,1,0,1
151871,2023,Canada,Netherlands,0,0,0,0,5/7/2023,0,0,0,0,0,0,0,0,0,0,0,0,0,0,0,0,0,0,0,0
151871,2023,Canada,France,2,2,9,13,24/06/2023,0,0,1,1,11,4,8,23,0,2,1,3,0,0,0,0,3,6,0,9
151871,2023,Canada,Bulgaria,2,4,7,13,22/06/2023,0,0,1,1,12,4,3,19,1,3,1,5,0,0,0,0,3,1,0,4
151871,2023,Slovenia,Canada,1,0,7,8,21/06/2023,0,0,1,1,10,2,5,17,0,3,0,3,0,0,0,0,1,1,1,3
151871,2023,Japan,Canada,4,0,7,11,20/06/2023,0,0,0,0,12,5,8,25,1,2,0,3,0,0,1,1,3,1,0,4
151871,2023,Canada,Germany,0,1,3,4,11/6/2023,0,0,0,0,3,2,6,11,1,1,0,2,0,0,0,0,0,2,1,3
151871,2023,Canada,USA,0,0,12,12,11/6/2023,0,0,2,2,12,4,5,21,1,1,1,3,0,0,0,0,6,4,0,10
151871,2023,Canada,Argentina,0,0,4,4,10/6/2023,0,0,1,1,4,2,4,10,1,0,4,5,0,0,0,0,3,2,1,6
151871,2023,Canada,Cuba,0,0,1,1,7/6/2023,0,0,0,0,2,1,1,4,0,0,0,0,0,0,0,0,0,0,0,0
168925,2023,China,Canada,0,0,0,0,9/7/2023,0,0,2,2,0,0,0,0,0,0,0,0,0,1,6,7,4,7,0,11
168925,2023,Poland,Canada,0,0,0,0,8/7/2023,0,0,2,2,0,0,0,0,0,0,0,0,3,2,13,18,7,1,1,9
168925,2023,Canada,Italy,0,0,0,0,6/7/2023,0,0,2,2,0,0,0,0,0,0,0,0,5,0,13,18,13,6,0,19
168925,2023,Canada,Netherlands,0,0,0,0,5/7/2023,0,0,0,0,0,0,0,0,0,0,0,0,0,0,0,0,0,0,0,0
168925,2023,Canada,France,0,0,0,0,24/06/2023,0,0,0,0,0,0,0,0,0,0,0,0,2,0,5,7,3,0,0,3
168925,2023,Canada,Bulgaria,0,0,0,0,22/06/2023,0,0,0,0,0,0,0,0,0,0,0,0,0,0,0,0,0,0,0,0
168925,2023,Slovenia,Canada,0,0,0,0,21/06/2023,0,0,1,1,0,0,0,0,0,0,0,0,0,1,4,5,2,0,0,2
168925,2023,Japan,Canada,0,0,0,0,20/06/2023,0,0,0,0,0,0,0,0,0,0,0,0,0,0,1,1,0,0,0,0
168925,2023,Canada,Germany,0,0,0,0,11/6/2023,0,0,0,0,0,0,0,0,0,0,0,0,0,0,0,0,0,0,0,0
168925,2023,Canada,USA,0,0,0,0,11/6/2023,0,0,0,0,0,0,0,0,0,0,0,0,0,0,0,0,0,0,0,0
168925,2023,Canada,Argentina,0,0,0,0,10/6/2023,0,0,0,0,0,0,0,0,0,0,0,0,0,0,0,0,0,0,0,0
168925,2023,Canada,Cuba,0,0,0,0,7/6/2023,0,0,0,0,0,0,0,0,0,0,0,0,0,0,0,0,0,0,0,0
168923,2023,China,Canada,0,0,0,0,9/7/2023,0,0,0,0,0,0,0,0,0,0,0,0,0,0,0,0,0,0,0,0
168923,2023,Poland,Canada,0,0,0,0,8/7/2023,0,0,0,0,0,0,0,0,0,0,0,0,0,0,0,0,0,0,0,0
168923,2023,Canada,Italy,0,0,0,0,6/7/2023,0,0,0,0,0,0,0,0,0,0,0,0,0,0,0,0,0,0,0,0
168923,2023,Canada,Netherlands,0,0,0,0,5/7/2023,0,0,3,3,0,0,0,0,0,0,0,0,2,5,21,28,5,4,1,10
168923,2023,Canada,France,0,0,0,0,24/06/2023,0,0,2,2,0,0,0,0,0,0,0,0,0,2,13,15,4,3,0,7
168923,2023,Canada,Bulgaria,0,0,0,0,22/06/2023,0,0,4,4,0,0,0,0,0,0,0,0,2,2,16,20,7,4,1,12
168923,2023,Slovenia,Canada,0,0,0,0,21/06/2023,0,0,1,1,0,0,0,0,0,0,0,0,2,1,4,7,6,4,1,11
168923,2023,Japan,Canada,0,0,0,0,20/06/2023,0,0,1,1,0,0,0,0,0,0,0,0,2,2,15,19,5,12,0,17
168923,2023,Canada,Germany,0,0,0,0,11/6/2023,0,0,0,0,0,0,0,0,0,0,0,0,4,1,19,24,14,6,3,23
168923,2023,Canada,USA,0,0,0,0,11/6/2023,0,0,3,3,0,0,0,0,0,0,0,0,2,1,7,10,5,8,0,13
168923,2023,Canada,Argentina,0,0,0,0,10/6/2023,0,0,2,2,0,0,0,0,0,0,0,0,5,1,14,20,14,4,1,19
168923,2023,Canada,Cuba,0,0,0,0,7/6/2023,0,0,6,6,0,0,0,0,0,0,0,0,3,0,24,27,12,16,1,29
168908,2023,China,Canada,0,0,2,2,9/7/2023,0,0,1,1,0,0,0,0,0,0,0,0,0,0,0,0,1,0,0,1
168908,2023,Poland,Canada,0,0,4,4,8/7/2023,0,0,0,0,0,0,0,0,0,0,0,0,0,0,0,0,0,1,0,1
168908,2023,Canada,Italy,0,2,1,3,6/7/2023,0,0,0,0,1,0,3,4,0,0,0,0,2,0,7,9,1,0,0,1
168908,2023,Canada,Netherlands,0,0,9,9,5/7/2023,0,0,1,1,5,4,5,14,1,2,2,5,3,1,7,11,3,0,0,3
168908,2023,Canada,France,0,0,0,0,24/06/2023,0,0,0,0,0,0,0,0,0,0,0,0,0,0,0,0,0,0,0,0
168908,2023,Canada,Bulgaria,0,0,5,5,22/06/2023,0,0,0,0,0,0,0,0,0,0,0,0,0,0,0,0,0,1,0,1
168908,2023,Slovenia,Canada,0,1,5,6,21/06/2023,0,0,1,1,6,2,4,12,1,1,1,3,6,3,12,21,5,1,0,6
168908,2023,Japan,Canada,0,1,0,1,20/06/2023,0,0,0,0,2,0,3,5,0,0,0,0,0,2,2,4,1,1,0,2
168908,2023,Canada,Germany,0,0,0,0,11/6/2023,0,0,0,0,0,0,0,0,0,0,0,0,1,0,4,5,0,0,0,0
168908,2023,Canada,USA,0,0,5,5,11/6/2023,0,0,0,0,3,0,6,9,0,1,2,3,4,1,10,15,0,2,1,3
168908,2023,Canada,Argentina,0,0,1,1,10/6/2023,0,0,1,1,0,0,1,1,0,1,0,1,2,0,2,4,0,0,0,0
168908,2023,Canada,Cuba,0,0,0,0,7/6/2023,0,0,0,0,0,0,0,0,0,0,0,0,0,0,0,0,0,0,0,0
173184,2023,China,Canada,0,0,0,0,9/7/2023,0,0,0,0,0,0,0,0,0,0,0,0,0,0,0,0,0,0,0,0
173184,2023,Brazil,China,0,1,6,7,8/7/2023,0,0,1,1,4,1,2,7,2,3,0,5,0,0,1,1,2,0,2,4
173184,2023,China,Slovenia,2,3,6,11,6/7/2023,0,0,1,1,3,0,2,5,2,3,2,7,0,1,2,3,1,0,0,1
173184,2023,Japan,China,0,0,0,0,4/7/2023,0,0,0,0,0,0,0,0,0,0,0,0,0,0,0,0,0,0,0,0
173184,2023,China,Germany,0,1,11,12,24/06/2023,0,0,0,0,3,1,5,9,0,0,2,2,0,0,0,0,1,1,0,2
173184,2023,China,Italy,0,1,9,10,22/06/2023,0,0,1,1,3,1,3,7,1,5,3,9,1,0,0,1,0,2,0,2
173184,2023,USA,China,0,1,11,12,21/06/2023,0,0,0,0,3,2,2,7,0,1,2,3,0,0,0,0,0,1,0,1
173184,2023,Netherlands,China,0,0,0,0,20/06/2023,0,0,0,0,0,0,0,0,0,0,0,0,0,0,0,0,0,0,0,0
173184,2023,Iran,China,0,0,0,0,10/6/2023,0,0,0,0,0,0,0,0,0,0,0,0,0,0,0,0,0,0,0,0
173184,2023,China,France,0,0,0,0,9/6/2023,0,0,0,0,0,0,0,0,0,0,0,0,0,0,0,0,0,0,0,0
173184,2023,Serbia,China,0,0,10,10,8/6/2023,0,1,2,3,4,0,4,8,1,4,2,7,0,0,1,1,1,0,1,2
173184,2023,Bulgaria,China,1,0,6,7,6/6/2023,0,0,0,0,1,1,1,3,2,0,1,3,0,0,1,1,0,0,0,0
142855,2023,China,Canada,2,1,6,9,9/7/2023,0,0,0,0,7,8,4,19,0,3,0,3,0,0,0,0,5,0,2,7
142855,2023,Brazil,China,0,1,1,2,8/7/2023,0,0,1,1,2,3,2,7,0,0,0,0,0,0,0,0,0,0,0,0
142855,2023,China,Slovenia,1,3,3,7,6/7/2023,0,0,0,0,7,2,5,14,1,1,4,6,0,0,0,0,3,2,1,6
142855,2023,Japan,China,0,2,2,4,4/7/2023,0,1,2,3,2,3,7,12,2,0,1,3,0,0,0,0,2,0,0,2
142855,2023,China,Germany,0,3,7,10,24/06/2023,0,0,0,0,16,3,5,24,2,1,2,5,0,0,0,0,2,6,0,8
142855,2023,China,Italy,0,3,4,7,22/06/2023,0,0,1,1,9,5,9,23,0,1,3,4,0,0,1,1,3,3,0,6
142855,2023,USA,China,0,0,0,0,21/06/2023,0,0,0,0,0,0,0,0,0,0,0,0,0,0,0,0,0,0,0,0
142855,2023,Netherlands,China,0,1,7,8,20/06/2023,0,0,0,0,6,5,7,18,0,1,4,5,0,0,0,0,4,0,1,5
142855,2023,Iran,China,1,2,3,6,10/6/2023,0,0,0,0,8,1,6,15,0,1,0,1,0,0,0,0,3,0,0,3
142855,2023,China,France,0,3,11,14,9/6/2023,0,0,1,1,14,5,7,26,1,2,3,6,0,0,0,0,2,1,0,3
142855,2023,Serbia,China,0,2,12,14,8/6/2023,0,0,0,0,13,8,9,30,0,0,2,2,0,0,0,0,3,0,2,5
142855,2023,Bulgaria,China,0,5,9,14,6/6/2023,0,1,0,1,10,7,6,23,0,5,3,8,0,0,0,0,6,0,1,7
174297,2023,China,Canada,1,0,13,14,9/7/2023,16,0,53,69,0,0,2,2,0,3,1,4,0,0,0,0,4,0,0,4
174297,2023,Brazil,China,0,1,5,6,8/7/2023,6,0,27,33,0,0,0,0,0,0,1,1,0,0,0,0,1,0,0,1
174297,2023,China,Slovenia,0,0,4,4,6/7/2023,9,0,36,45,1,0,0,1,0,2,4,6,0,0,0,0,3,2,0,5
174297,2023,Japan,China,0,0,21,21,4/7/2023,23,1,67,91,0,0,0,0,3,4,5,12,0,1,0,1,3,2,3,8
174297,2023,China,Germany,1,0,15,16,24/06/2023,14,0,66,80,0,0,0,0,2,3,2,7,0,0,1,1,3,1,0,4
174297,2023,China,Italy,0,0,2,2,22/06/2023,8,0,11,19,0,0,0,0,1,0,0,1,0,0,1,1,0,0,0,0
174297,2023,USA,China,0,1,11,12,21/06/2023,18,0,47,65,1,0,2,3,0,1,1,2,0,0,0,0,1,9,0,10
174297,2023,Netherlands,China,0,1,9,10,20/06/2023,21,0,54,75,0,0,1,1,2,0,2,4,0,0,0,0,3,2,0,5
174297,2023,Iran,China,0,0,8,8,10/6/2023,5,0,45,50,0,0,0,0,0,4,0,4,0,0,0,0,1,0,0,1
174297,2023,China,France,0,0,10,10,9/6/2023,10,2,67,79,1,1,0,2,0,2,1,3,0,0,0,0,4,0,1,5
174297,2023,Serbia,China,0,2,8,10,8/6/2023,12,2,72,86,1,1,0,2,0,0,1,1,0,0,0,0,5,0,0,5
174297,2023,Bulgaria,China,1,1,11,13,6/6/2023,8,1,62,71,1,0,2,3,0,0,2,2,0,0,0,0,2,0,1,3
174295,2023,China,Canada,0,0,0,0,9/7/2023,0,0,0,0,0,0,0,0,0,0,0,0,0,0,0,0,0,0,0,0
174295,2023,Brazil,China,0,0,0,0,8/7/2023,0,0,0,0,0,0,0,0,0,0,0,0,0,0,0,0,0,0,0,0
174295,2023,China,Slovenia,0,0,0,0,6/7/2023,0,0,0,0,0,0,0,0,0,0,0,0,0,0,2,2,0,0,0,0
174295,2023,Japan,China,0,0,0,0,4/7/2023,0,0,0,0,0,0,0,0,0,0,0,0,0,0,0,0,0,0,0,0
174295,2023,China,Germany,0,0,0,0,24/06/2023,0,0,1,1,0,0,0,0,0,0,0,0,0,0,0,0,0,0,0,0
174295,2023,China,Italy,0,0,0,0,22/06/2023,0,0,6,6,0,0,0,0,0,0,0,0,2,3,11,16,4,3,1,8
174295,2023,USA,China,0,0,0,0,21/06/2023,0,0,0,0,0,0,0,0,0,0,0,0,0,0,0,0,0,0,0,0
174295,2023,Netherlands,China,0,0,0,0,20/06/2023,0,0,0,0,0,0,0,0,0,0,0,0,0,0,0,0,0,0,0,0
152518,2023,China,Canada,0,2,9,11,9/7/2023,0,0,3,3,5,6,7,18,1,3,0,4,4,2,21,27,3,5,0,8
152518,2023,Brazil,China,0,0,5,5,8/7/2023,0,0,1,1,6,2,4,12,0,1,1,2,0,1,10,11,2,0,0,2
152518,2023,China,Slovenia,0,3,13,16,6/7/2023,0,0,3,3,15,2,15,32,0,5,3,8,7,2,14,23,9,6,1,16
152518,2023,Japan,China,2,5,9,16,4/7/2023,0,0,4,4,15,2,9,26,0,1,1,2,4,1,16,21,5,3,2,10
152518,2023,China,Germany,1,6,12,19,24/06/2023,0,0,3,3,13,1,5,19,0,0,1,1,8,1,16,25,4,6,1,11
152518,2023,China,Italy,0,4,3,7,22/06/2023,0,1,1,2,7,3,3,13,0,1,0,1,5,0,10,15,4,1,0,5
152518,2023,USA,China,0,0,0,0,21/06/2023,0,0,0,0,0,0,0,0,0,0,0,0,0,0,0,0,0,0,0,0
152518,2023,Netherlands,China,0,0,1,1,20/06/2023,0,0,0,0,0,0,1,1,0,1,0,1,1,0,0,1,2,0,0,2
152518,2023,Iran,China,0,1,2,3,10/6/2023,0,0,1,1,2,1,0,3,0,0,1,1,2,1,2,5,0,0,1,1
152518,2023,China,France,0,0,1,1,9/6/2023,0,0,0,0,1,1,2,4,0,0,0,0,1,2,6,9,0,0,1,1
152518,2023,Serbia,China,0,3,6,9,8/6/2023,0,0,0,0,8,3,6,17,1,0,1,2,7,3,21,31,5,0,1,6
152518,2023,Bulgaria,China,2,5,12,19,6/6/2023,0,0,3,3,11,2,5,18,2,0,2,4,16,1,37,54,3,0,1,4
164632,2023,China,Canada,0,0,0,0,9/7/2023,0,0,0,0,0,0,0,0,0,0,0,0,0,0,0,0,0,0,0,0
164632,2023,Brazil,China,0,0,0,0,8/7/2023,0,0,0,0,0,0,0,0,0,0,0,0,0,0,0,0,0,0,0,0
164632,2023,China,Slovenia,0,0,0,0,6/7/2023,0,0,0,0,0,0,0,0,0,0,0,0,0,0,0,0,0,0,0,0
164632,2023,Japan,China,0,0,0,0,4/7/2023,0,0,0,0,0,0,0,0,0,0,0,0,0,0,0,0,0,0,0,0
164632,2023,China,Germany,0,0,0,0,24/06/2023,0,0,0,0,0,0,0,0,0,0,0,0,0,0,0,0,0,0,0,0
164632,2023,China,Italy,0,0,0,0,22/06/2023,0,0,0,0,0,0,0,0,0,0,0,0,0,0,0,0,0,0,0,0
164632,2023,USA,China,0,0,0,0,21/06/2023,0,0,0,0,0,0,0,0,0,0,0,0,0,0,0,0,0,0,0,0
164632,2023,Netherlands,China,0,0,0,0,20/06/2023,0,0,0,0,0,0,0,0,0,0,0,0,0,0,0,0,0,0,0,0
164632,2023,Iran,China,0,1,3,4,10/6/2023,5,0,21,26,0,0,1,1,1,2,2,5,0,0,0,0,1,0,1,2
164632,2023,China,France,0,1,0,1,9/6/2023,0,0,0,0,0,0,0,0,0,0,0,0,0,0,0,0,0,0,0,0
164632,2023,Serbia,China,0,0,0,0,8/6/2023,0,0,0,0,0,0,0,0,1,1,0,2,0,0,0,0,1,0,0,1
164632,2023,Bulgaria,China,0,0,0,0,6/6/2023,0,0,0,0,0,0,0,0,0,0,0,0,0,0,0,0,0,0,0,0
181103,2023,China,Canada,2,4,5,11,9/7/2023,0,0,4,4,8,1,3,12,0,7,4,11,0,0,1,1,1,0,0,1
181103,2023,Brazil,China,0,1,2,3,8/7/2023,0,0,1,1,0,0,1,1,0,0,3,3,0,0,1,1,0,0,0,0
181103,2023,China,Slovenia,0,0,4,4,6/7/2023,0,0,0,0,1,0,1,2,0,0,0,0,0,0,1,1,0,0,0,0
181103,2023,Japan,China,0,7,6,13,4/7/2023,0,0,1,1,8,2,4,14,8,5,9,22,0,0,1,1,3,0,0,3
181103,2023,China,Germany,0,1,2,3,24/06/2023,0,0,0,0,2,0,0,2,1,1,0,2,0,0,0,0,1,1,0,2
181103,2023,China,Italy,0,0,0,0,22/06/2023,0,0,0,0,0,0,0,0,0,0,0,0,0,0,0,0,0,0,0,0
181103,2023,USA,China,0,1,7,8,21/06/2023,1,0,1,2,2,2,3,7,0,6,5,11,0,0,2,2,0,1,0,1
181103,2023,Netherlands,China,1,3,6,10,20/06/2023,0,0,1,1,6,2,2,10,4,3,1,8,0,0,3,3,0,0,0,0
181103,2023,Iran,China,0,3,7,10,10/6/2023,0,0,0,0,4,1,3,8,4,6,6,16,0,0,1,1,1,0,0,1
181103,2023,China,France,0,3,6,9,9/6/2023,0,0,0,0,8,0,3,11,0,4,7,11,1,0,1,2,0,0,0,0
181103,2023,Serbia,China,0,2,7,9,8/6/2023,0,0,0,0,3,0,1,4,0,0,3,3,1,0,0,1,1,0,0,1
181103,2023,Bulgaria,China,1,4,13,18,6/6/2023,0,0,0,0,7,1,2,10,1,3,2,6,0,0,0,0,0,0,0,0
174159,2023,China,Canada,0,2,1,3,9/7/2023,0,0,1,1,1,0,3,4,0,4,0,4,0,0,5,5,0,1,0,1
174159,2023,Brazil,China,1,2,4,7,8/7/2023,0,0,4,4,2,6,10,18,0,0,0,0,0,0,1,1,3,0,0,3
174159,2023,China,Slovenia,2,1,4,7,6/7/2023,0,0,1,1,6,2,8,16,0,3,2,5,0,0,2,2,1,1,0,2
174159,2023,Japan,China,1,1,10,12,4/7/2023,0,0,1,1,6,0,6,12,1,1,2,4,1,0,7,8,1,0,0,1
174159,2023,China,Germany,0,0,1,1,24/06/2023,0,0,0,0,0,0,0,0,0,0,0,0,0,0,0,0,0,0,0,0
174159,2023,China,Italy,0,4,3,7,22/06/2023,0,0,0,0,12,9,4,25,0,2,2,4,3,0,17,20,2,1,0,3
174159,2023,USA,China,1,2,6,9,21/06/2023,0,0,1,1,12,2,9,23,0,1,2,3,0,1,6,7,7,4,0,11
174159,2023,Netherlands,China,0,1,1,2,20/06/2023,0,0,0,0,0,2,1,3,0,0,2,2,2,0,0,2,0,0,0,0
174159,2023,Iran,China,0,2,5,7,10/6/2023,0,0,1,1,3,5,8,16,0,1,0,1,6,2,15,23,3,0,1,4
174159,2023,China,France,0,3,13,16,9/6/2023,0,0,1,1,7,2,12,21,2,2,0,4,4,0,13,17,6,1,2,9
174159,2023,Serbia,China,0,0,2,2,8/6/2023,0,0,0,0,1,0,0,1,0,0,0,0,1,0,5,6,1,0,0,1
174159,2023,Bulgaria,China,0,0,0,0,6/6/2023,0,0,0,0,0,0,0,0,0,0,0,0,0,0,0,0,0,0,0,0
168175,2023,China,Canada,0,1,12,13,9/7/2023,0,0,1,1,5,4,1,10,3,4,2,9,0,0,0,0,1,0,0,1
168175,2023,Brazil,China,0,1,6,7,8/7/2023,0,0,0,0,1,1,3,5,0,4,2,6,0,0,0,0,0,0,0,0
168175,2023,China,Slovenia,0,2,18,20,6/7/2023,0,0,1,1,6,3,6,15,2,1,3,6,0,0,0,0,1,1,2,4
168175,2023,Japan,China,0,4,17,21,4/7/2023,0,0,0,0,6,0,0,6,1,2,4,7,0,0,0,0,1,0,0,1
168175,2023,China,Germany,1,1,18,20,24/06/2023,0,0,0,0,4,0,3,7,0,6,4,10,0,0,1,1,1,0,0,1
168175,2023,China,Italy,0,0,11,11,22/06/2023,0,0,0,0,3,2,2,7,1,2,4,7,0,0,0,0,0,1,0,1
168175,2023,USA,China,0,0,0,0,21/06/2023,0,0,0,0,0,0,0,0,0,0,0,0,0,0,0,0,0,0,0,0
168175,2023,Netherlands,China,0,1,10,11,20/06/2023,0,0,1,1,8,1,4,13,1,2,3,6,0,0,0,0,0,0,0,0
168175,2023,Iran,China,2,0,17,19,10/6/2023,0,0,1,1,3,0,3,6,3,6,2,11,0,0,0,0,2,0,1,3
168175,2023,China,France,0,2,11,13,9/6/2023,0,0,0,0,4,0,4,8,2,4,1,7,0,0,1,1,5,1,0,6
168175,2023,Serbia,China,0,0,5,5,8/6/2023,0,0,0,0,1,0,1,2,1,0,3,4,1,0,0,1,2,0,0,2
168175,2023,Bulgaria,China,1,1,11,13,6/6/2023,0,0,0,0,5,0,2,7,1,3,2,6,0,0,1,1,1,0,0,1
174158,2023,China,Canada,0,0,0,0,9/7/2023,0,0,5,5,0,0,0,0,0,0,0,0,3,0,21,24,5,2,0,7
174158,2023,Brazil,China,0,0,0,0,8/7/2023,0,0,6,6,0,0,0,0,0,0,0,0,3,1,5,9,3,2,0,5
174158,2023,China,Slovenia,0,0,0,0,6/7/2023,0,0,5,5,0,0,0,0,0,0,0,0,3,2,12,17,9,3,2,14
174158,2023,Japan,China,0,0,0,0,4/7/2023,0,0,5,5,0,0,0,0,0,0,0,0,5,1,14,20,11,6,3,20
174158,2023,China,Germany,0,0,0,0,24/06/2023,0,0,4,4,0,0,0,0,0,0,0,0,8,0,12,20,12,10,2,24
174158,2023,China,Italy,0,0,0,0,22/06/2023,0,0,0,0,0,0,0,0,0,0,0,0,0,0,0,0,0,0,0,0
174158,2023,USA,China,0,0,0,0,21/06/2023,0,0,5,5,0,0,0,0,0,0,0,0,4,1,19,24,4,4,0,8
174158,2023,Netherlands,China,0,0,0,0,20/06/2023,0,0,4,4,0,0,0,0,0,0,0,0,6,2,18,26,6,3,0,9
174158,2023,Iran,China,0,0,0,0,10/6/2023,0,0,1,1,0,0,0,0,0,0,0,0,6,3,17,26,2,2,1,5
174158,2023,China,France,0,0,0,0,9/6/2023,0,0,6,6,0,0,0,0,0,0,0,0,3,2,7,12,11,1,4,16
174158,2023,Serbia,China,0,0,0,0,8/6/2023,0,0,4,4,0,0,0,0,0,0,0,0,4,3,8,15,8,0,0,8
174158,2023,Bulgaria,China,0,0,0,0,6/6/2023,0,0,5,5,0,0,0,0,0,0,0,0,2,2,8,12,8,1,2,11
152511,2023,China,Canada,0,0,4,4,9/7/2023,2,1,20,23,0,0,0,0,0,0,0,0,0,0,0,0,0,0,0,0
152511,2023,Brazil,China,0,1,4,5,8/7/2023,4,0,37,41,0,0,0,0,0,0,1,1,0,1,0,1,4,2,1,7
152511,2023,China,Slovenia,0,1,8,9,6/7/2023,11,1,45,57,0,0,0,0,0,1,2,3,0,0,0,0,2,0,1,3
152511,2023,Japan,China,0,0,0,0,4/7/2023,0,0,0,0,0,0,0,0,0,0,0,0,0,0,0,0,0,0,0,0
152511,2023,China,Germany,0,0,0,0,24/06/2023,0,0,1,1,0,0,0,0,0,1,0,1,0,0,0,0,1,1,0,2
152511,2023,China,Italy,1,1,8,10,22/06/2023,7,0,42,49,0,0,0,0,0,1,0,1,0,0,0,0,1,2,0,3
152511,2023,USA,China,0,0,0,0,21/06/2023,0,0,0,0,0,0,0,0,0,0,0,0,0,0,0,0,0,0,0,0
152511,2023,Netherlands,China,0,0,0,0,20/06/2023,0,0,3,3,0,0,0,0,0,0,0,0,0,0,0,0,0,0,0,0
142598,2023,China,Canada,0,0,0,0,9/7/2023,0,0,0,0,0,0,0,0,0,0,0,0,0,0,0,0,0,0,0,0
142598,2023,Brazil,China,0,0,0,0,8/7/2023,0,0,0,0,0,0,0,0,0,0,0,0,0,0,0,0,0,0,0,0
142598,2023,China,Slovenia,0,0,0,0,6/7/2023,0,0,0,0,0,0,0,0,0,0,0,0,0,0,0,0,0,0,0,0
142598,2023,Japan,China,0,0,0,0,4/7/2023,0,0,0,0,0,0,0,0,0,0,0,0,0,0,0,0,0,0,0,0
168271,2023,China,Canada,1,2,13,16,9/7/2023,0,0,2,2,24,4,13,41,0,3,2,5,1,3,22,26,2,1,2,5
168271,2023,Brazil,China,0,4,3,7,8/7/2023,0,0,4,4,8,5,12,25,1,2,2,5,6,0,27,33,3,0,1,4
168271,2023,China,Slovenia,0,1,11,12,6/7/2023,0,1,4,5,14,5,17,36,2,2,4,8,9,1,26,36,7,3,0,10
168271,2023,Japan,China,2,3,14,19,4/7/2023,0,0,4,4,17,5,14,36,2,4,0,6,4,5,27,36,3,0,1,4
168271,2023,China,Germany,2,3,10,15,24/06/2023,0,0,2,2,20,4,6,30,3,1,2,6,3,2,15,20,0,5,1,6
168271,2023,China,Italy,0,0,0,0,22/06/2023,0,0,0,0,0,0,0,0,0,0,0,0,0,0,0,0,0,0,0,0
168271,2023,USA,China,3,1,11,15,21/06/2023,0,0,2,2,12,5,7,24,0,1,3,4,3,2,8,13,3,2,0,5
168271,2023,Netherlands,China,4,2,7,13,20/06/2023,0,0,2,2,10,10,9,29,1,0,1,2,4,0,17,21,6,3,0,9
168271,2023,Iran,China,1,2,9,12,10/6/2023,0,0,5,5,15,4,7,26,4,2,1,7,8,1,19,28,3,0,2,5
168271,2023,China,France,1,2,11,14,9/6/2023,0,0,2,2,7,6,11,24,1,2,4,7,7,5,24,36,6,1,1,8
168271,2023,Serbia,China,1,2,7,10,8/6/2023,0,0,0,0,14,6,7,27,2,4,2,8,2,2,15,19,3,0,0,3
168271,2023,Bulgaria,China,2,6,8,16,6/6/2023,0,0,3,3,21,6,9,36,6,3,2,11,1,1,14,16,5,0,1,6
169310,2023,China,Canada,0,0,1,1,9/7/2023,0,0,0,0,1,0,0,1,0,0,0,0,0,0,1,1,0,0,0,0
169310,2023,Brazil,China,2,2,1,5,8/7/2023,0,0,0,0,9,2,6,17,0,0,0,0,0,0,9,9,0,0,0,0
169310,2023,China,Slovenia,0,0,1,1,6/7/2023,0,0,0,0,0,0,0,0,0,0,0,0,0,0,0,0,0,1,0,1
169310,2023,Japan,China,0,1,3,4,4/7/2023,0,0,0,0,0,0,0,0,0,0,0,0,0,0,0,0,0,0,0,0
169310,2023,China,Germany,0,1,0,1,24/06/2023,0,0,0,0,0,0,0,0,0,0,0,0,0,0,0,0,0,0,0,0
169310,2023,China,Italy,0,0,3,3,22/06/2023,0,0,0,0,1,0,0,1,0,1,1,2,1,1,8,10,1,1,0,2
169310,2023,USA,China,1,4,6,11,21/06/2023,0,0,0,0,10,0,4,14,0,1,0,1,1,2,12,15,5,3,0,8
169310,2023,Netherlands,China,1,2,6,9,20/06/2023,0,0,2,2,4,7,3,14,0,2,0,2,0,0,11,11,2,2,2,6
169310,2023,Iran,China,0,0,0,0,10/6/2023,0,0,0,0,0,0,0,0,0,0,0,0,0,0,0,0,0,0,0,0
169310,2023,China,France,0,0,0,0,9/6/2023,0,0,0,0,0,0,0,0,0,0,0,0,0,0,0,0,0,0,0,0
169310,2023,Serbia,China,0,0,0,0,8/6/2023,0,0,0,0,0,0,0,0,0,0,0,0,0,0,1,1,0,0,0,0
169310,2023,Bulgaria,China,0,1,2,3,6/6/2023,0,0,0,0,0,0,0,0,0,0,0,0,0,0,0,0,0,0,0,0
147273,2023,Cuba,Iran,0,1,2,3,9/7/2023,0,0,0,0,1,0,1,2,0,1,2,3,0,0,1,1,3,0,0,3
147273,2023,Cuba,Germany,0,0,0,0,8/7/2023,0,0,0,0,0,0,0,0,0,0,0,0,0,0,0,0,0,0,0,0
147273,2023,Serbia,Cuba,0,4,7,11,7/7/2023,0,0,1,1,4,1,2,7,2,2,3,7,0,0,3,3,1,0,0,1
147273,2023,USA,Cuba,0,4,4,8,6/7/2023,0,0,1,1,4,2,1,7,1,4,5,10,0,0,0,0,3,1,0,4
147273,2023,Bulgaria,Cuba,0,1,16,17,25/06/2023,0,0,0,0,6,4,1,11,0,6,5,11,1,0,2,3,1,2,0,3
147273,2023,France,Cuba,0,1,4,5,23/06/2023,0,0,1,1,1,2,2,5,1,3,4,8,0,0,1,1,1,0,0,1
147273,2023,Slovenia,Cuba,0,2,5,7,22/06/2023,0,0,0,0,6,1,2,9,0,4,3,7,0,0,1,1,1,0,0,1
147273,2023,Japan,Cuba,0,2,5,7,21/06/2023,0,0,3,3,6,0,1,7,1,3,2,6,0,0,0,0,0,0,0,0
147273,2023,Brazil,Cuba,0,0,0,0,10/6/2023,0,0,0,0,0,0,0,0,0,0,0,0,0,0,0,0,0,0,0,0
147273,2023,Italy,Cuba,0,4,3,7,9/6/2023,0,0,0,0,5,2,3,10,0,5,5,10,0,1,1,2,1,2,0,3
147273,2023,Netherlands,Cuba,2,1,8,11,8/6/2023,0,0,2,2,6,2,0,8,2,3,2,7,0,0,0,0,0,0,0,0
147273,2023,Canada,Cuba,1,3,9,13,7/6/2023,0,0,0,0,8,2,5,15,2,7,13,22,0,0,0,0,3,1,0,4
151814,2023,Cuba,Iran,0,4,5,9,9/7/2023,0,0,2,2,4,2,4,10,0,1,0,1,3,1,9,13,1,4,0,5
151814,2023,Cuba,Germany,0,2,10,12,8/7/2023,0,0,2,2,4,0,5,9,0,2,0,2,0,1,4,5,5,0,0,5
151814,2023,Serbia,Cuba,1,4,13,18,7/7/2023,0,0,6,6,9,5,14,28,0,5,1,6,2,3,30,35,4,1,0,5
151814,2023,USA,Cuba,0,1,3,4,6/7/2023,0,0,1,1,1,0,2,3,0,1,0,1,1,0,4,5,0,0,0,0
151814,2023,Bulgaria,Cuba,0,1,7,8,25/06/2023,0,0,1,1,10,3,3,16,2,1,0,3,0,0,7,7,3,0,0,3
151814,2023,France,Cuba,0,1,2,3,23/06/2023,0,0,0,0,0,0,1,1,0,0,0,0,0,0,1,1,0,0,0,0
151814,2023,Slovenia,Cuba,1,1,5,7,22/06/2023,0,0,0,0,0,0,1,1,0,0,1,1,0,0,0,0,2,0,0,2
151814,2023,Japan,Cuba,0,1,2,3,21/06/2023,0,0,0,0,0,0,0,0,0,0,0,0,0,0,2,2,0,1,0,1
151814,2023,Brazil,Cuba,0,0,2,2,10/6/2023,0,0,0,0,0,0,0,0,0,0,0,0,0,0,0,0,0,0,0,0
151814,2023,Italy,Cuba,0,0,0,0,9/6/2023,0,0,0,0,0,0,0,0,0,0,0,0,0,0,0,0,0,0,0,0
151814,2023,Netherlands,Cuba,0,4,6,10,8/6/2023,0,0,0,0,6,1,13,20,0,0,2,2,1,0,10,11,5,2,2,9
151814,2023,Canada,Cuba,0,1,2,3,7/6/2023,0,0,0,0,0,0,6,6,0,1,2,3,1,0,4,5,0,1,0,1
147263,2023,Cuba,Iran,0,2,11,13,9/7/2023,0,0,1,1,7,2,5,14,4,8,5,17,0,0,2,2,3,1,1,5
147263,2023,Cuba,Germany,0,2,9,11,8/7/2023,0,0,1,1,4,0,1,5,3,2,3,8,0,0,3,3,2,1,2,5
147263,2023,Serbia,Cuba,0,1,10,11,7/7/2023,0,0,0,0,4,1,4,9,6,7,8,21,0,1,4,5,3,2,1,6
147263,2023,USA,Cuba,0,2,7,9,6/7/2023,0,0,0,0,2,1,3,6,1,3,1,5,0,0,0,0,3,0,1,4
147263,2023,Bulgaria,Cuba,1,4,9,14,25/06/2023,0,0,1,1,5,1,1,7,3,4,1,8,3,0,4,7,0,0,0,0
147263,2023,France,Cuba,0,2,5,7,23/06/2023,0,0,0,0,6,0,2,8,2,4,4,10,0,0,1,1,3,0,0,3
147263,2023,Slovenia,Cuba,0,3,5,8,22/06/2023,0,0,2,2,7,1,1,9,0,3,2,5,0,0,2,2,1,0,0,1
147263,2023,Japan,Cuba,0,2,4,6,21/06/2023,0,0,1,1,5,3,0,8,1,6,2,9,2,0,0,2,0,0,0,0
147263,2023,Brazil,Cuba,1,5,13,19,10/6/2023,0,0,0,0,8,1,2,11,4,6,5,15,0,0,2,2,2,1,0,3
147263,2023,Italy,Cuba,1,4,10,15,9/6/2023,0,0,0,0,4,1,2,7,5,6,1,12,0,0,4,4,3,0,0,3
147263,2023,Netherlands,Cuba,0,1,8,9,8/6/2023,0,0,0,0,3,0,6,9,0,6,6,12,0,1,3,4,1,2,0,3
147263,2023,Canada,Cuba,0,4,15,19,7/6/2023,0,1,2,3,12,2,2,16,0,6,11,17,1,0,0,1,5,1,1,7
168412,2023,Cuba,Iran,0,1,3,4,9/7/2023,6,0,16,22,0,0,2,2,0,3,0,3,0,0,0,0,1,1,0,2
168412,2023,Cuba,Germany,0,0,0,0,8/7/2023,0,0,0,0,0,0,0,0,0,0,0,0,0,0,0,0,0,0,0,0
168412,2023,Serbia,Cuba,0,0,10,10,7/7/2023,5,0,20,25,0,0,2,2,1,1,1,3,0,0,0,0,1,2,0,3
168412,2023,USA,Cuba,0,0,0,0,6/7/2023,0,0,0,0,0,0,0,0,0,0,0,0,0,0,0,0,0,0,0,0
168412,2023,Bulgaria,Cuba,0,1,0,1,25/06/2023,2,0,5,7,0,0,0,0,0,0,0,0,0,0,0,0,0,0,0,0
168412,2023,France,Cuba,1,2,5,8,23/06/2023,15,1,58,74,0,0,4,4,0,3,1,4,0,0,0,0,2,0,0,2
168412,2023,Slovenia,Cuba,0,1,6,7,22/06/2023,13,0,34,47,0,2,0,2,1,4,1,6,0,0,0,0,2,1,0,3
168412,2023,Japan,Cuba,0,1,2,3,21/06/2023,6,0,9,15,0,0,0,0,1,0,0,1,0,0,0,0,0,1,0,1
168412,2023,Brazil,Cuba,0,0,0,0,10/6/2023,0,0,0,0,0,0,0,0,0,0,0,0,0,0,0,0,0,0,0,0
168412,2023,Italy,Cuba,0,2,4,6,9/6/2023,4,0,25,29,1,0,0,1,0,2,2,4,0,0,0,0,1,0,0,1
168412,2023,Netherlands,Cuba,0,1,0,1,8/6/2023,1,0,9,10,0,0,0,0,0,0,0,0,0,0,0,0,1,1,0,2
168412,2023,Canada,Cuba,0,0,0,0,7/6/2023,0,0,0,0,0,0,0,0,0,0,0,0,0,0,0,0,0,0,0,0
132361,2023,Cuba,Iran,0,0,0,0,9/7/2023,0,1,6,7,0,0,0,0,0,0,0,0,2,2,8,12,8,2,0,10
132361,2023,Cuba,Germany,0,0,0,0,8/7/2023,0,0,3,3,0,0,0,0,0,0,0,0,4,2,13,19,3,5,0,8
132361,2023,Serbia,Cuba,0,0,0,0,7/7/2023,0,1,2,3,0,0,0,0,0,0,0,0,4,1,12,17,5,5,1,11
132361,2023,USA,Cuba,0,0,0,0,6/7/2023,0,0,3,3,0,0,0,0,0,0,0,0,6,2,12,20,5,4,0,9
132361,2023,Bulgaria,Cuba,0,0,0,0,25/06/2023,0,0,0,0,0,0,0,0,0,0,0,0,0,0,0,0,0,0,0,0
132361,2023,France,Cuba,0,0,0,0,23/06/2023,0,0,0,0,0,0,0,0,0,0,0,0,0,0,0,0,0,0,0,0
132361,2023,Slovenia,Cuba,0,0,0,0,22/06/2023,0,0,1,1,0,0,0,0,0,0,0,0,2,0,11,13,3,5,1,9
132361,2023,Japan,Cuba,0,0,0,0,21/06/2023,0,0,4,4,0,0,0,0,0,0,0,0,1,0,6,7,1,4,1,6
132361,2023,Brazil,Cuba,0,0,0,0,10/6/2023,0,0,1,1,0,0,0,0,0,0,0,0,3,0,12,15,8,4,3,15
132361,2023,Italy,Cuba,0,0,0,0,9/6/2023,0,0,6,6,0,0,0,0,0,0,0,0,3,1,7,11,4,0,1,5
132361,2023,Netherlands,Cuba,0,0,0,0,8/6/2023,0,0,6,6,0,0,0,0,0,0,0,0,2,0,13,15,4,2,1,7
132361,2023,Canada,Cuba,0,0,0,0,7/6/2023,0,0,5,5,0,0,0,0,0,0,0,0,12,2,24,38,10,6,0,16
147268,2023,Cuba,Iran,0,0,0,0,9/7/2023,0,0,0,0,0,0,0,0,0,0,0,0,0,0,0,0,0,0,0,0
147268,2023,Cuba,Germany,0,0,0,0,8/7/2023,0,0,0,0,0,0,0,0,0,0,0,0,0,0,0,0,0,0,0,0
147268,2023,Serbia,Cuba,0,0,0,0,7/7/2023,0,0,0,0,0,0,0,0,0,0,0,0,0,0,0,0,0,0,0,0
147268,2023,USA,Cuba,0,0,0,0,6/7/2023,0,0,0,0,0,0,0,0,0,0,0,0,0,0,0,0,0,0,0,0
147268,2023,Bulgaria,Cuba,0,0,1,1,25/06/2023,0,0,0,0,1,0,1,2,0,0,0,0,0,0,0,0,0,0,0,0
147268,2023,France,Cuba,0,2,1,3,23/06/2023,0,0,1,1,5,0,3,8,0,1,0,1,0,0,0,0,2,1,1,4
147268,2023,Slovenia,Cuba,0,1,0,1,22/06/2023,0,0,0,0,0,0,1,1,0,1,0,1,0,0,0,0,0,1,0,1
147268,2023,Japan,Cuba,0,0,0,0,21/06/2023,0,0,0,0,1,0,0,1,0,0,0,0,0,0,0,0,0,0,0,0
147268,2023,Brazil,Cuba,0,0,0,0,10/6/2023,0,0,0,0,0,0,0,0,0,0,0,0,0,0,0,0,0,0,0,0
147268,2023,Italy,Cuba,0,1,1,2,9/6/2023,0,0,1,1,2,0,3,5,1,2,0,3,0,0,0,0,1,0,0,1
147268,2023,Netherlands,Cuba,0,0,0,0,8/6/2023,0,0,0,0,0,0,0,0,0,0,0,0,0,0,0,0,0,0,0,0
147268,2023,Canada,Cuba,0,0,0,0,7/6/2023,0,0,0,0,0,0,0,0,1,1,1,3,0,0,0,0,0,0,0,0
157477,2023,Cuba,Iran,0,2,10,12,9/7/2023,27,1,59,87,0,0,0,0,3,1,3,7,0,0,0,0,4,4,1,9
157477,2023,Cuba,Germany,0,1,9,10,8/7/2023,13,1,53,67,0,1,0,1,2,2,1,5,0,1,2,3,5,0,0,5
157477,2023,Serbia,Cuba,0,3,6,9,7/7/2023,18,2,52,72,0,0,1,1,3,2,3,8,0,0,0,0,1,2,0,3
157477,2023,USA,Cuba,0,1,7,8,6/7/2023,18,1,36,55,0,0,0,0,1,1,0,2,0,0,0,0,1,1,0,2
157477,2023,Bulgaria,Cuba,0,0,12,12,25/06/2023,27,0,70,97,1,0,1,2,1,5,3,9,0,0,0,0,4,6,0,10
157477,2023,France,Cuba,0,0,0,0,23/06/2023,0,0,0,0,0,0,0,0,0,0,0,0,0,0,0,0,0,0,0,0
157477,2023,Slovenia,Cuba,0,0,4,4,22/06/2023,6,0,25,31,1,0,0,1,0,3,2,5,0,0,0,0,2,2,0,4
157477,2023,Japan,Cuba,0,0,4,4,21/06/2023,12,0,28,40,0,2,0,2,0,2,1,3,0,0,0,0,0,3,0,3
157477,2023,Brazil,Cuba,0,1,19,20,10/6/2023,24,0,82,106,1,0,0,1,2,1,5,8,0,0,0,0,5,4,1,10
157477,2023,Italy,Cuba,0,0,11,11,9/6/2023,10,0,38,48,1,1,0,2,1,0,0,1,0,1,3,4,3,1,0,4
157477,2023,Netherlands,Cuba,0,2,9,11,8/6/2023,9,1,45,55,1,0,1,2,0,2,1,3,0,0,1,1,3,1,1,5
157477,2023,Canada,Cuba,0,1,14,15,7/6/2023,19,1,102,122,1,0,0,1,1,5,4,10,0,0,0,0,7,4,0,11
169940,2023,Cuba,Iran,2,7,12,21,9/7/2023,0,0,3,3,25,6,5,36,1,2,1,4,0,0,0,0,1,4,1,6
169940,2023,Cuba,Germany,0,5,6,11,8/7/2023,0,0,1,1,15,1,12,28,1,5,0,6,1,0,1,2,2,3,0,5
169940,2023,Serbia,Cuba,5,7,10,22,7/7/2023,0,0,1,1,24,12,9,45,1,1,3,5,0,0,0,0,3,1,0,4
169940,2023,USA,Cuba,1,3,8,12,6/7/2023,0,0,1,1,10,6,8,24,0,1,0,1,0,0,0,0,2,0,2,4
169940,2023,Bulgaria,Cuba,6,6,13,25,25/06/2023,0,0,1,1,21,6,9,36,0,2,1,3,1,0,1,2,7,3,1,11
169940,2023,France,Cuba,0,2,6,8,23/06/2023,0,0,0,0,4,7,2,13,0,0,3,3,0,0,0,0,0,3,0,3
169940,2023,Slovenia,Cuba,1,2,10,13,22/06/2023,0,0,0,0,12,10,9,31,0,2,4,6,0,1,0,1,1,2,1,4
169940,2023,Japan,Cuba,1,5,7,13,21/06/2023,0,0,0,0,4,3,6,13,1,0,1,2,0,0,0,0,5,2,0,7
169940,2023,Brazil,Cuba,2,4,18,24,10/6/2023,0,0,4,4,26,6,6,38,2,2,2,6,0,0,2,2,5,3,0,8
169940,2023,Italy,Cuba,0,2,9,11,9/6/2023,0,0,2,2,6,7,10,23,1,5,2,8,0,0,0,0,4,5,1,10
169940,2023,Netherlands,Cuba,1,4,10,15,8/6/2023,0,0,1,1,9,8,5,22,2,5,3,10,0,0,0,0,2,7,0,9
169940,2023,Canada,Cuba,2,5,14,21,7/6/2023,0,0,1,1,24,11,6,41,2,3,3,8,0,0,0,0,8,4,3,15
147272,2023,Cuba,Iran,0,0,0,0,9/7/2023,0,0,0,0,0,0,0,0,0,0,0,0,0,0,0,0,0,0,0,0
147272,2023,Cuba,Germany,0,0,0,0,8/7/2023,0,0,0,0,0,0,0,0,0,0,0,0,0,0,0,0,0,0,0,0
147272,2023,Serbia,Cuba,0,0,0,0,7/7/2023,0,0,0,0,0,0,0,0,0,0,0,0,0,0,0,0,0,0,0,0
147272,2023,USA,Cuba,0,0,0,0,6/7/2023,2,0,2,4,0,0,0,0,0,1,0,1,0,0,0,0,0,0,0,0
147272,2023,Bulgaria,Cuba,0,0,0,0,25/06/2023,0,0,0,0,0,0,0,0,0,0,0,0,0,0,0,0,0,0,0,0
147272,2023,France,Cuba,0,0,0,0,23/06/2023,0,0,0,0,0,0,0,0,0,0,0,0,0,0,0,0,0,0,0,0
147272,2023,Slovenia,Cuba,0,0,0,0,22/06/2023,0,0,0,0,0,0,0,0,0,0,0,0,0,0,0,0,0,0,0,0
147272,2023,Japan,Cuba,0,0,0,0,21/06/2023,0,0,0,0,0,0,0,0,0,0,0,0,0,0,0,0,0,0,0,0
147272,2023,Brazil,Cuba,0,0,0,0,10/6/2023,0,0,0,0,0,0,0,0,0,0,0,0,0,0,0,0,0,0,0,0
147272,2023,Italy,Cuba,0,0,0,0,9/6/2023,0,0,0,0,0,0,0,0,0,0,0,0,0,0,0,0,0,0,0,0
147272,2023,Netherlands,Cuba,0,0,0,0,8/6/2023,0,0,0,0,0,0,0,0,0,0,0,0,0,0,0,0,0,0,0,0
147272,2023,Canada,Cuba,0,0,0,0,7/6/2023,0,0,0,0,0,0,0,0,0,0,0,0,0,0,0,0,0,0,0,0
151817,2023,Cuba,Iran,3,5,15,23,9/7/2023,0,0,2,2,22,3,8,33,2,3,4,9,9,0,32,41,1,5,1,7
151817,2023,Cuba,Germany,1,3,8,12,8/7/2023,0,1,5,6,11,2,10,23,1,0,1,2,1,4,21,26,4,2,1,7
151817,2023,Serbia,Cuba,2,4,9,15,7/7/2023,0,0,2,2,12,3,6,21,0,3,0,3,6,2,17,25,5,1,1,7
151817,2023,USA,Cuba,1,3,6,10,6/7/2023,0,0,0,0,11,4,3,18,0,1,1,2,2,4,11,17,4,1,0,5
151817,2023,Bulgaria,Cuba,1,4,10,15,25/06/2023,0,0,7,7,17,6,9,32,1,4,1,6,4,1,15,20,11,2,2,15
151817,2023,France,Cuba,3,2,8,13,23/06/2023,0,0,2,2,9,5,7,21,0,5,2,7,4,0,9,13,7,1,2,10
151817,2023,Slovenia,Cuba,0,4,9,13,22/06/2023,0,0,5,5,9,5,6,20,0,6,2,8,6,2,20,28,2,3,0,5
151817,2023,Japan,Cuba,1,4,6,11,21/06/2023,0,0,1,1,8,2,5,15,1,2,3,6,4,0,14,18,0,3,0,3
151817,2023,Brazil,Cuba,2,6,12,20,10/6/2023,0,0,5,5,14,4,17,35,0,5,4,9,6,1,27,34,4,5,2,11
151817,2023,Italy,Cuba,2,4,7,13,9/6/2023,0,1,6,7,11,3,9,23,1,2,1,4,1,0,21,22,2,0,1,3
151817,2023,Netherlands,Cuba,0,2,8,10,8/6/2023,0,0,6,6,9,5,5,19,1,0,3,4,4,0,21,25,2,1,0,3
151817,2023,Canada,Cuba,0,5,14,19,7/6/2023,0,0,7,7,15,7,12,34,0,2,3,5,6,1,20,27,6,5,0,11
182877,2023,Cuba,Iran,0,1,15,16,9/7/2023,0,0,0,0,4,2,3,9,0,6,3,9,0,0,0,0,1,1,0,2
182877,2023,Cuba,Germany,0,2,4,6,8/7/2023,0,0,0,0,2,1,1,4,4,2,3,9,0,0,0,0,0,0,0,0
182877,2023,Serbia,Cuba,0,1,2,3,7/7/2023,0,0,0,0,0,0,1,1,1,0,0,1,0,0,1,1,0,0,0,0
182877,2023,USA,Cuba,0,0,0,0,6/7/2023,0,0,0,0,0,0,0,0,0,0,0,0,0,0,0,0,0,0,0,0
182877,2023,Bulgaria,Cuba,0,0,2,2,25/06/2023,0,0,0,0,0,0,0,0,0,1,0,1,0,0,0,0,0,0,0,0
182877,2023,France,Cuba,0,1,1,2,23/06/2023,0,0,0,0,0,1,2,3,2,3,0,5,0,0,0,0,0,0,0,0
182877,2023,Slovenia,Cuba,0,0,0,0,22/06/2023,0,0,0,0,0,0,0,0,0,0,0,0,0,0,0,0,0,0,0,0
182877,2023,Japan,Cuba,0,0,0,0,21/06/2023,0,0,0,0,0,0,0,0,0,0,0,0,0,0,0,0,0,0,0,0
182877,2023,Brazil,Cuba,0,2,7,9,10/6/2023,0,0,0,0,4,1,1,6,4,6,4,14,0,0,1,1,0,1,0,1
182877,2023,Italy,Cuba,0,0,0,0,9/6/2023,0,0,0,0,0,0,0,0,0,0,0,0,0,0,0,0,0,0,0,0
182877,2023,Netherlands,Cuba,0,0,0,0,8/6/2023,0,0,0,0,0,0,0,0,0,0,0,0,0,0,0,0,0,0,0,0
182877,2023,Canada,Cuba,0,0,0,0,7/6/2023,0,0,0,0,0,0,0,0,0,0,0,0,0,0,0,0,0,0,0,0
168417,2023,Cuba,Iran,1,2,3,6,9/7/2023,0,0,0,0,0,0,0,0,0,0,0,0,0,0,0,0,1,0,0,1
168417,2023,Cuba,Germany,0,1,4,5,8/7/2023,0,0,0,0,0,0,0,0,0,0,0,0,0,0,0,0,0,1,0,1
168417,2023,Serbia,Cuba,0,2,4,6,7/7/2023,0,0,0,0,0,0,0,0,0,0,0,0,0,0,0,0,0,0,0,0
168417,2023,USA,Cuba,0,0,0,0,6/7/2023,0,0,0,0,0,0,0,0,0,0,0,0,0,0,0,0,0,0,0,0
168417,2023,Bulgaria,Cuba,0,3,1,4,25/06/2023,0,0,1,1,0,1,1,2,1,0,0,1,0,0,0,0,0,0,0,0
168417,2023,France,Cuba,0,2,0,2,23/06/2023,0,0,0,0,0,0,0,0,0,0,0,0,0,0,0,0,0,0,0,0
168417,2023,Slovenia,Cuba,0,1,3,4,22/06/2023,0,0,0,0,0,0,0,0,0,0,0,0,0,0,0,0,0,0,0,0
168417,2023,Japan,Cuba,0,1,3,4,21/06/2023,0,0,0,0,0,0,0,0,0,0,0,0,0,0,0,0,0,1,0,1
168417,2023,Brazil,Cuba,0,3,3,6,10/6/2023,0,0,0,0,0,0,0,0,0,0,0,0,0,0,0,0,0,0,0,0
168417,2023,Italy,Cuba,0,1,2,3,9/6/2023,0,0,0,0,0,0,0,0,0,0,0,0,0,0,0,0,0,0,0,0
168417,2023,Netherlands,Cuba,0,1,0,1,8/6/2023,0,0,0,0,0,0,0,0,0,0,0,0,0,0,0,0,0,0,0,0
168417,2023,Canada,Cuba,0,1,5,6,7/6/2023,0,0,0,0,0,0,0,0,0,0,0,0,0,0,0,0,2,0,0,2
157318,2023,Cuba,Iran,1,5,7,13,9/7/2023,0,0,0,0,13,4,2,19,1,0,3,4,6,0,23,29,4,4,0,8
157318,2023,Cuba,Germany,0,1,2,3,8/7/2023,0,0,0,0,3,2,4,9,0,1,1,2,0,1,3,4,0,0,0,0
157318,2023,Serbia,Cuba,0,0,1,1,7/7/2023,0,0,0,0,0,0,0,0,0,0,0,0,0,0,0,0,0,0,0,0
157318,2023,USA,Cuba,0,2,5,7,6/7/2023,0,0,1,1,2,1,5,8,1,4,0,5,2,2,9,13,0,0,1,1
157318,2023,Bulgaria,Cuba,0,2,5,7,25/06/2023,0,0,1,1,1,3,2,6,0,0,2,2,2,1,12,15,0,1,0,1
157318,2023,France,Cuba,0,5,4,9,23/06/2023,0,0,1,1,7,2,10,19,3,1,5,9,3,0,19,22,2,0,0,2
157318,2023,Slovenia,Cuba,2,4,6,12,22/06/2023,0,0,2,2,10,1,5,16,1,2,1,4,5,2,22,29,6,3,0,9
157318,2023,Japan,Cuba,1,5,4,10,21/06/2023,0,0,1,1,6,2,6,14,3,0,0,3,9,0,23,32,1,0,0,1
157318,2023,Brazil,Cuba,0,6,13,19,10/6/2023,0,0,2,2,17,2,13,32,2,5,3,10,3,1,32,36,3,1,1,5
157318,2023,Italy,Cuba,0,2,13,15,9/6/2023,0,0,1,1,11,3,9,23,0,3,1,4,4,2,23,29,4,1,0,5
157318,2023,Netherlands,Cuba,0,1,0,1,8/6/2023,0,0,1,1,0,1,0,1,0,0,0,0,1,0,2,3,0,0,0,0
157318,2023,Canada,Cuba,0,3,9,12,7/6/2023,0,0,8,8,15,5,13,33,0,4,2,6,3,0,21,24,9,2,3,14
190322,2023,Cuba,Iran,0,0,0,0,9/7/2023,0,0,0,0,0,0,0,0,0,0,0,0,0,0,0,0,0,0,0,0
190322,2023,Cuba,Germany,0,0,0,0,8/7/2023,0,0,0,0,0,0,0,0,0,0,0,0,0,0,0,0,0,0,0,0
190322,2023,Serbia,Cuba,0,0,0,0,7/7/2023,0,0,0,0,0,0,0,0,0,0,0,0,0,0,0,0,0,0,0,0
190322,2023,USA,Cuba,0,0,0,0,6/7/2023,0,0,0,0,0,0,0,0,0,0,0,0,0,0,0,0,0,0,0,0
190322,2023,Bulgaria,Cuba,0,0,0,0,25/06/2023,0,0,2,2,0,0,0,0,0,0,0,0,9,1,23,33,3,7,1,11
190322,2023,France,Cuba,0,0,0,0,23/06/2023,0,0,2,2,0,0,0,0,0,0,0,0,4,4,13,21,6,5,1,12
190322,2023,Slovenia,Cuba,0,0,0,0,22/06/2023,0,0,0,0,0,0,0,0,0,0,0,0,1,0,1,2,0,0,0,0
190322,2023,Japan,Cuba,0,0,0,0,21/06/2023,0,0,0,0,0,0,0,0,0,0,0,0,0,0,0,0,0,1,0,1
190322,2023,Brazil,Cuba,0,0,0,0,10/6/2023,0,0,0,0,0,0,0,0,0,0,0,0,0,0,0,0,0,0,0,0
190322,2023,Italy,Cuba,0,0,0,0,9/6/2023,0,0,1,1,0,0,0,0,0,0,0,0,0,0,0,0,0,0,0,0
190322,2023,Netherlands,Cuba,0,0,0,0,8/6/2023,0,0,0,0,0,0,0,0,0,0,0,0,0,0,0,0,6,2,0,8
190322,2023,Canada,Cuba,0,0,0,0,7/6/2023,0,0,0,0,0,0,0,0,0,0,0,0,0,0,0,0,4,3,1,8
152494,2023,USA,France,1,4,13,18,19/07/2023,0,0,1,1,10,1,6,17,5,4,3,12,0,0,0,0,0,1,1,2
152494,2023,France,Germany,1,1,12,14,10/7/2023,0,0,0,0,11,2,5,18,1,4,4,9,0,0,0,0,2,0,0,2
152494,2023,USA,France,1,2,6,9,9/7/2023,0,0,0,0,9,1,1,11,1,5,2,8,0,0,0,0,0,1,0,1
152494,2023,Serbia,France,0,2,10,12,7/7/2023,0,0,1,1,7,3,3,13,3,4,2,9,0,0,1,1,1,0,0,1
152494,2023,Iran,France,0,2,9,11,4/7/2023,0,0,2,2,6,1,2,9,1,4,3,8,0,0,0,0,2,0,1,3
152494,2023,Brazil,France,1,0,10,11,25/06/2023,0,1,3,4,8,1,5,14,1,5,3,9,0,0,0,0,2,1,0,3
152494,2023,Canada,France,0,4,5,9,24/06/2023,0,0,0,0,7,0,3,10,0,2,3,5,0,0,0,0,4,1,0,5
152494,2023,France,Cuba,0,2,8,10,23/06/2023,0,0,0,0,5,0,3,8,0,3,3,6,0,0,0,0,3,0,0,3
152494,2023,Argentina,France,0,3,9,12,21/06/2023,0,0,0,0,7,3,5,15,3,3,2,8,0,0,0,0,3,1,0,4
119792,2023,USA,France,0,0,0,0,19/07/2023,0,0,9,9,0,0,0,0,0,0,0,0,6,1,14,21,10,5,2,17
119792,2023,France,Germany,0,0,0,0,10/7/2023,0,0,9,9,0,0,0,0,0,0,0,0,2,2,16,20,12,4,1,17
119792,2023,USA,France,0,0,0,0,9/7/2023,0,0,12,12,0,0,0,0,0,0,0,0,10,0,8,18,8,4,2,14
119792,2023,Serbia,France,0,0,0,0,7/7/2023,0,0,11,11,0,0,0,0,0,0,0,0,5,0,11,16,10,2,2,14
119792,2023,Iran,France,0,0,0,0,4/7/2023,0,0,8,8,0,0,0,0,0,0,0,0,2,0,16,18,7,3,3,13
119792,2023,Brazil,France,0,0,0,0,25/06/2023,0,0,5,5,0,0,0,0,0,0,0,0,3,1,19,23,15,8,0,23
119792,2023,Canada,France,0,0,0,0,24/06/2023,0,0,4,4,0,0,0,0,0,0,0,0,4,0,11,15,10,4,0,14
119792,2023,France,Cuba,0,0,0,0,23/06/2023,0,0,4,4,0,0,0,0,0,0,0,0,2,1,10,13,12,5,2,19
119792,2023,Argentina,France,0,0,0,0,21/06/2023,0,0,7,7,0,0,0,0,0,0,0,0,9,2,13,24,19,5,1,25
142694,2023,USA,France,2,4,5,11,19/07/2023,0,0,0,0,13,6,10,29,2,1,3,6,0,0,0,0,3,0,0,3
142694,2023,France,Germany,0,0,1,1,10/7/2023,0,0,0,0,1,1,3,5,0,0,0,0,0,0,0,0,1,0,0,1
142694,2023,USA,France,0,2,10,12,9/7/2023,0,0,1,1,9,3,10,22,2,3,0,5,0,0,0,0,2,1,1,4
142694,2023,Serbia,France,0,3,13,16,7/7/2023,0,0,0,0,16,8,15,39,2,1,1,4,0,0,0,0,4,3,0,7
142694,2023,Iran,France,0,1,0,1,4/7/2023,0,0,0,0,2,0,0,2,0,0,0,0,0,0,0,0,0,0,0,0
142694,2023,Brazil,France,0,0,0,0,25/06/2023,0,0,0,0,0,0,0,0,0,0,0,0,0,0,0,0,0,0,0,0
142694,2023,Canada,France,3,2,13,18,24/06/2023,0,0,0,0,11,0,10,21,2,3,2,7,0,0,0,0,3,1,0,4
142694,2023,France,Cuba,1,3,8,12,23/06/2023,0,0,2,2,13,3,11,27,0,0,3,3,0,0,0,0,3,0,2,5
142694,2023,Argentina,France,0,1,0,1,21/06/2023,0,0,0,0,3,0,2,5,2,1,0,3,0,0,0,0,0,0,0,0
119804,2023,USA,France,0,0,6,6,19/07/2023,12,0,34,46,1,0,0,1,0,0,1,1,0,0,0,0,0,3,1,4
119804,2023,France,Germany,0,1,21,22,10/7/2023,30,0,41,71,1,0,1,2,1,3,2,6,0,0,0,0,3,4,0,7
119804,2023,USA,France,0,0,0,0,9/7/2023,3,0,7,10,0,0,0,0,0,0,0,0,0,0,0,0,0,0,0,0
119804,2023,Serbia,France,0,0,0,0,7/7/2023,0,0,0,0,0,0,0,0,0,0,0,0,0,0,0,0,0,0,0,0
119804,2023,Iran,France,0,1,12,13,4/7/2023,17,0,40,57,1,0,0,1,0,0,2,2,0,0,1,1,3,1,0,4
124518,2023,USA,France,0,2,20,22,19/07/2023,0,0,3,3,11,6,6,23,0,3,3,6,7,3,27,37,13,3,0,16
124518,2023,Brazil,France,0,3,17,20,25/06/2023,0,0,3,3,9,4,9,22,0,4,2,6,8,1,19,28,2,1,4,7
124518,2023,Canada,France,0,0,1,1,24/06/2023,0,0,0,0,0,0,0,0,0,0,0,0,0,0,0,0,0,0,0,0
124518,2023,France,Cuba,0,1,6,7,23/06/2023,0,0,4,4,5,3,7,15,2,1,2,5,3,0,6,9,5,2,0,7
124518,2023,Argentina,France,0,2,15,17,21/06/2023,0,0,4,4,13,6,9,28,0,3,5,8,8,0,11,19,3,3,0,6
124518,2023,Japan,France,0,3,10,13,11/6/2023,0,0,3,3,14,2,5,21,0,1,4,5,12,1,15,28,7,2,0,9
124518,2023,France,Slovenia,0,3,12,15,10/6/2023,0,0,2,2,8,5,12,25,1,4,1,6,7,2,19,28,10,1,0,11
124518,2023,China,France,1,2,17,20,9/6/2023,0,0,3,3,16,5,8,29,0,1,2,3,7,0,10,17,11,1,1,13
124518,2023,Poland,France,1,3,12,16,7/6/2023,0,0,3,3,10,4,11,25,1,4,5,10,7,2,10,19,6,1,0,7
136851,2023,USA,France,2,4,11,17,19/07/2023,25,0,46,71,0,0,2,2,1,4,2,7,0,0,0,0,8,3,0,11
136851,2023,France,Germany,0,0,0,0,10/7/2023,2,0,12,14,0,0,0,0,0,0,0,0,0,0,0,0,0,0,0,0
136851,2023,USA,France,0,5,6,11,9/7/2023,19,0,45,64,0,1,1,2,0,1,1,2,0,0,0,0,4,1,0,5
136851,2023,Serbia,France,1,6,11,18,7/7/2023,29,0,64,93,2,0,1,3,0,3,4,7,0,0,1,1,4,3,1,8
136851,2023,Iran,France,0,0,0,0,4/7/2023,1,0,4,5,0,0,0,0,0,0,0,0,0,0,0,0,0,1,0,1
136851,2023,Brazil,France,3,3,16,22,25/06/2023,30,0,60,90,3,0,2,5,1,3,1,5,0,1,0,1,4,4,0,8
136851,2023,Canada,France,0,1,8,9,24/06/2023,16,1,52,69,1,1,0,2,1,4,4,9,0,0,0,0,4,1,1,6
136851,2023,France,Cuba,1,4,8,13,23/06/2023,13,0,46,59,2,0,0,2,2,2,3,7,0,0,0,0,3,3,0,6
136851,2023,Argentina,France,0,5,13,18,21/06/2023,21,2,71,94,0,0,3,3,1,1,1,3,0,0,0,0,4,1,2,7
142710,2023,USA,France,0,1,3,4,19/07/2023,0,0,1,1,4,1,10,15,0,1,1,2,0,0,1,1,3,0,1,4
142710,2023,France,Germany,1,7,7,15,10/7/2023,0,0,1,1,11,5,8,24,1,1,4,6,0,0,0,0,2,1,0,3
142710,2023,USA,France,0,0,2,2,9/7/2023,0,0,0,0,2,0,0,2,1,0,0,1,0,0,0,0,0,0,0,0
142710,2023,Serbia,France,0,0,0,0,7/7/2023,0,0,0,0,0,0,0,0,0,0,0,0,0,0,0,0,0,0,0,0
142710,2023,Iran,France,1,3,6,10,4/7/2023,0,0,1,1,10,1,8,19,0,3,0,3,0,0,0,0,4,2,1,7
142710,2023,Brazil,France,0,5,7,12,25/06/2023,0,0,3,3,16,5,15,36,1,2,3,6,1,0,0,1,4,3,0,7
142710,2023,Canada,France,0,0,0,0,24/06/2023,0,0,0,0,0,0,0,0,0,0,0,0,0,0,0,0,0,0,0,0
142710,2023,France,Cuba,0,0,0,0,23/06/2023,0,0,0,0,0,0,0,0,0,0,0,0,0,0,0,0,0,0,0,0
142710,2023,Argentina,France,0,3,7,10,21/06/2023,0,0,2,2,14,6,8,28,0,3,1,4,0,0,0,0,4,2,0,6
125073,2023,USA,France,1,1,6,8,19/07/2023,0,0,0,0,11,2,5,18,2,5,0,7,0,0,0,0,1,1,0,2
125073,2023,France,Germany,0,0,7,7,10/7/2023,0,0,0,0,7,0,0,7,3,2,1,6,0,0,0,0,0,1,0,1
125073,2023,USA,France,0,3,0,3,9/7/2023,0,0,0,0,1,0,1,2,0,2,1,3,0,0,0,0,0,0,1,1
125073,2023,Serbia,France,0,2,1,3,7/7/2023,0,0,0,0,0,0,1,1,0,1,1,2,0,0,0,0,0,0,0,0
125073,2023,Iran,France,0,1,6,7,4/7/2023,0,0,0,0,1,1,2,4,3,2,3,8,0,0,0,0,2,0,0,2
142677,2023,USA,France,0,0,0,0,19/07/2023,0,0,0,0,0,0,0,0,0,0,0,0,0,0,0,0,0,0,0,0
142677,2023,France,Germany,0,0,0,0,10/7/2023,0,0,0,0,0,0,0,0,0,0,0,0,0,0,0,0,0,0,0,0
142677,2023,USA,France,0,2,3,5,9/7/2023,0,0,0,0,2,1,4,7,1,1,3,5,0,0,0,0,0,0,0,0
142677,2023,Serbia,France,0,3,2,5,7/7/2023,0,0,0,0,9,1,3,13,4,2,6,12,0,0,1,1,0,0,0,0
142677,2023,Iran,France,0,0,0,0,4/7/2023,0,0,0,0,0,0,0,0,0,0,0,0,0,0,0,0,0,0,0,0
142677,2023,Brazil,France,0,3,5,8,25/06/2023,0,0,0,0,7,1,1,9,1,3,3,7,0,0,0,0,0,0,2,2
142677,2023,Canada,France,0,3,9,12,24/06/2023,0,0,0,0,7,1,2,10,0,2,2,4,0,0,0,0,1,1,0,2
142677,2023,France,Cuba,2,1,7,10,23/06/2023,0,0,0,0,3,0,2,5,1,4,3,8,0,0,0,0,0,0,0,0
142677,2023,Argentina,France,0,0,7,7,21/06/2023,0,0,0,0,4,1,0,5,0,1,3,4,0,0,0,0,0,0,0,0
142677,2023,Japan,France,1,3,6,10,11/6/2023,0,0,1,1,5,0,2,7,0,1,3,4,0,0,1,1,1,0,0,1
142677,2023,France,Slovenia,0,2,6,8,10/6/2023,0,0,2,2,6,0,3,9,0,3,0,3,0,0,2,2,1,0,0,1
142677,2023,China,France,1,4,6,11,9/6/2023,0,0,0,0,10,0,4,14,1,3,6,10,0,0,2,2,5,0,1,6
142677,2023,Poland,France,0,3,8,11,7/6/2023,0,0,0,0,6,1,2,9,2,2,0,4,0,0,0,0,5,0,0,5
132948,2023,USA,France,0,4,6,10,19/07/2023,0,0,1,1,6,0,20,26,1,5,6,12,2,1,24,27,5,5,1,11
132948,2023,France,Germany,1,4,8,13,10/7/2023,0,0,0,0,15,1,5,21,1,5,0,6,10,2,12,24,3,2,0,5
132948,2023,USA,France,0,2,12,14,9/7/2023,0,0,1,1,9,6,9,24,1,1,2,4,2,1,11,14,2,4,2,8
132948,2023,Serbia,France,0,3,13,16,7/7/2023,0,0,7,7,17,4,11,32,0,3,2,5,9,0,19,28,5,2,2,9
132948,2023,Iran,France,0,4,9,13,4/7/2023,0,0,1,1,7,5,11,23,0,1,0,1,2,0,11,13,5,2,1,8
132948,2023,Brazil,France,1,3,10,14,25/06/2023,0,0,2,2,10,4,10,24,2,8,2,12,2,1,22,25,1,3,1,5
132948,2023,Canada,France,0,2,8,10,24/06/2023,0,0,3,3,16,0,3,19,1,2,2,5,3,1,12,16,3,1,2,6
132948,2023,France,Cuba,0,1,15,16,23/06/2023,0,0,5,5,2,2,9,13,0,2,0,2,1,2,14,17,4,2,0,6
132948,2023,Argentina,France,1,0,6,7,21/06/2023,0,0,1,1,4,1,4,9,1,0,1,2,6,1,4,11,3,1,0,4
120735,2023,USA,France,0,0,0,0,19/07/2023,0,0,0,0,0,0,0,0,0,0,0,0,0,0,0,0,0,0,0,0
120735,2023,France,Germany,1,3,14,18,10/7/2023,0,0,0,0,6,3,11,20,1,0,2,3,8,2,15,25,2,3,0,5
120735,2023,USA,France,1,3,9,13,9/7/2023,0,0,2,2,8,4,7,19,2,2,1,5,9,3,17,29,1,0,4,5
120735,2023,Serbia,France,1,0,15,16,7/7/2023,0,0,2,2,3,4,7,14,1,4,3,8,7,1,14,22,2,2,0,4
120735,2023,Iran,France,0,0,0,0,4/7/2023,0,0,0,0,0,0,0,0,0,0,0,0,0,0,0,0,0,0,0,0
120735,2023,Brazil,France,0,1,2,3,25/06/2023,0,0,0,0,0,0,0,0,0,0,0,0,0,0,0,0,0,0,0,0
120735,2023,Canada,France,1,1,10,12,24/06/2023,0,0,2,2,9,1,9,19,1,3,0,4,6,3,12,21,2,2,1,5
120735,2023,France,Cuba,0,0,1,1,23/06/2023,0,0,0,0,0,0,0,0,0,0,0,0,0,0,0,0,0,0,0,0
120735,2023,Argentina,France,0,2,7,9,21/06/2023,0,0,1,1,7,2,7,16,0,3,1,4,9,1,15,25,3,0,0,3
152506,2023,USA,France,0,0,0,0,19/07/2023,0,0,0,0,0,0,0,0,0,0,0,0,0,0,0,0,0,0,0,0
152506,2023,France,Germany,0,0,0,0,10/7/2023,0,0,0,0,0,0,0,0,0,0,0,0,0,0,0,0,0,0,0,0
152506,2023,USA,France,0,0,0,0,9/7/2023,0,0,0,0,0,0,0,0,0,0,0,0,0,0,0,0,0,0,0,0
152506,2023,Serbia,France,0,0,0,0,7/7/2023,0,0,0,0,0,0,0,0,0,0,0,0,0,0,0,0,0,0,0,0
152506,2023,Iran,France,0,0,0,0,4/7/2023,0,0,0,0,0,0,0,0,0,0,0,0,0,0,0,0,0,0,0,0
152506,2023,Brazil,France,0,0,0,0,25/06/2023,0,0,0,0,0,0,0,0,0,0,0,0,0,0,0,0,0,0,0,0
152506,2023,Canada,France,0,0,0,0,24/06/2023,0,0,0,0,0,0,0,0,0,0,0,0,0,0,0,0,0,0,0,0
152506,2023,France,Cuba,0,0,0,0,23/06/2023,0,0,0,0,0,0,0,0,0,0,0,0,0,0,0,0,0,0,0,0
152506,2023,Argentina,France,0,0,0,0,21/06/2023,0,0,0,0,0,0,0,0,0,0,0,0,0,0,0,0,0,0,0,0
152506,2023,Japan,France,0,0,0,0,11/6/2023,0,0,5,5,0,0,0,0,0,0,0,0,6,4,15,25,7,1,0,8
152506,2023,France,Slovenia,0,0,0,0,10/6/2023,0,0,8,8,0,0,0,0,0,0,0,0,4,1,10,15,6,0,5,11
152506,2023,China,France,0,0,0,0,9/6/2023,0,0,3,3,0,0,0,0,0,0,0,0,6,1,6,13,13,0,5,18
152506,2023,Poland,France,0,0,0,0,7/6/2023,0,1,5,6,0,0,0,0,0,0,0,0,7,3,12,22,4,0,1,5
142686,2023,USA,France,0,0,0,0,19/07/2023,0,0,1,1,2,0,3,5,0,0,0,0,1,0,0,1,0,1,0,1
142686,2023,France,Germany,0,0,0,0,10/7/2023,0,0,0,0,0,0,0,0,0,0,0,0,0,0,0,0,0,0,0,0
142686,2023,USA,France,0,1,0,1,9/7/2023,0,0,0,0,1,0,1,2,0,0,0,0,1,0,2,3,0,0,0,0
142686,2023,Serbia,France,0,1,4,5,7/7/2023,0,0,0,0,2,0,1,3,0,0,1,1,1,1,6,8,1,2,0,3
142686,2023,Iran,France,3,3,6,12,4/7/2023,0,0,3,3,12,4,4,20,2,2,2,6,2,1,9,12,3,3,1,7
142686,2023,Brazil,France,0,0,1,1,25/06/2023,0,0,1,1,0,0,0,0,0,0,0,0,0,0,0,0,0,0,0,0
142686,2023,Canada,France,0,0,0,0,24/06/2023,0,0,0,0,0,0,0,0,0,0,0,0,0,0,0,0,0,0,0,0
142686,2023,France,Cuba,0,0,0,0,23/06/2023,0,0,0,0,2,0,2,4,0,0,0,0,0,1,0,1,0,0,0,0
142686,2023,Argentina,France,0,1,0,1,21/06/2023,0,0,0,0,0,0,0,0,0,0,0,0,0,0,0,0,0,0,0,0
142686,2023,Japan,France,1,5,10,16,11/6/2023,0,0,3,3,12,4,7,23,0,1,2,3,6,2,15,23,6,2,2,10
142686,2023,France,Slovenia,1,3,12,16,10/6/2023,0,0,4,4,15,8,16,39,0,1,4,5,4,0,17,21,6,0,2,8
142686,2023,China,France,2,1,7,10,9/6/2023,0,0,2,2,14,1,10,25,2,2,1,5,13,0,16,29,11,3,2,16
142686,2023,Poland,France,0,4,13,17,7/6/2023,1,0,4,5,8,4,8,20,0,3,1,4,5,3,27,35,4,0,0,4
136856,2023,USA,France,0,4,2,6,19/07/2023,0,0,0,0,0,0,0,0,0,0,0,0,0,0,0,0,0,0,0,0
136856,2023,France,Germany,0,2,3,5,10/7/2023,0,0,0,0,0,0,0,0,0,0,0,0,0,0,0,0,1,0,0,1
136856,2023,USA,France,1,0,4,5,9/7/2023,0,0,0,0,0,0,0,0,0,0,0,0,0,0,0,0,0,0,0,0
136856,2023,Serbia,France,0,3,3,6,7/7/2023,0,0,0,0,0,0,0,0,0,0,0,0,0,0,0,0,1,0,0,1
136856,2023,Iran,France,2,1,4,7,4/7/2023,0,0,0,0,0,0,0,0,0,0,0,0,0,0,0,0,1,0,0,1
136856,2023,Brazil,France,0,1,1,2,25/06/2023,0,0,0,0,0,0,0,0,0,0,0,0,0,0,0,0,0,0,0,0
136856,2023,Canada,France,0,0,2,2,24/06/2023,0,0,0,0,0,0,0,0,0,0,0,0,0,0,0,0,0,0,0,0
136856,2023,France,Cuba,0,1,2,3,23/06/2023,0,0,0,0,0,0,0,0,0,0,0,0,0,0,0,0,0,0,0,0
136856,2023,Argentina,France,1,4,4,9,21/06/2023,0,0,1,1,1,0,0,1,0,0,0,0,0,0,0,0,1,0,0,1
136856,2023,Japan,France,1,4,12,17,11/6/2023,0,0,0,0,6,1,2,9,2,3,3,8,1,0,1,2,1,0,1,2
136856,2023,France,Slovenia,0,7,8,15,10/6/2023,0,0,0,0,8,1,3,12,2,4,4,10,2,0,2,4,7,0,3,10
136856,2023,China,France,2,5,14,21,9/6/2023,0,0,1,1,2,3,7,12,0,1,2,3,0,0,0,0,2,0,0,2
136856,2023,Poland,France,0,5,9,14,7/6/2023,0,0,0,0,3,2,0,5,1,3,7,11,2,0,1,3,2,0,1,3
119779,2023,France,Germany,1,3,10,14,10/7/2023,0,0,3,3,11,4,4,19,0,1,2,3,4,1,19,24,2,3,0,5
119779,2023,Cuba,Germany,0,1,5,6,8/7/2023,0,0,3,3,6,4,4,14,0,4,2,6,2,0,24,26,2,1,1,4
119779,2023,Argentina,Germany,0,1,3,4,6/7/2023,0,0,1,1,3,1,9,13,0,1,0,1,3,0,8,11,1,0,0,1
119779,2023,Germany,Bulgaria,0,0,12,12,6/7/2023,0,0,2,2,8,2,2,12,0,0,4,4,2,1,15,18,1,1,0,2
152469,2023,France,Germany,0,4,7,11,10/7/2023,27,0,41,68,1,1,0,2,0,0,5,5,0,1,1,2,4,2,0,6
152469,2023,Cuba,Germany,1,2,10,13,8/7/2023,20,0,37,57,0,0,0,0,0,2,3,5,0,0,1,1,5,2,0,7
152469,2023,Argentina,Germany,0,0,3,3,6/7/2023,1,0,7,8,0,0,0,0,0,0,0,0,0,0,0,0,4,1,0,5
152469,2023,Germany,Bulgaria,1,1,10,12,6/7/2023,15,0,42,57,0,0,0,0,1,1,1,3,0,0,0,0,3,1,1,5
152469,2023,China,Germany,1,3,11,15,24/06/2023,25,0,52,77,0,0,1,1,1,0,1,2,0,0,0,0,2,4,0,6
152469,2023,Serbia,Germany,4,1,11,16,22/06/2023,32,0,70,102,0,0,0,0,0,2,2,4,0,0,1,1,4,3,0,7
152469,2023,Germany,Poland,0,2,17,19,21/06/2023,16,0,60,76,0,0,0,0,1,1,1,3,0,0,0,0,5,0,1,6
152469,2023,Iran,Germany,0,3,10,13,20/06/2023,14,1,52,67,0,0,0,0,1,2,0,3,0,0,1,1,1,1,1,3
152469,2023,Canada,Germany,1,2,16,19,11/6/2023,13,1,82,96,0,0,0,0,2,0,1,3,0,0,0,0,4,0,0,4
152469,2023,Germany,Italy,1,0,13,14,10/6/2023,10,1,36,47,0,1,0,1,1,4,1,6,0,0,1,1,3,5,0,8
152469,2023,Netherlands,Germany,0,0,4,4,9/6/2023,6,0,8,14,0,0,0,0,0,1,1,2,0,0,0,0,0,0,1,1
152469,2023,Brazil,Germany,0,0,3,3,8/6/2023,5,0,5,10,0,0,0,0,0,0,0,0,0,0,0,0,1,1,0,2
119775,2023,France,Germany,0,0,1,1,10/7/2023,0,0,0,0,0,0,1,1,0,0,0,0,0,0,0,0,0,0,0,0
119775,2023,Cuba,Germany,0,0,0,0,8/7/2023,0,0,0,0,0,0,0,0,0,0,0,0,0,0,2,2,3,1,0,4
119775,2023,Argentina,Germany,0,0,0,0,6/7/2023,0,0,0,0,0,0,0,0,0,0,0,0,0,0,0,0,0,0,0,0
119775,2023,Germany,Bulgaria,0,0,0,0,6/7/2023,0,0,1,1,0,0,0,0,0,0,0,0,0,0,0,0,0,0,0,0
119775,2023,China,Germany,0,2,1,3,24/06/2023,0,0,1,1,0,2,0,2,0,1,0,1,5,0,4,9,0,2,0,2
119775,2023,Serbia,Germany,0,0,0,0,22/06/2023,0,0,0,0,0,0,0,0,0,0,0,0,0,1,10,11,6,3,0,9
119775,2023,Germany,Poland,0,0,0,0,21/06/2023,0,0,1,1,0,0,0,0,0,0,0,0,0,1,9,10,4,1,1,6
119775,2023,Iran,Germany,0,0,0,0,20/06/2023,0,0,0,0,0,0,0,0,0,0,0,0,0,0,0,0,0,0,0,0
119775,2023,Canada,Germany,0,0,0,0,11/6/2023,0,0,0,0,0,0,0,0,0,0,0,0,0,0,0,0,0,0,0,0
119775,2023,Germany,Italy,2,3,10,15,10/6/2023,0,0,1,1,8,4,8,20,1,2,1,4,1,2,23,26,7,5,0,12
119775,2023,Netherlands,Germany,0,2,1,3,9/6/2023,0,0,1,1,1,1,0,2,0,0,0,0,1,0,2,3,2,0,0,2
119775,2023,Brazil,Germany,0,0,4,4,8/6/2023,0,0,0,0,1,2,3,6,0,1,0,1,0,0,8,8,1,3,0,4
139386,2023,France,Germany,1,2,13,16,10/7/2023,0,0,4,4,7,2,10,19,1,0,6,7,3,2,19,24,6,2,1,9
139386,2023,Cuba,Germany,2,0,15,17,8/7/2023,0,0,6,6,10,4,4,18,0,5,1,6,9,0,10,19,6,3,0,9
139386,2023,Argentina,Germany,0,1,4,5,6/7/2023,0,0,1,1,4,4,3,11,1,1,0,2,3,1,9,13,0,3,0,3
139386,2023,Germany,Bulgaria,2,2,12,16,6/7/2023,0,0,2,2,12,1,7,20,0,2,1,3,0,0,7,7,5,1,0,6
139386,2023,China,Germany,1,2,12,15,24/06/2023,0,0,7,7,10,3,6,19,1,2,2,5,9,1,8,18,3,5,0,8
139386,2023,Serbia,Germany,1,3,11,15,22/06/2023,0,0,3,3,12,3,16,31,1,3,1,5,9,1,22,32,6,3,3,12
139386,2023,Germany,Poland,0,2,12,14,21/06/2023,0,0,1,1,3,4,3,10,0,1,0,1,2,0,9,11,2,2,1,5
139386,2023,Iran,Germany,0,3,5,8,20/06/2023,0,0,0,0,10,3,9,22,1,4,2,7,5,3,18,26,2,2,0,4
139386,2023,Canada,Germany,1,4,13,18,11/6/2023,0,0,0,0,8,6,13,27,1,0,0,1,10,1,18,29,4,1,3,8
139386,2023,Germany,Italy,1,3,6,10,10/6/2023,0,0,5,5,4,5,6,15,0,1,2,3,7,0,18,25,4,3,0,7
139386,2023,Netherlands,Germany,0,3,11,14,9/6/2023,0,0,3,3,10,4,7,21,2,0,0,2,2,5,16,23,5,2,1,8
139386,2023,Brazil,Germany,0,3,11,14,8/6/2023,0,0,7,7,14,4,7,25,0,1,2,3,10,1,18,29,9,6,0,15
182291,2023,France,Germany,0,0,0,0,10/7/2023,0,0,4,4,0,0,0,0,0,0,0,0,6,0,18,24,6,5,0,11
182291,2023,Cuba,Germany,0,0,0,0,8/7/2023,0,0,2,2,0,0,0,0,0,0,0,0,1,1,0,2,5,2,0,7
182291,2023,Argentina,Germany,0,0,0,0,6/7/2023,0,0,3,3,0,0,0,0,0,0,0,0,2,2,10,14,6,5,1,12
182291,2023,Germany,Bulgaria,0,0,0,0,6/7/2023,0,0,2,2,0,0,0,0,0,0,0,0,5,0,14,19,8,3,2,13
182291,2023,China,Germany,0,0,0,0,24/06/2023,0,0,1,1,0,0,0,0,0,0,0,0,3,1,7,11,8,8,2,18
182291,2023,Serbia,Germany,0,0,0,0,22/06/2023,0,0,0,0,0,0,0,0,0,0,0,0,0,0,12,12,1,4,1,6
182291,2023,Germany,Poland,0,0,0,0,21/06/2023,0,0,4,4,0,0,0,0,0,0,0,0,1,2,13,16,2,2,1,5
182291,2023,Iran,Germany,0,0,0,0,20/06/2023,0,0,1,1,0,0,0,0,0,0,0,0,1,3,13,17,7,4,0,11
182291,2023,Canada,Germany,0,0,0,0,11/6/2023,0,0,2,2,0,0,0,0,0,0,1,1,4,0,11,15,21,2,0,23
182291,2023,Germany,Italy,0,0,0,0,10/6/2023,0,0,1,1,0,0,0,0,0,0,0,0,0,0,0,0,2,4,0,6
182291,2023,Netherlands,Germany,0,0,0,0,9/6/2023,0,0,1,1,0,0,0,0,0,0,0,0,0,0,0,0,1,1,0,2
182291,2023,Brazil,Germany,0,0,0,0,8/6/2023,0,0,1,1,0,0,0,0,0,0,0,0,0,0,0,0,4,9,0,13
116575,2023,France,Germany,0,0,5,5,10/7/2023,3,0,12,15,0,0,0,0,0,1,0,1,0,0,0,0,3,1,2,6
116575,2023,Cuba,Germany,0,1,3,4,8/7/2023,3,0,2,5,0,0,0,0,0,0,0,0,0,0,0,0,0,0,0,0
116575,2023,Argentina,Germany,1,2,11,14,6/7/2023,10,0,46,56,0,0,0,0,1,0,3,4,0,0,0,0,3,3,1,7
116575,2023,Germany,Bulgaria,0,1,4,5,6/7/2023,5,1,5,11,0,0,0,0,0,0,0,0,0,0,0,0,3,0,1,4
116575,2023,Canada,Germany,0,1,1,2,11/6/2023,3,0,17,20,0,0,0,0,0,1,0,1,0,0,0,0,0,0,0,0
116575,2023,Germany,Italy,1,2,4,7,10/6/2023,6,0,28,34,1,0,0,1,0,1,1,2,0,0,0,0,4,3,0,7
116575,2023,Netherlands,Germany,0,2,8,10,9/6/2023,6,1,54,61,0,0,0,0,0,2,4,6,0,0,0,0,4,3,0,7
116575,2023,Brazil,Germany,0,3,9,12,8/6/2023,23,1,72,96,1,0,0,1,0,1,0,1,0,0,0,0,3,1,1,5
162081,2023,France,Germany,3,6,7,16,10/7/2023,0,1,1,2,9,5,2,16,2,5,4,11,0,0,1,1,1,1,1,3
162081,2023,Cuba,Germany,2,3,6,11,8/7/2023,0,1,1,2,8,1,5,14,0,5,6,11,0,0,0,0,0,0,0,0
162081,2023,Argentina,Germany,0,3,4,7,6/7/2023,0,0,0,0,1,0,1,2,0,0,1,1,0,0,1,1,0,1,1,2
162081,2023,Germany,Bulgaria,1,1,9,11,6/7/2023,0,0,0,0,4,2,5,11,1,7,4,12,0,0,1,1,0,1,0,1
162081,2023,China,Germany,0,3,10,13,24/06/2023,0,0,0,0,17,0,1,18,0,5,3,8,0,1,5,6,1,0,0,1
162081,2023,Serbia,Germany,1,2,13,16,22/06/2023,0,0,1,1,13,1,2,16,1,7,4,12,1,0,1,2,2,1,0,3
162081,2023,Germany,Poland,0,2,3,5,21/06/2023,0,0,0,0,8,2,2,12,1,4,0,5,0,0,2,2,1,0,0,1
162081,2023,Iran,Germany,0,3,4,7,20/06/2023,0,0,0,0,6,1,3,10,1,3,3,7,0,0,1,1,0,0,1,1
162081,2023,Canada,Germany,1,4,7,12,11/6/2023,0,0,0,0,4,3,5,12,1,2,1,4,0,0,2,2,1,0,3,4
162081,2023,Germany,Italy,0,4,11,15,10/6/2023,0,0,0,0,5,1,4,10,2,2,6,10,1,0,3,4,0,1,0,1
162081,2023,Netherlands,Germany,0,4,10,14,9/6/2023,0,0,0,0,8,1,6,15,3,7,2,12,0,0,0,0,4,3,0,7
162081,2023,Brazil,Germany,3,3,8,14,8/6/2023,0,0,0,0,10,0,6,16,1,3,6,10,0,0,2,2,1,0,0,1
136441,2023,France,Germany,0,0,0,0,10/7/2023,0,0,0,0,0,0,0,0,0,0,0,0,0,0,2,2,0,0,0,0
136441,2023,Cuba,Germany,1,0,1,2,8/7/2023,0,0,0,0,0,0,0,0,0,0,0,0,1,0,1,2,0,0,0,0
136441,2023,Argentina,Germany,1,3,6,10,6/7/2023,0,0,5,5,6,3,4,13,1,0,2,3,4,3,13,20,3,0,0,3
136441,2023,Germany,Bulgaria,0,1,2,3,6/7/2023,0,0,1,1,0,0,0,0,0,0,0,0,0,0,2,2,1,1,0,2
136441,2023,China,Germany,1,2,5,8,24/06/2023,0,0,2,2,5,5,12,22,0,2,1,3,12,2,11,25,1,3,1,5
136441,2023,Serbia,Germany,1,3,9,13,22/06/2023,0,0,7,7,7,3,6,16,1,1,3,5,7,1,14,22,7,4,1,12
136441,2023,Germany,Poland,0,2,8,10,21/06/2023,0,0,4,4,3,4,2,9,2,0,2,4,1,2,7,10,5,4,3,12
136441,2023,Iran,Germany,0,1,2,3,20/06/2023,0,0,1,1,0,2,2,4,0,0,0,0,0,0,2,2,0,1,0,1
136441,2023,Canada,Germany,0,1,1,2,11/6/2023,0,0,0,0,0,0,0,0,0,0,0,0,0,0,0,0,0,0,0,0
136441,2023,Germany,Italy,0,0,0,0,10/6/2023,0,1,3,4,0,0,0,0,0,0,0,0,2,3,11,16,5,4,1,10
136441,2023,Netherlands,Germany,0,0,0,0,9/6/2023,0,0,6,6,0,0,0,0,0,0,0,0,3,1,19,23,2,0,0,2
136441,2023,Brazil,Germany,0,0,0,0,8/6/2023,0,0,2,2,0,0,0,0,0,0,0,0,6,2,12,20,6,5,0,11
162790,2023,France,Germany,0,0,0,0,10/7/2023,0,0,0,0,0,0,0,0,0,0,0,0,0,0,0,0,0,0,0,0
162790,2023,Cuba,Germany,0,0,0,0,8/7/2023,0,0,0,0,0,0,0,0,0,0,0,0,0,0,0,0,0,0,0,0
162790,2023,Argentina,Germany,0,0,2,2,6/7/2023,0,0,1,1,0,2,0,2,2,2,2,6,0,1,0,1,0,0,0,0
162790,2023,Germany,Bulgaria,0,1,9,10,6/7/2023,0,0,2,2,7,0,2,9,0,6,3,9,0,0,1,1,0,0,1,1
162790,2023,China,Germany,0,0,10,10,24/06/2023,0,0,1,1,5,1,3,9,1,5,1,7,0,0,1,1,1,1,0,2
162790,2023,Serbia,Germany,1,0,9,10,22/06/2023,0,0,0,0,6,1,5,12,1,5,3,9,0,1,0,1,2,1,1,4
162790,2023,Germany,Poland,1,1,14,16,21/06/2023,0,0,3,3,3,2,2,7,4,6,7,17,0,0,1,1,3,0,0,3
162790,2023,Iran,Germany,0,0,0,0,20/06/2023,0,0,0,0,0,0,0,0,0,2,0,2,0,0,0,0,0,0,0,0
162790,2023,Canada,Germany,0,0,1,1,11/6/2023,0,0,0,0,2,0,0,2,0,0,0,0,0,0,0,0,0,0,0,0
162790,2023,Germany,Italy,0,0,0,0,10/6/2023,0,0,0,0,0,0,0,0,0,0,0,0,0,0,0,0,0,0,0,0
162790,2023,Netherlands,Germany,0,0,0,0,9/6/2023,0,0,0,0,0,0,0,0,0,0,0,0,0,0,0,0,0,0,0,0
162790,2023,Brazil,Germany,0,0,0,0,8/6/2023,0,0,0,0,0,0,0,0,0,0,0,0,0,0,0,0,0,0,0,0
162082,2023,France,Germany,1,5,5,11,10/7/2023,0,0,0,0,17,5,4,26,0,2,0,2,0,0,0,0,1,2,1,4
162082,2023,Cuba,Germany,3,4,4,11,8/7/2023,0,0,0,0,11,6,3,20,1,3,4,8,0,0,0,0,2,2,0,4
162082,2023,Argentina,Germany,0,2,4,6,6/7/2023,0,0,2,2,11,5,6,22,2,5,1,8,0,0,0,0,3,2,0,5
162082,2023,Germany,Bulgaria,0,1,3,4,6/7/2023,0,0,0,0,11,2,9,22,1,3,1,5,0,0,0,0,4,1,0,5
162082,2023,China,Germany,0,0,0,0,24/06/2023,0,0,0,0,0,0,0,0,0,0,0,0,0,0,0,0,0,0,0,0
162082,2023,Serbia,Germany,2,8,4,14,22/06/2023,0,0,0,0,12,8,11,31,1,3,4,8,0,0,0,0,5,1,1,7
162082,2023,Germany,Poland,0,2,3,5,21/06/2023,0,0,0,0,10,0,7,17,0,2,1,3,0,0,0,0,2,0,1,3
162082,2023,Iran,Germany,2,4,5,11,20/06/2023,0,0,1,1,6,5,3,14,0,2,0,2,0,0,0,0,5,1,0,6
162082,2023,Canada,Germany,1,0,1,2,11/6/2023,0,0,0,0,3,1,2,6,0,0,0,0,0,0,0,0,0,1,0,1
162082,2023,Germany,Italy,0,2,7,9,10/6/2023,0,0,1,1,17,5,10,32,2,3,6,11,0,1,0,1,4,2,0,6
162082,2023,Netherlands,Germany,0,3,5,8,9/6/2023,0,0,1,1,7,8,3,18,1,2,4,7,0,0,0,0,4,4,0,8
162082,2023,Brazil,Germany,0,4,6,10,8/6/2023,0,0,0,0,20,8,8,36,1,4,1,6,0,0,0,0,5,2,1,8
152349,2023,France,Germany,0,0,12,12,10/7/2023,0,0,0,0,6,1,2,9,2,0,4,6,0,0,0,0,1,0,0,1
152349,2023,Cuba,Germany,0,0,10,10,8/7/2023,0,0,0,0,5,0,3,8,2,2,3,7,0,0,1,1,2,0,0,2
152349,2023,Argentina,Germany,0,1,8,9,6/7/2023,0,1,2,3,2,1,3,6,1,4,5,10,0,0,0,0,1,0,0,1
152349,2023,Germany,Bulgaria,0,0,0,0,6/7/2023,0,0,0,0,0,0,0,0,0,0,0,0,0,0,0,0,0,0,0,0
152349,2023,China,Germany,0,0,0,0,24/06/2023,0,0,0,0,0,0,0,0,0,0,0,0,0,0,0,0,0,0,0,0
152349,2023,Serbia,Germany,0,1,4,5,22/06/2023,0,0,0,0,4,2,1,7,1,1,0,2,0,0,0,0,0,0,0,0
152349,2023,Germany,Poland,0,1,3,4,21/06/2023,0,0,0,0,1,2,2,5,0,6,3,9,0,0,0,0,0,0,0,0
152349,2023,Iran,Germany,0,0,9,9,20/06/2023,0,0,0,0,8,1,3,12,0,7,4,11,0,0,4,4,3,0,0,3
152349,2023,Canada,Germany,0,2,10,12,11/6/2023,0,0,0,0,9,1,0,10,4,2,0,6,0,0,1,1,2,0,0,2
152349,2023,Germany,Italy,0,0,3,3,10/6/2023,0,0,0,0,0,0,0,0,1,1,0,2,0,0,2,2,0,1,0,1
152349,2023,Netherlands,Germany,0,0,9,9,9/6/2023,0,0,1,1,3,0,1,4,1,4,2,7,0,0,0,0,4,0,1,5
152349,2023,Brazil,Germany,0,2,2,4,8/6/2023,0,0,0,0,2,1,2,5,1,1,2,4,0,0,0,0,3,1,0,4
163592,2023,France,Germany,0,0,0,0,10/7/2023,0,0,0,0,0,0,0,0,0,0,0,0,0,0,0,0,0,0,0,0
163592,2023,Cuba,Germany,0,0,0,0,8/7/2023,0,0,0,0,0,0,0,0,0,0,0,0,0,0,0,0,0,0,0,0
163592,2023,Argentina,Germany,0,0,0,0,6/7/2023,0,0,0,0,0,0,0,0,0,0,0,0,0,0,0,0,0,0,0,0
163592,2023,Germany,Bulgaria,0,0,0,0,6/7/2023,0,0,0,0,0,0,0,0,0,0,0,0,0,0,0,0,0,0,0,0
163592,2023,China,Germany,0,1,3,4,24/06/2023,0,0,0,0,2,2,1,5,0,2,0,2,4,0,6,10,1,2,0,3
163592,2023,Serbia,Germany,0,0,0,0,22/06/2023,0,0,0,0,0,0,0,0,0,0,0,0,0,0,0,0,0,0,0,0
163592,2023,Germany,Poland,0,0,3,3,21/06/2023,0,0,0,0,1,2,5,8,1,1,0,2,2,0,6,8,0,1,0,1
163592,2023,Iran,Germany,0,3,7,10,20/06/2023,0,0,3,3,8,3,5,16,0,1,1,2,5,0,7,12,5,0,0,5
163592,2023,Canada,Germany,0,1,11,12,11/6/2023,0,0,0,0,18,0,12,30,2,2,1,5,11,0,13,24,8,1,1,10
163592,2023,Germany,Italy,0,0,1,1,10/6/2023,0,0,0,0,0,0,0,0,0,0,0,0,0,0,0,0,0,0,0,0
163592,2023,Netherlands,Germany,0,1,0,1,9/6/2023,0,0,0,0,1,2,3,6,0,0,0,0,0,1,1,2,0,0,0,0
163592,2023,Brazil,Germany,0,0,0,0,8/6/2023,0,0,0,0,0,0,0,0,0,0,0,0,0,0,0,0,0,0,0,0
152352,2023,France,Germany,0,0,0,0,10/7/2023,0,0,0,0,0,0,0,0,0,0,0,0,0,0,0,0,0,0,0,0
152352,2023,Cuba,Germany,0,0,0,0,8/7/2023,0,0,0,0,0,0,0,0,0,0,0,0,0,0,0,0,0,0,0,0
152352,2023,Argentina,Germany,0,0,0,0,6/7/2023,0,0,0,0,0,0,0,0,0,0,0,0,0,0,0,0,0,0,0,0
152352,2023,Germany,Bulgaria,0,0,0,0,6/7/2023,0,0,0,0,0,0,0,0,0,0,0,0,0,0,0,0,0,0,0,0
152352,2023,Canada,Germany,0,0,0,0,11/6/2023,0,0,0,0,0,0,0,0,0,0,0,0,0,0,0,0,0,0,0,0
152352,2023,Germany,Italy,0,1,8,9,10/6/2023,0,0,1,1,3,0,3,6,2,4,3,9,0,1,0,1,3,0,0,3
152352,2023,Netherlands,Germany,0,0,0,0,9/6/2023,0,0,0,0,0,0,0,0,0,0,0,0,0,0,0,0,0,0,0,0
152352,2023,Brazil,Germany,0,3,5,8,8/6/2023,0,0,0,0,3,1,2,6,1,0,2,3,0,0,0,0,2,1,0,3
184322,2023,France,Germany,0,0,3,3,10/7/2023,0,0,0,0,0,1,4,5,1,2,0,3,0,0,0,0,0,0,0,0
184322,2023,Cuba,Germany,0,0,0,0,8/7/2023,0,0,0,0,0,0,0,0,1,0,0,1,0,0,0,0,0,0,0,0
184322,2023,Argentina,Germany,0,0,0,0,6/7/2023,0,0,1,1,1,0,4,5,0,1,1,2,0,0,0,0,1,0,0,1
184322,2023,Germany,Bulgaria,0,0,0,0,6/7/2023,0,0,0,0,1,0,3,4,0,0,1,1,0,0,0,0,0,0,0,0
184322,2023,China,Germany,0,1,0,1,24/06/2023,0,0,1,1,0,0,2,2,0,1,0,1,0,0,0,0,0,0,0,0
184322,2023,Serbia,Germany,0,1,0,1,22/06/2023,0,0,1,1,1,1,3,5,0,1,0,1,0,0,0,0,0,0,0,0
184322,2023,Germany,Poland,0,2,3,5,21/06/2023,0,0,0,0,10,5,4,19,3,3,2,8,0,0,0,0,3,0,2,5
184322,2023,Iran,Germany,0,0,1,1,20/06/2023,0,0,0,0,2,1,0,3,0,0,0,0,0,0,0,0,0,0,0,0
184322,2023,Canada,Germany,0,0,13,13,11/6/2023,0,0,0,0,19,4,8,31,0,2,0,2,0,0,0,0,7,2,0,9
184322,2023,Germany,Italy,0,1,0,1,10/6/2023,0,0,0,0,2,1,0,3,1,0,0,1,0,0,0,0,0,2,0,2
184322,2023,Netherlands,Germany,0,1,2,3,9/6/2023,0,0,0,0,4,0,4,8,0,1,2,3,0,0,0,0,1,1,0,2
184322,2023,Brazil,Germany,0,1,1,2,8/6/2023,0,0,0,0,1,0,2,3,0,0,0,0,0,0,0,0,0,0,0,0
163173,2023,Cuba,Iran,0,0,0,0,9/7/2023,0,0,0,0,0,0,0,0,0,0,0,0,0,0,0,0,1,0,0,1
163173,2023,Argentina,Iran,0,3,13,16,9/7/2023,0,0,1,1,6,2,3,11,1,7,6,14,1,0,1,2,1,1,1,3
163173,2023,Bulgaria,Iran,0,0,9,9,7/7/2023,0,0,0,0,0,1,2,3,0,3,1,4,0,0,1,1,1,0,0,1
163173,2023,Iran,France,0,0,14,14,4/7/2023,0,0,0,0,6,0,4,10,0,1,1,2,0,0,0,0,0,1,0,1
163173,2023,Netherlands,Iran,0,0,0,0,24/06/2023,0,0,0,0,0,0,0,0,0,1,0,1,0,0,0,0,0,0,0,0
163173,2023,Iran,USA,0,0,0,0,23/06/2023,0,0,0,0,0,0,0,0,0,0,0,0,0,0,0,0,0,0,0,0
163173,2023,Iran,Italy,0,0,0,0,21/06/2023,0,0,0,0,0,0,0,0,0,0,0,0,0,0,0,0,0,0,0,0
163173,2023,Iran,Germany,0,0,0,0,20/06/2023,0,0,0,0,0,0,0,0,0,0,0,0,0,0,0,0,0,0,0,0
163173,2023,Slovenia,Iran,0,0,0,0,11/6/2023,0,0,0,0,0,0,0,0,0,0,0,0,0,0,0,0,0,0,0,0
163173,2023,Iran,China,0,0,0,0,10/6/2023,0,0,0,0,0,0,0,0,0,0,0,0,0,0,0,0,0,0,0,0
163173,2023,Poland,Iran,0,0,0,0,8/6/2023,0,0,0,0,0,0,0,0,0,0,0,0,0,0,0,0,0,0,0,0
163173,2023,Japan,Iran,0,0,0,0,6/6/2023,0,0,0,0,0,0,0,0,0,0,0,0,0,0,0,0,0,0,0,0
118827,2023,Cuba,Iran,0,4,9,13,9/7/2023,0,0,2,2,11,3,4,18,3,9,4,16,0,0,1,1,2,2,1,5
118827,2023,Argentina,Iran,0,0,0,0,9/7/2023,0,0,0,0,0,0,0,0,0,0,0,0,0,0,0,0,0,0,0,0
118827,2023,Bulgaria,Iran,0,5,7,12,7/7/2023,0,0,0,0,6,2,5,13,7,8,10,25,1,0,0,1,4,0,0,4
118827,2023,Iran,France,0,5,3,8,4/7/2023,0,0,1,1,3,1,3,7,4,6,5,15,0,1,2,3,1,0,0,1
118827,2023,Netherlands,Iran,1,1,18,20,24/06/2023,0,1,0,1,5,3,2,10,5,8,4,17,0,0,1,1,1,2,1,4
118827,2023,Iran,USA,0,3,7,10,23/06/2023,0,0,6,6,6,2,1,9,2,4,2,8,0,0,2,2,2,0,0,2
118827,2023,Iran,Italy,0,2,6,8,21/06/2023,0,0,1,1,4,1,0,5,1,2,2,5,0,0,2,2,2,0,1,3
118827,2023,Iran,Germany,1,3,6,10,20/06/2023,0,0,1,1,4,0,1,5,4,3,1,8,1,0,0,1,0,0,0,0
118827,2023,Slovenia,Iran,0,3,4,7,11/6/2023,0,0,0,0,1,1,2,4,0,3,2,5,2,0,1,3,4,0,0,4
118827,2023,Iran,China,0,2,15,17,10/6/2023,0,0,6,6,5,2,3,10,1,3,1,5,0,0,0,0,4,0,0,4
118827,2023,Poland,Iran,1,5,10,16,8/6/2023,0,0,1,1,4,2,6,12,4,5,3,12,0,0,0,0,0,0,0,0
118827,2023,Japan,Iran,0,3,5,8,6/6/2023,0,0,2,2,4,1,4,9,4,4,4,12,2,0,2,4,3,0,0,3
163176,2023,Cuba,Iran,0,0,0,0,9/7/2023,0,0,0,0,0,0,0,0,0,0,0,0,0,0,0,0,0,0,0,0
163176,2023,Argentina,Iran,0,0,0,0,9/7/2023,0,0,11,11,0,0,0,0,0,0,0,0,4,1,11,16,8,3,4,15
163176,2023,Bulgaria,Iran,0,0,0,0,7/7/2023,0,0,0,0,0,0,0,0,0,0,0,0,0,0,0,0,0,0,0,0
163176,2023,Iran,France,0,0,0,0,4/7/2023,0,0,2,2,0,0,0,0,0,0,0,0,2,2,10,14,7,1,0,8
163176,2023,Netherlands,Iran,0,0,0,0,24/06/2023,0,0,5,5,0,0,0,0,0,0,0,0,3,3,13,19,12,2,0,14
163176,2023,Iran,USA,0,0,0,0,23/06/2023,0,0,3,3,0,0,0,0,0,0,0,0,3,1,7,11,4,1,0,5
163176,2023,Iran,Italy,0,0,0,0,21/06/2023,0,0,5,5,0,0,0,0,0,0,0,0,1,2,9,12,8,2,0,10
163176,2023,Iran,Germany,0,0,0,0,20/06/2023,0,0,3,3,0,0,0,0,0,0,0,0,1,2,11,14,1,4,2,7
163176,2023,Slovenia,Iran,0,0,0,0,11/6/2023,0,0,7,7,0,0,0,0,0,0,0,0,2,2,10,14,8,1,1,10
163176,2023,Iran,China,0,0,0,0,10/6/2023,0,0,7,7,0,0,0,0,0,0,0,0,8,1,9,18,10,0,1,11
163176,2023,Poland,Iran,0,0,0,0,8/6/2023,0,0,7,7,0,0,0,0,0,0,0,0,9,1,15,25,10,0,2,12
163176,2023,Japan,Iran,0,0,0,0,6/6/2023,0,0,10,10,0,0,0,0,0,0,0,0,6,2,5,13,3,0,1,4
153535,2023,Cuba,Iran,0,0,0,0,9/7/2023,0,0,9,9,0,0,0,0,0,0,0,0,4,1,13,18,6,4,1,11
153535,2023,Argentina,Iran,0,0,0,0,9/7/2023,0,0,0,0,0,0,0,0,0,0,0,0,0,0,0,0,0,0,0,0
153535,2023,Bulgaria,Iran,0,0,0,0,7/7/2023,0,0,4,4,0,0,0,0,0,0,0,0,3,2,4,9,8,4,0,12
153535,2023,Iran,France,0,0,0,0,4/7/2023,0,0,3,3,0,0,0,0,0,0,0,0,0,0,0,0,0,0,0,0
152752,2023,Cuba,Iran,3,4,19,26,9/7/2023,0,0,1,1,12,10,12,34,1,3,1,5,5,5,16,26,4,3,0,7
152752,2023,Argentina,Iran,1,4,15,20,9/7/2023,0,0,2,2,9,2,13,24,3,1,1,5,4,3,33,40,2,1,0,3
152752,2023,Bulgaria,Iran,1,1,9,11,7/7/2023,0,0,1,1,6,3,8,17,2,1,2,5,8,0,9,17,0,5,1,6
152752,2023,Iran,France,1,3,6,10,4/7/2023,0,0,1,1,5,1,4,10,1,2,0,3,9,1,21,31,3,1,0,4
152752,2023,Netherlands,Iran,1,4,10,15,24/06/2023,0,0,2,2,4,6,7,17,1,3,1,5,9,2,24,35,3,3,1,7
152752,2023,Iran,USA,1,0,4,5,23/06/2023,0,0,1,1,2,0,0,2,0,0,0,0,2,3,10,15,0,1,0,1
152752,2023,Iran,Italy,0,1,2,3,21/06/2023,0,0,1,1,4,0,3,7,0,1,2,3,2,0,8,10,0,0,0,0
152752,2023,Iran,Germany,0,0,0,0,20/06/2023,0,0,0,0,0,0,0,0,0,0,0,0,0,0,0,0,0,0,0,0
152752,2023,Slovenia,Iran,0,2,3,5,11/6/2023,0,0,1,1,5,4,6,15,1,1,1,3,6,1,6,13,6,1,0,7
152752,2023,Iran,China,0,1,0,1,10/6/2023,0,0,0,0,0,0,0,0,0,0,0,0,0,0,0,0,0,0,0,0
152752,2023,Poland,Iran,0,0,0,0,8/6/2023,0,0,0,0,0,0,0,0,0,0,0,0,0,0,0,0,0,0,0,0
152752,2023,Japan,Iran,0,0,1,1,6/6/2023,0,0,0,0,1,2,2,5,0,0,1,1,1,0,4,5,3,0,0,3
152753,2023,Cuba,Iran,0,2,14,16,9/7/2023,31,0,70,101,1,0,1,2,0,2,2,4,0,0,0,0,2,3,0,5
152753,2023,Argentina,Iran,0,1,8,9,9/7/2023,3,0,18,21,0,0,0,0,0,0,1,1,0,0,0,0,3,1,0,4
152753,2023,Bulgaria,Iran,0,0,4,4,7/7/2023,5,0,17,22,0,0,0,0,0,1,0,1,0,0,0,0,0,0,0,0
152753,2023,Iran,France,0,0,2,2,4/7/2023,1,0,8,9,0,0,0,0,0,1,0,1,0,0,0,0,0,1,0,1
182470,2023,Bulgaria,Iran,0,1,1,2,7/7/2023,0,0,0,0,3,1,2,6,0,1,2,3,0,0,5,5,1,1,0,2
182470,2023,Iran,France,0,0,1,1,4/7/2023,0,0,0,0,0,0,0,0,0,0,0,0,0,0,1,1,0,1,0,1
182470,2023,Netherlands,Iran,1,1,7,9,24/06/2023,0,0,1,1,4,3,6,13,0,1,0,1,3,4,9,16,3,1,0,4
182470,2023,Iran,USA,0,3,6,9,23/06/2023,0,0,4,4,9,5,3,17,0,0,1,1,1,4,11,16,5,2,0,7
182470,2023,Iran,Italy,0,0,5,5,21/06/2023,0,0,1,1,3,2,3,8,0,0,1,1,3,1,5,9,2,2,1,5
182470,2023,Iran,Germany,1,2,9,12,20/06/2023,0,0,2,2,6,2,4,12,1,1,1,3,0,0,14,14,7,2,0,9
182470,2023,Slovenia,Iran,0,1,4,5,11/6/2023,0,0,0,0,3,0,3,6,0,0,0,0,3,4,2,9,1,0,2,3
182470,2023,Iran,China,1,0,14,15,10/6/2023,0,0,2,2,14,2,2,18,1,1,3,5,3,1,16,20,3,0,0,3
182470,2023,Poland,Iran,1,3,18,22,8/6/2023,0,0,2,2,12,4,9,25,2,0,2,4,7,4,31,42,5,0,0,5
182470,2023,Japan,Iran,0,2,1,3,6/6/2023,0,0,0,0,1,2,4,7,0,0,0,0,2,1,7,10,1,0,2,3
123413,2023,Cuba,Iran,0,2,17,19,9/7/2023,0,0,2,2,10,1,3,14,0,0,1,1,14,1,29,44,5,4,0,9
123413,2023,Argentina,Iran,0,0,2,2,9/7/2023,0,0,0,0,2,0,2,4,1,0,0,1,2,0,4,6,1,0,0,1
123413,2023,Bulgaria,Iran,1,1,3,5,7/7/2023,0,0,0,0,0,0,0,0,0,0,0,0,1,0,2,3,0,0,0,0
123413,2023,Iran,France,0,0,0,0,4/7/2023,0,0,0,0,0,0,0,0,0,0,0,0,0,0,0,0,0,0,0,0
123413,2023,Netherlands,Iran,0,0,1,1,24/06/2023,0,0,0,0,0,0,0,0,0,0,0,0,0,0,4,4,0,0,1,1
123413,2023,Iran,USA,0,1,1,2,23/06/2023,0,0,0,0,1,1,1,3,0,0,0,0,0,1,1,2,1,0,0,1
123413,2023,Iran,Italy,0,1,3,4,21/06/2023,0,0,0,0,0,1,1,2,0,0,0,0,0,0,3,3,2,0,0,2
123413,2023,Iran,Germany,0,1,5,6,20/06/2023,0,0,2,2,1,0,0,1,0,0,0,0,1,0,0,1,0,0,0,0
123413,2023,Slovenia,Iran,0,0,1,1,11/6/2023,0,0,0,0,0,0,0,0,0,0,0,0,0,0,0,0,0,0,0,0
123413,2023,Iran,China,0,0,0,0,10/6/2023,0,0,0,0,2,0,0,2,0,0,1,1,2,1,6,9,1,0,1,2
123413,2023,Poland,Iran,0,0,1,1,8/6/2023,0,0,0,0,0,0,2,2,0,0,0,0,3,0,2,5,0,0,0,0
123413,2023,Japan,Iran,0,0,3,3,6/6/2023,0,0,1,1,0,0,0,0,0,0,1,1,1,0,4,5,1,0,0,1
189602,2023,Cuba,Iran,0,0,0,0,9/7/2023,0,0,0,0,0,0,0,0,0,0,0,0,0,0,0,0,0,0,0,0
189602,2023,Argentina,Iran,0,0,0,0,9/7/2023,0,0,0,0,1,2,2,5,0,2,0,2,0,0,0,0,1,0,0,1
189602,2023,Bulgaria,Iran,0,0,0,0,7/7/2023,0,0,0,0,0,0,0,0,0,0,0,0,0,0,0,0,0,0,0,0
189602,2023,Iran,France,0,0,0,0,4/7/2023,0,0,0,0,0,0,0,0,0,0,0,0,0,0,0,0,0,0,0,0
168551,2023,Cuba,Iran,0,3,17,20,9/7/2023,0,0,1,1,14,6,11,31,3,5,3,11,0,0,0,0,5,5,1,11
168551,2023,Argentina,Iran,0,4,1,5,9/7/2023,0,0,3,3,8,6,3,17,0,2,3,5,0,0,0,0,2,1,0,3
168551,2023,Bulgaria,Iran,0,2,5,7,7/7/2023,0,0,0,0,7,2,5,14,0,1,2,3,0,0,0,0,0,0,0,0
168551,2023,Iran,France,0,2,3,5,4/7/2023,0,0,0,0,4,2,4,10,0,0,3,3,0,0,0,0,0,3,1,4
152755,2023,Cuba,Iran,0,0,0,0,9/7/2023,0,0,0,0,0,0,0,0,0,0,0,0,0,0,0,0,0,0,0,0
152755,2023,Argentina,Iran,0,4,11,15,9/7/2023,17,0,71,88,1,0,2,3,1,3,0,4,0,1,0,1,7,2,2,11
152755,2023,Bulgaria,Iran,0,3,6,9,7/7/2023,12,0,58,70,3,0,1,4,1,1,1,3,0,0,0,0,1,1,2,4
152755,2023,Iran,France,0,2,4,6,4/7/2023,18,0,34,52,2,0,1,3,0,1,1,2,0,0,0,0,3,8,2,13
152755,2023,Netherlands,Iran,0,0,0,0,24/06/2023,4,0,2,6,0,0,0,0,0,0,0,0,0,0,0,0,0,0,0,0
152755,2023,Iran,USA,0,0,0,0,23/06/2023,0,0,0,0,0,0,0,0,0,0,0,0,0,0,0,0,0,0,0,0
152755,2023,Iran,Italy,0,0,0,0,21/06/2023,1,0,6,7,1,0,0,1,0,1,0,1,0,0,0,0,1,0,0,1
152755,2023,Iran,Germany,0,0,0,0,20/06/2023,0,0,2,2,0,0,0,0,0,0,0,0,0,0,0,0,0,1,0,1
152755,2023,Slovenia,Iran,0,1,2,3,11/6/2023,2,1,19,22,1,0,0,1,2,0,0,2,0,0,0,0,0,0,0,0
152755,2023,Iran,China,1,3,9,13,10/6/2023,13,1,58,72,4,0,1,5,1,4,2,7,0,0,1,1,5,0,1,6
152755,2023,Poland,Iran,0,3,8,11,8/6/2023,15,1,66,82,1,0,3,4,0,0,1,1,0,0,1,1,1,0,0,1
152755,2023,Japan,Iran,1,2,4,7,6/6/2023,1,0,40,41,0,0,1,1,0,0,1,1,0,0,1,1,2,0,0,2
174373,2023,Cuba,Iran,0,0,19,19,9/7/2023,0,0,1,1,9,0,4,13,3,5,1,9,0,0,0,0,2,1,1,4
174373,2023,Argentina,Iran,0,1,14,15,9/7/2023,0,0,1,1,1,1,2,4,4,4,9,17,0,0,0,0,3,1,1,5
174373,2023,Bulgaria,Iran,1,0,12,13,7/7/2023,0,0,1,1,2,0,1,3,1,2,3,6,0,0,1,1,2,0,0,2
174373,2023,Iran,France,0,0,0,0,4/7/2023,0,0,0,0,0,0,0,0,0,0,0,0,0,0,0,0,0,0,0,0
174373,2023,Netherlands,Iran,1,1,13,15,24/06/2023,0,0,0,0,9,1,2,12,1,4,4,9,0,0,0,0,3,0,2,5
174373,2023,Iran,USA,0,0,14,14,23/06/2023,0,0,0,0,3,0,2,5,1,0,2,3,0,0,1,1,1,1,1,3
174373,2023,Iran,Italy,0,1,10,11,21/06/2023,0,0,0,0,6,2,3,11,0,4,7,11,1,0,0,1,3,2,1,6
174373,2023,Iran,Germany,1,1,11,13,20/06/2023,0,0,1,1,1,0,5,6,4,3,4,11,0,0,2,2,1,0,1,2
174373,2023,Slovenia,Iran,0,0,14,14,11/6/2023,0,0,1,1,3,1,2,6,0,2,2,4,0,0,0,0,3,0,1,4
174373,2023,Iran,China,1,1,14,16,10/6/2023,0,0,1,1,2,2,3,7,6,5,2,13,0,0,1,1,4,0,1,5
174373,2023,Poland,Iran,0,2,15,17,8/6/2023,0,0,0,0,7,1,1,9,1,4,3,8,0,0,1,1,4,0,4,8
174373,2023,Japan,Iran,1,0,9,10,6/6/2023,0,0,0,0,3,1,2,6,0,2,2,4,1,0,0,1,1,0,1,2
152742,2023,Argentina,Iran,1,7,11,19,9/7/2023,0,0,2,2,14,8,16,38,1,5,2,8,8,0,22,30,4,0,1,5
152742,2023,Bulgaria,Iran,0,4,11,15,7/7/2023,0,0,4,4,10,5,3,18,0,3,2,5,11,2,33,46,4,5,0,9
152742,2023,Iran,France,0,2,9,11,4/7/2023,0,0,0,0,8,4,5,17,0,0,1,1,0,2,7,9,3,1,1,5
152742,2023,Netherlands,Iran,0,0,1,1,24/06/2023,0,0,1,1,4,3,2,9,0,1,0,1,2,0,5,7,0,0,0,0
152742,2023,Iran,USA,0,0,6,6,23/06/2023,0,0,0,0,4,2,3,9,1,2,1,4,2,3,7,12,2,0,0,2
152742,2023,Iran,Italy,1,2,9,12,21/06/2023,0,0,1,1,7,4,8,19,0,1,0,1,2,3,10,15,3,3,4,10
152742,2023,Iran,Germany,1,2,8,11,20/06/2023,0,0,1,1,10,0,4,14,0,1,3,4,2,0,13,15,4,2,1,7
152742,2023,Slovenia,Iran,1,1,10,12,11/6/2023,0,0,0,0,6,3,7,16,0,4,4,8,3,2,11,16,4,0,2,6
152742,2023,Iran,China,0,1,7,8,10/6/2023,0,0,0,0,12,0,10,22,0,2,0,2,2,0,6,8,5,0,0,5
152742,2023,Poland,Iran,0,2,3,5,8/6/2023,0,1,0,1,6,0,3,9,1,0,0,1,0,0,5,5,2,0,0,2
152742,2023,Japan,Iran,0,3,6,9,6/6/2023,0,0,2,2,3,1,6,10,1,3,0,4,1,0,9,10,2,0,0,2
163174,2023,Cuba,Iran,0,0,0,0,9/7/2023,0,0,0,0,0,0,0,0,0,0,0,0,0,0,0,0,0,0,0,0
171191,2023,Japan,Italy,4,3,13,20,23/07/2023,0,0,8,8,11,4,9,24,1,2,4,7,4,1,27,32,12,3,1,16
171191,2023,USA,Italy,0,1,8,9,22/07/2023,0,0,5,5,9,2,13,24,0,0,2,2,1,1,24,26,5,2,1,8
171191,2023,Italy,Argentina,1,1,14,16,19/07/2023,0,0,2,2,13,2,4,19,1,1,0,2,1,0,9,10,7,1,0,8
171191,2023,Japan,Italy,1,2,12,15,8/7/2023,0,0,3,3,12,4,6,22,1,0,2,3,7,2,16,25,2,3,1,6
171191,2023,Slovenia,Italy,1,1,8,10,7/7/2023,0,0,3,3,9,1,9,19,2,1,2,5,0,0,9,9,2,3,0,5
171191,2023,Canada,Italy,1,3,15,19,6/7/2023,0,0,10,10,14,1,13,28,3,2,2,7,4,2,16,22,8,2,0,10
171191,2023,Brazil,Italy,3,3,12,18,4/7/2023,0,0,8,8,14,2,10,26,0,5,2,7,3,0,23,26,8,4,0,12
171191,2023,Italy,Poland,0,3,10,13,25/06/2023,0,0,9,9,11,6,12,29,3,3,2,8,3,3,19,25,8,2,0,10
171191,2023,Serbia,Italy,0,0,11,11,23/06/2023,0,0,6,6,8,2,3,13,1,0,4,5,4,1,10,15,3,2,0,5
171191,2023,China,Italy,1,0,12,13,22/06/2023,0,0,2,2,2,1,1,4,3,0,0,3,1,0,7,8,1,0,0,1
171191,2023,Iran,Italy,1,2,5,8,21/06/2023,0,0,3,3,12,0,10,22,2,3,1,6,3,0,5,8,4,2,0,6
144005,2023,Japan,Italy,2,3,12,17,23/07/2023,34,1,62,97,6,1,0,7,0,3,4,7,0,0,2,2,6,1,0,7
144005,2023,USA,Italy,0,1,10,11,22/07/2023,23,0,46,69,2,0,1,3,0,1,1,2,0,0,0,0,8,4,0,12
144005,2023,Italy,Argentina,0,1,11,12,19/07/2023,18,0,43,61,2,0,1,3,2,0,4,6,0,0,0,0,4,1,0,5
144005,2023,Japan,Italy,0,1,15,16,8/7/2023,39,0,62,101,1,3,2,6,2,3,8,13,0,0,1,1,3,3,1,7
144005,2023,Slovenia,Italy,0,1,13,14,7/7/2023,27,0,43,70,3,0,3,6,0,3,1,4,0,0,0,0,10,1,0,11
144005,2023,Canada,Italy,2,1,16,19,6/7/2023,33,0,67,100,4,0,4,8,1,3,2,6,0,0,0,0,14,2,1,17
144005,2023,Brazil,Italy,1,2,16,19,4/7/2023,16,0,60,76,1,0,0,1,2,3,5,10,0,0,1,1,6,3,2,11
144005,2023,Italy,Poland,1,3,14,18,25/06/2023,29,1,64,94,2,0,3,5,2,5,7,14,0,0,2,2,5,1,1,7
144005,2023,Serbia,Italy,0,0,13,13,23/06/2023,22,0,30,52,3,1,0,4,1,3,1,5,0,0,0,0,8,2,0,10
144005,2023,China,Italy,1,1,15,17,22/06/2023,16,0,33,49,2,0,0,2,0,2,1,3,0,0,0,0,2,1,1,4
144005,2023,Iran,Italy,1,3,9,13,21/06/2023,20,0,49,69,1,1,1,3,4,3,3,10,0,0,1,1,7,0,2,9
150436,2023,Japan,Italy,0,0,0,0,23/07/2023,0,0,6,6,0,0,0,0,0,0,0,0,7,2,12,21,11,3,0,14
150436,2023,USA,Italy,0,0,0,0,22/07/2023,0,1,6,7,0,0,0,0,0,0,0,0,5,1,14,20,5,3,0,8
150436,2023,Italy,Argentina,0,0,0,0,19/07/2023,0,0,3,3,0,0,0,0,0,0,0,0,3,0,9,12,7,4,0,11
150436,2023,Germany,Italy,0,0,0,0,10/6/2023,0,0,11,11,0,0,0,0,0,0,0,0,8,2,17,27,11,4,0,15
150436,2023,Italy,Cuba,0,0,0,0,9/6/2023,0,0,7,7,0,0,0,0,0,0,0,0,5,0,14,19,14,1,1,16
150436,2023,Italy,USA,0,0,0,0,8/6/2023,0,0,8,8,0,0,0,0,0,0,0,0,4,1,11,16,12,2,3,17
150436,2023,Italy,Argentina,0,0,0,0,6/6/2023,0,0,12,12,0,0,0,0,0,0,0,0,3,0,9,12,10,1,3,14
152370,2023,Japan,Italy,0,0,0,0,23/07/2023,0,0,0,0,0,0,0,0,0,0,0,0,0,0,0,0,0,0,0,0
152370,2023,USA,Italy,0,1,0,1,22/07/2023,2,0,1,3,0,0,0,0,0,0,0,0,0,0,0,0,0,0,0,0
152370,2023,Italy,Argentina,0,0,0,0,19/07/2023,0,0,0,0,0,0,0,0,0,0,0,0,0,0,0,0,0,0,0,0
152370,2023,Japan,Italy,0,1,2,3,8/7/2023,0,0,1,1,0,0,0,0,0,0,0,0,0,0,0,0,0,0,0,0
152370,2023,Slovenia,Italy,0,0,0,0,7/7/2023,0,0,0,0,0,0,0,0,0,0,0,0,0,0,0,0,0,0,0,0
152370,2023,Canada,Italy,0,1,3,4,6/7/2023,0,0,0,0,0,0,0,0,0,0,0,0,0,0,0,0,0,1,0,1
152370,2023,Brazil,Italy,0,0,0,0,4/7/2023,0,0,0,0,0,0,0,0,0,0,0,0,0,0,0,0,0,0,0,0
152370,2023,Italy,Poland,0,0,1,1,25/06/2023,0,0,2,2,0,0,0,0,1,0,0,1,0,0,0,0,0,0,0,0
152370,2023,Serbia,Italy,0,0,1,1,23/06/2023,0,0,0,0,0,0,0,0,0,0,0,0,0,0,0,0,0,0,0,0
152370,2023,China,Italy,0,1,0,1,22/06/2023,2,0,4,6,0,0,0,0,0,1,0,1,0,0,0,0,0,0,0,0
152370,2023,Iran,Italy,0,0,1,1,21/06/2023,0,0,0,0,0,0,0,0,0,0,0,0,0,0,0,0,0,0,0,0
181128,2023,Japan,Italy,0,0,0,0,23/07/2023,0,0,0,0,0,0,0,0,0,0,0,0,0,0,0,0,0,0,0,0
181128,2023,USA,Italy,0,0,0,0,22/07/2023,0,0,0,0,0,0,0,0,0,0,0,0,0,0,0,0,0,0,0,0
181128,2023,Italy,Argentina,0,0,0,0,19/07/2023,0,0,0,0,0,0,0,0,0,0,0,0,0,0,0,0,0,0,0,0
181128,2023,Japan,Italy,0,0,0,0,8/7/2023,0,0,2,2,0,0,0,0,0,0,0,0,0,0,0,0,9,2,0,11
181128,2023,Slovenia,Italy,0,0,0,0,7/7/2023,0,0,4,4,0,0,0,0,0,0,0,0,0,0,0,0,3,2,0,5
181128,2023,Canada,Italy,0,0,0,0,6/7/2023,0,0,3,3,0,0,0,0,0,0,0,0,3,2,10,15,7,2,2,11
181128,2023,Brazil,Italy,0,0,0,0,4/7/2023,0,0,2,2,0,0,0,0,0,0,0,0,0,0,0,0,4,2,1,7
181128,2023,Italy,Poland,0,0,0,0,25/06/2023,0,0,6,6,0,0,0,0,0,0,0,0,6,1,15,22,5,3,1,9
181128,2023,Serbia,Italy,0,0,0,0,23/06/2023,0,0,3,3,0,0,0,0,0,0,0,0,2,0,5,7,4,1,1,6
181128,2023,China,Italy,0,0,0,0,22/06/2023,0,0,2,2,0,0,0,0,0,0,0,0,2,0,7,9,2,1,0,3
181128,2023,Iran,Italy,0,0,0,0,21/06/2023,0,0,5,5,0,0,0,0,0,0,0,0,11,0,12,23,14,4,3,21
163447,2023,Japan,Italy,0,0,0,0,23/07/2023,0,0,0,0,0,0,0,0,0,0,0,0,0,0,0,0,0,0,0,0
163447,2023,USA,Italy,0,0,0,0,22/07/2023,0,0,0,0,0,0,0,0,0,0,0,0,0,0,0,0,0,0,0,0
163447,2023,Italy,Argentina,0,0,0,0,19/07/2023,0,0,0,0,0,0,0,0,0,0,0,0,0,0,0,0,0,0,0,0
163447,2023,Japan,Italy,0,0,0,0,8/7/2023,0,0,0,0,0,0,0,0,0,0,0,0,0,0,0,0,0,0,0,0
163447,2023,Slovenia,Italy,0,0,0,0,7/7/2023,0,0,0,0,0,0,0,0,0,0,0,0,0,0,0,0,0,0,0,0
163447,2023,Canada,Italy,0,0,0,0,6/7/2023,0,0,0,0,0,0,0,0,0,0,0,0,0,0,0,0,0,0,0,0
163447,2023,Brazil,Italy,0,0,0,0,4/7/2023,0,0,0,0,0,0,0,0,0,0,0,0,0,0,0,0,0,0,0,0
163447,2023,Germany,Italy,1,4,15,20,10/6/2023,0,0,2,2,11,4,11,26,1,2,3,6,2,3,26,31,12,2,0,14
163447,2023,Italy,Cuba,1,2,9,12,9/6/2023,0,0,2,2,15,6,5,26,1,3,0,4,3,0,15,18,6,2,0,8
163447,2023,Italy,USA,0,2,2,4,8/6/2023,0,0,1,1,8,2,8,18,0,2,1,3,1,3,10,14,1,1,0,2
163447,2023,Italy,Argentina,0,0,3,3,6/6/2023,0,0,0,0,3,1,0,4,0,0,0,0,0,1,1,2,0,0,0,0
152408,2023,Japan,Italy,1,3,8,12,23/07/2023,0,0,0,0,3,0,5,8,5,9,6,20,0,0,1,1,0,0,0,0
152408,2023,USA,Italy,3,4,4,11,22/07/2023,0,0,0,0,5,1,3,9,1,4,4,9,0,0,0,0,0,0,0,0
152408,2023,Italy,Argentina,1,2,10,13,19/07/2023,0,0,0,0,4,0,2,6,1,2,4,7,0,0,0,0,3,1,0,4
152408,2023,Japan,Italy,0,3,9,12,8/7/2023,0,0,2,2,6,0,3,9,5,4,6,15,0,1,2,3,3,0,0,3
152408,2023,Slovenia,Italy,0,3,3,6,7/7/2023,0,0,0,0,5,0,6,11,1,3,4,8,0,0,1,1,4,0,2,6
152408,2023,Canada,Italy,2,5,4,11,6/7/2023,0,0,1,1,10,0,1,11,3,5,7,15,0,0,0,0,1,0,0,1
152408,2023,Brazil,Italy,1,3,6,10,4/7/2023,0,0,1,1,7,0,1,8,4,6,8,18,0,0,1,1,3,0,1,4
152408,2023,Italy,Poland,0,1,3,4,25/06/2023,0,0,1,1,0,0,5,5,0,0,1,1,0,0,1,1,1,0,0,1
152408,2023,Serbia,Italy,0,0,0,0,23/06/2023,0,0,0,0,0,0,0,0,0,0,0,0,0,0,0,0,0,0,0,0
152408,2023,China,Italy,0,3,8,11,22/06/2023,0,0,0,0,3,2,0,5,0,4,1,5,0,0,0,0,0,0,0,0
152408,2023,Iran,Italy,0,1,5,6,21/06/2023,0,0,1,1,3,1,2,6,2,6,2,10,0,0,0,0,2,0,0,2
153200,2023,Japan,Italy,0,3,12,15,23/07/2023,0,0,3,3,11,4,16,31,3,4,6,13,4,4,16,24,6,1,0,7
153200,2023,USA,Italy,0,3,5,8,22/07/2023,0,0,5,5,8,3,12,23,1,5,2,8,2,1,13,16,4,2,0,6
153200,2023,Italy,Argentina,0,0,8,8,19/07/2023,0,0,5,5,11,1,10,22,1,3,4,8,6,2,6,14,3,3,0,6
153200,2023,Japan,Italy,1,3,16,20,8/7/2023,0,0,2,2,15,0,18,33,2,5,1,8,14,3,13,30,4,3,1,8
153200,2023,Slovenia,Italy,1,0,12,13,7/7/2023,0,0,2,2,7,3,10,20,5,2,3,10,8,1,15,24,5,0,1,6
153200,2023,Canada,Italy,0,2,12,14,6/7/2023,0,0,5,5,10,2,17,29,1,2,0,3,7,2,22,31,8,2,0,10
153200,2023,Brazil,Italy,2,2,16,20,4/7/2023,0,0,2,2,8,2,16,26,0,1,4,5,1,2,16,19,4,1,0,5
153200,2023,Italy,Poland,1,3,9,13,25/06/2023,0,0,2,2,15,2,16,33,2,3,5,10,6,3,14,23,7,1,1,9
153200,2023,Serbia,Italy,0,0,12,12,23/06/2023,0,0,4,4,5,2,5,12,2,1,3,6,3,0,16,19,4,0,0,4
153200,2023,China,Italy,0,2,5,7,22/06/2023,0,0,4,4,9,3,8,20,2,3,1,6,6,0,8,14,1,3,1,5
153200,2023,Iran,Italy,1,0,18,19,21/06/2023,0,0,4,4,9,0,12,21,1,2,3,6,4,1,16,21,4,1,0,5
162520,2023,Japan,Italy,0,4,9,13,23/07/2023,0,1,1,2,14,4,17,35,1,5,7,13,0,0,0,0,4,1,2,7
162520,2023,USA,Italy,1,2,1,4,22/07/2023,0,0,2,2,4,6,13,23,1,3,3,7,0,0,0,0,2,0,1,3
162520,2023,Italy,Argentina,0,4,3,7,19/07/2023,0,0,2,2,10,3,6,19,1,2,1,4,0,0,0,0,8,2,0,10
162520,2023,Japan,Italy,3,5,15,23,8/7/2023,0,0,1,1,16,6,5,27,3,5,2,10,0,0,1,1,5,2,3,10
162520,2023,Slovenia,Italy,3,1,7,11,7/7/2023,0,0,2,2,11,5,12,28,2,3,5,10,0,0,0,0,3,2,1,6
162520,2023,Canada,Italy,1,5,10,16,6/7/2023,0,0,2,2,16,6,19,41,1,6,8,15,0,0,1,1,5,8,0,13
162520,2023,Brazil,Italy,4,3,9,16,4/7/2023,0,0,1,1,16,1,14,31,0,4,5,9,0,0,0,0,4,2,2,8
162520,2023,Italy,Poland,1,4,11,16,25/06/2023,0,0,2,2,17,5,14,36,0,6,6,12,0,0,1,1,7,2,0,9
162520,2023,Serbia,Italy,2,1,8,11,23/06/2023,0,0,1,1,13,4,8,25,0,6,4,10,0,0,0,0,2,2,0,4
162520,2023,China,Italy,0,0,6,6,22/06/2023,0,0,1,1,8,1,5,14,4,1,1,6,0,1,1,2,3,0,0,3
162520,2023,Iran,Italy,2,4,9,15,21/06/2023,0,0,0,0,11,5,7,23,1,0,0,1,0,0,0,0,1,2,1,4
162520,2023,Germany,Italy,2,7,9,18,10/6/2023,0,0,1,1,14,5,15,34,1,2,2,5,0,0,1,1,4,2,1,7
162520,2023,Italy,Cuba,2,3,14,19,9/6/2023,0,0,1,1,15,3,12,30,0,0,6,6,0,0,0,0,2,2,0,4
162520,2023,Italy,USA,0,3,4,7,8/6/2023,0,0,0,0,8,5,10,23,0,5,1,6,0,0,0,0,3,1,0,4
162520,2023,Italy,Argentina,1,3,6,10,6/6/2023,0,1,2,3,12,5,10,27,1,1,2,4,0,0,0,0,5,1,1,7
163032,2023,Japan,Italy,0,0,0,0,23/07/2023,0,0,0,0,0,0,0,0,0,0,0,0,0,0,0,0,0,0,0,0
163032,2023,USA,Italy,0,0,4,4,22/07/2023,0,0,1,1,0,1,2,3,0,0,0,0,0,0,0,0,0,2,0,2
163032,2023,Italy,Argentina,0,0,0,0,19/07/2023,0,0,0,0,0,0,0,0,0,0,0,0,0,0,0,0,0,0,0,0
163032,2023,Italy,Poland,0,1,1,2,25/06/2023,0,0,0,0,0,0,0,0,0,0,0,0,0,0,0,0,0,0,0,0
163032,2023,Serbia,Italy,0,0,0,0,23/06/2023,0,0,0,0,0,0,0,0,0,0,0,0,0,0,0,0,0,0,0,0
163032,2023,China,Italy,0,1,1,2,22/06/2023,0,0,0,0,1,0,2,3,0,0,0,0,0,0,0,0,1,0,0,1
163032,2023,Iran,Italy,0,0,0,0,21/06/2023,0,0,0,0,0,0,0,0,0,0,0,0,0,0,0,0,0,0,0,0
163032,2023,Germany,Italy,0,0,1,1,10/6/2023,0,0,0,0,0,0,0,0,0,0,0,0,0,0,0,0,0,0,0,0
163032,2023,Italy,Cuba,0,0,0,0,9/6/2023,0,0,0,0,0,0,0,0,0,0,1,1,0,0,0,0,0,0,0,0
163032,2023,Italy,USA,0,0,1,1,8/6/2023,0,0,0,0,1,0,1,2,0,0,2,2,0,0,0,0,0,0,0,0
163032,2023,Italy,Argentina,0,1,2,3,6/6/2023,0,1,0,1,1,2,2,5,0,0,0,0,0,0,0,0,0,0,0,0
152405,2023,Japan,Italy,0,2,19,21,23/07/2023,0,0,3,3,8,3,4,15,3,4,9,16,0,0,3,3,1,1,0,2
152405,2023,USA,Italy,0,1,8,9,22/07/2023,0,0,0,0,5,1,3,9,3,2,5,10,1,0,2,3,3,0,0,3
152405,2023,Italy,Argentina,3,0,14,17,19/07/2023,0,0,0,0,4,1,1,6,3,4,2,9,0,0,1,1,5,0,1,6
152405,2023,Japan,Italy,0,2,8,10,8/7/2023,0,0,0,0,6,0,4,10,0,6,2,8,0,0,1,1,2,0,0,2
152405,2023,Slovenia,Italy,1,2,13,16,7/7/2023,0,0,2,2,3,1,3,7,4,3,8,15,0,0,0,0,3,2,1,6
152405,2023,Canada,Italy,2,2,23,27,6/7/2023,0,0,2,2,11,2,3,16,2,4,6,12,0,0,0,0,3,1,0,4
152405,2023,Brazil,Italy,2,1,14,17,4/7/2023,0,0,2,2,4,0,2,6,1,5,7,13,0,0,1,1,2,0,0,2
152405,2023,Italy,Poland,0,3,11,14,25/06/2023,0,0,0,0,8,0,5,13,0,6,5,11,0,0,2,2,4,0,1,5
152405,2023,Serbia,Italy,3,0,15,18,23/06/2023,0,0,0,0,5,1,2,8,6,6,3,15,0,0,1,1,2,2,1,5
152405,2023,China,Italy,0,0,0,0,22/06/2023,0,0,0,0,0,0,0,0,0,0,0,0,0,0,0,0,0,0,0,0
152405,2023,Iran,Italy,2,4,6,12,21/06/2023,0,0,0,0,5,0,6,11,2,2,1,5,0,0,0,0,1,0,0,1
172962,2023,Japan,Italy,0,0,2,2,23/07/2023,0,0,0,0,0,0,0,0,0,0,0,0,0,2,1,3,0,0,0,0
172962,2023,USA,Italy,0,0,0,0,22/07/2023,0,0,0,0,0,0,0,0,0,0,0,0,0,0,0,0,0,0,0,0
172962,2023,Italy,Argentina,0,0,0,0,19/07/2023,0,0,0,0,0,0,0,0,0,0,0,0,0,0,0,0,0,0,0,0
172962,2023,Japan,Italy,0,1,2,3,8/7/2023,0,0,1,1,5,1,4,10,0,3,2,5,1,0,6,7,2,0,0,2
172962,2023,Slovenia,Italy,0,0,0,0,7/7/2023,0,0,0,0,0,0,0,0,0,0,0,0,0,0,0,0,0,0,0,0
172962,2023,Canada,Italy,0,0,0,0,6/7/2023,0,0,0,0,0,0,0,0,0,0,0,0,0,0,0,0,0,0,0,0
172962,2023,Brazil,Italy,0,0,0,0,4/7/2023,0,0,0,0,0,0,0,0,0,0,0,0,0,0,0,0,0,0,0,0
172962,2023,Italy,Poland,0,0,0,0,25/06/2023,0,0,0,0,0,0,0,0,0,0,0,0,1,0,1,2,0,0,0,0
172962,2023,Serbia,Italy,0,0,0,0,23/06/2023,0,0,0,0,0,0,0,0,0,0,0,0,0,0,0,0,0,0,0,0
172962,2023,China,Italy,1,0,4,5,22/06/2023,0,0,0,0,3,1,7,11,0,0,1,1,1,0,9,10,2,1,0,3
172962,2023,Iran,Italy,0,0,0,0,21/06/2023,0,0,0,0,0,0,0,0,0,0,0,0,0,0,0,0,0,0,0,0
172962,2023,Germany,Italy,1,3,11,15,10/6/2023,0,0,3,3,16,5,9,30,1,3,1,5,0,0,11,11,6,9,2,17
172962,2023,Italy,Cuba,0,3,15,18,9/6/2023,0,0,0,0,9,4,9,22,2,3,3,8,3,3,19,25,4,1,0,5
172962,2023,Italy,USA,1,1,10,12,8/6/2023,0,0,1,1,8,1,7,16,0,1,1,2,1,2,14,17,4,1,0,5
172962,2023,Italy,Argentina,0,2,6,8,6/6/2023,0,0,1,1,6,3,11,20,0,1,0,1,0,1,9,10,4,2,0,6
174076,2023,Japan,Italy,0,0,0,0,23/07/2023,0,0,0,0,0,0,0,0,0,0,0,0,0,0,0,0,0,0,0,0
174076,2023,USA,Italy,0,0,0,0,22/07/2023,0,0,0,0,0,0,0,0,0,0,0,0,0,0,0,0,0,0,0,0
174076,2023,Italy,Argentina,0,0,0,0,19/07/2023,0,0,0,0,0,0,0,0,0,0,0,0,0,0,0,0,0,0,0,0
174076,2023,Japan,Italy,0,0,0,0,8/7/2023,0,0,0,0,0,0,0,0,0,0,0,0,0,0,0,0,0,0,0,0
174076,2023,Slovenia,Italy,0,0,0,0,7/7/2023,0,0,0,0,0,0,0,0,0,0,0,0,0,0,0,0,0,0,0,0
174076,2023,Canada,Italy,0,0,0,0,6/7/2023,0,0,0,0,0,0,0,0,0,0,0,0,0,0,0,0,0,0,0,0
174076,2023,Brazil,Italy,0,0,0,0,4/7/2023,0,0,0,0,0,0,0,0,0,0,0,0,0,0,0,0,0,0,0,0
174076,2023,Germany,Italy,3,4,9,16,10/6/2023,0,0,1,1,4,0,2,6,1,5,1,7,0,0,0,0,3,0,0,3
174076,2023,Italy,Cuba,1,6,5,12,9/6/2023,0,0,1,1,7,1,1,9,3,0,3,6,0,0,0,0,1,0,0,1
174076,2023,Italy,USA,1,0,3,4,8/6/2023,0,0,0,0,1,0,2,3,0,1,3,4,0,0,0,0,1,0,0,1
174076,2023,Italy,Argentina,0,0,2,2,6/6/2023,0,0,0,0,0,1,0,1,0,0,2,2,0,0,0,0,0,0,0,0
174074,2023,Japan,Italy,0,0,0,0,23/07/2023,0,0,0,0,0,0,0,0,0,0,0,0,0,0,0,0,0,0,0,0
174074,2023,USA,Italy,0,0,0,0,22/07/2023,0,0,0,0,0,0,0,0,0,0,0,0,0,0,0,0,0,0,0,0
174074,2023,Italy,Argentina,0,0,0,0,19/07/2023,0,0,0,0,0,0,0,0,0,0,0,0,0,0,0,0,0,0,0,0
174074,2023,Japan,Italy,0,0,2,2,8/7/2023,0,0,0,0,1,0,0,1,0,3,0,3,0,0,0,0,0,0,0,0
174074,2023,Slovenia,Italy,0,0,0,0,7/7/2023,0,0,0,0,0,0,0,0,0,0,0,0,0,0,0,0,0,0,0,0
174074,2023,Canada,Italy,0,0,0,0,6/7/2023,0,0,0,0,0,0,0,0,1,0,0,1,0,0,0,0,0,0,0,0
174074,2023,Brazil,Italy,0,0,0,0,4/7/2023,0,0,0,0,0,0,0,0,0,0,0,0,0,0,0,0,0,0,0,0
174074,2023,Germany,Italy,0,0,12,12,10/6/2023,0,0,0,0,7,0,1,8,2,1,3,6,0,0,0,0,0,1,0,1
174074,2023,Italy,Cuba,0,2,11,13,9/6/2023,0,0,4,4,2,1,0,3,2,6,2,10,0,0,1,1,0,1,0,1
174074,2023,Italy,USA,0,1,4,5,8/6/2023,0,1,0,1,1,1,4,6,1,0,1,2,0,1,0,1,0,0,0,0
174074,2023,Italy,Argentina,0,0,7,7,6/6/2023,0,0,0,0,6,1,1,8,1,0,1,2,0,0,0,0,1,2,0,3
142565,2023,Japan,Italy,1,1,11,13,23/07/2023,0,0,0,0,2,0,3,5,0,3,4,7,0,0,0,0,1,1,0,2
142565,2023,Japan,Poland,0,3,8,11,22/07/2023,0,0,0,0,8,0,8,16,2,8,2,12,2,0,0,2,4,0,0,4
142565,2023,Japan,Slovenia,0,1,18,19,20/07/2023,0,0,2,2,5,0,6,11,1,3,4,8,0,0,2,2,4,1,0,5
142565,2023,Japan,Poland,0,0,3,3,9/7/2023,0,0,0,0,1,0,2,3,0,2,1,3,1,0,0,1,1,0,0,1
142565,2023,Japan,Italy,1,1,11,13,8/7/2023,0,0,1,1,6,1,4,11,0,6,5,11,2,0,2,4,0,0,0,0
142565,2023,Japan,Netherlands,0,3,8,11,7/7/2023,0,0,0,0,3,1,4,8,3,4,1,8,0,0,1,1,2,0,0,2
142565,2023,Japan,China,1,2,17,20,4/7/2023,0,0,2,2,5,2,3,10,1,4,5,10,0,0,1,1,1,1,1,3
142565,2023,Japan,Argentina,0,3,13,16,24/06/2023,0,0,2,2,8,0,2,10,0,2,1,3,1,0,2,3,3,1,1,5
142565,2023,Japan,Brazil,0,2,13,15,22/06/2023,0,0,0,0,4,1,4,9,3,3,2,8,1,0,0,1,2,3,0,5
142565,2023,Japan,Cuba,0,0,9,9,21/06/2023,0,0,0,0,7,0,0,7,1,2,1,4,0,0,1,1,2,2,0,4
142565,2023,Japan,Canada,0,1,7,8,20/06/2023,0,0,1,1,9,0,2,11,3,3,2,8,0,0,0,0,2,0,0,2
142565,2023,Japan,France,0,2,10,12,11/6/2023,0,0,0,0,5,1,1,7,1,4,5,10,0,1,1,2,3,0,0,3
142565,2023,Japan,Bulgaria,0,4,10,14,10/6/2023,0,0,2,2,8,2,3,13,1,0,2,3,2,1,0,3,2,0,2,4
142565,2023,Japan,Serbia,0,1,11,12,9/6/2023,0,0,0,0,5,1,1,7,1,5,2,8,0,0,0,0,3,0,0,3
142565,2023,Japan,Iran,1,0,10,11,6/6/2023,0,0,2,2,2,0,1,3,1,4,4,9,0,0,0,0,2,0,0,2
163038,2023,Japan,Italy,7,5,11,23,23/07/2023,0,1,1,2,12,7,11,30,1,1,6,8,0,0,0,0,10,2,0,12
163038,2023,Japan,Poland,0,2,16,18,22/07/2023,0,0,1,1,13,6,6,25,0,0,2,2,0,0,1,1,3,3,0,6
163038,2023,Japan,Slovenia,0,0,0,0,20/07/2023,0,0,0,0,1,0,1,2,0,1,0,1,0,0,0,0,0,0,0,0
163038,2023,Japan,Poland,0,2,2,4,9/7/2023,0,0,0,0,3,2,8,13,0,2,1,3,0,0,0,0,0,2,0,2
163038,2023,Japan,Italy,1,0,1,2,8/7/2023,0,0,0,0,0,0,0,0,0,0,0,0,0,0,0,0,0,0,0,0
163038,2023,Japan,Netherlands,2,1,10,13,7/7/2023,0,0,0,0,9,7,6,22,1,2,0,3,0,0,0,0,4,2,1,7
163038,2023,Japan,China,1,3,4,8,4/7/2023,0,0,1,1,14,3,3,20,0,2,0,2,0,0,0,0,2,2,1,5
163038,2023,Japan,Argentina,0,5,18,23,24/06/2023,0,1,0,1,27,5,7,39,1,6,2,9,0,0,0,0,2,2,1,5
163038,2023,Japan,Brazil,1,8,10,19,22/06/2023,0,0,1,1,22,9,6,37,1,2,3,6,0,0,0,0,5,7,0,12
163038,2023,Japan,Cuba,0,1,0,1,21/06/2023,0,0,1,1,0,0,0,0,0,0,0,0,0,0,0,0,0,0,0,0
163038,2023,Japan,Canada,0,1,0,1,20/06/2023,0,0,0,0,2,1,1,4,0,1,0,1,0,0,0,0,0,0,0,0
163038,2023,Japan,France,2,1,3,6,11/6/2023,0,0,1,1,10,1,1,12,1,3,0,4,0,0,0,0,1,0,0,1
163038,2023,Japan,Bulgaria,0,0,0,0,10/6/2023,0,0,0,0,0,0,0,0,0,0,0,0,0,0,0,0,0,0,0,0
163038,2023,Japan,Serbia,1,1,0,2,9/6/2023,0,0,0,0,0,0,0,0,0,0,0,0,0,0,0,0,0,0,0,0
163038,2023,Japan,Iran,0,0,0,0,6/6/2023,0,0,0,0,3,1,0,4,0,1,0,1,0,0,0,0,2,0,0,2
163516,2023,Japan,Italy,0,0,2,2,23/07/2023,0,0,2,2,1,2,4,7,0,2,0,2,1,1,8,10,3,2,1,6
163516,2023,Japan,Poland,0,0,1,1,22/07/2023,0,0,0,0,0,0,0,0,0,0,0,0,0,0,0,0,0,0,0,0
163516,2023,Japan,Slovenia,0,0,0,0,20/07/2023,0,0,0,0,0,0,0,0,0,0,0,0,0,0,0,0,0,0,0,0
163516,2023,Japan,Poland,0,1,7,8,9/7/2023,0,0,4,4,11,2,9,22,0,1,2,3,2,2,16,20,3,2,0,5
163516,2023,Japan,Italy,0,2,13,15,8/7/2023,0,0,5,5,14,4,9,27,0,0,1,1,8,3,30,41,10,0,0,10
163516,2023,Japan,Netherlands,0,1,0,1,7/7/2023,0,0,0,0,0,0,0,0,0,0,0,0,0,0,0,0,0,0,0,0
163516,2023,Japan,China,0,0,1,1,4/7/2023,0,0,0,0,2,1,3,6,0,0,0,0,0,0,5,5,0,0,0,0
163516,2023,Japan,Argentina,0,0,1,1,24/06/2023,0,0,0,0,0,0,0,0,0,0,0,0,0,0,0,0,0,0,0,0
163516,2023,Japan,Brazil,0,0,1,1,22/06/2023,0,0,0,0,2,0,2,4,0,2,1,3,1,0,1,2,0,0,0,0
163516,2023,Japan,Cuba,0,0,0,0,21/06/2023,0,0,0,0,0,0,0,0,0,0,0,0,0,0,0,0,0,0,0,0
163516,2023,Japan,Canada,0,0,0,0,20/06/2023,0,0,0,0,0,0,0,0,0,0,0,0,0,0,0,0,0,0,0,0
163516,2023,Japan,France,0,0,0,0,11/6/2023,0,0,0,0,0,0,0,0,0,0,0,0,0,0,0,0,0,0,0,0
163516,2023,Japan,Bulgaria,0,0,0,0,10/6/2023,0,0,0,0,1,0,0,1,0,0,0,0,0,0,0,0,0,0,0,0
163516,2023,Japan,Serbia,0,0,0,0,9/6/2023,0,0,0,0,0,0,0,0,0,0,0,0,0,0,0,0,0,0,0,0
146409,2023,Japan,Italy,1,1,11,13,23/07/2023,0,0,2,2,7,0,5,12,2,1,6,9,1,0,4,5,2,0,1,3
146409,2023,Japan,Poland,0,1,6,7,22/07/2023,0,0,0,0,2,0,3,5,0,4,3,7,0,0,0,0,0,1,0,1
146409,2023,Japan,Slovenia,0,1,5,6,20/07/2023,0,0,1,1,5,2,5,12,1,3,4,8,0,0,0,0,1,0,0,1
146409,2023,Japan,Poland,0,0,0,0,9/7/2023,0,0,0,0,0,0,0,0,0,0,0,0,0,0,0,0,0,0,0,0
146409,2023,Japan,Italy,0,1,15,16,8/7/2023,0,0,2,2,3,1,3,7,0,1,3,4,0,0,0,0,1,1,0,2
146409,2023,Japan,Netherlands,0,1,9,10,7/7/2023,0,0,0,0,10,2,1,13,3,2,3,8,1,0,0,1,0,0,0,0
146409,2023,Japan,China,0,1,10,11,4/7/2023,0,0,0,0,4,1,2,7,1,4,1,6,0,0,0,0,1,0,0,1
146409,2023,Japan,Argentina,0,3,17,20,24/06/2023,0,0,0,0,7,1,4,12,1,4,6,11,0,0,0,0,0,1,0,1
146409,2023,Japan,Brazil,1,2,10,13,22/06/2023,0,0,0,0,1,2,5,8,0,5,0,5,0,0,0,0,1,2,0,3
146409,2023,Japan,Cuba,0,1,14,15,21/06/2023,0,0,0,0,8,0,3,11,1,2,0,3,0,0,0,0,0,2,0,2
146409,2023,Japan,Canada,2,0,26,28,20/06/2023,0,0,3,3,4,2,4,10,1,5,1,7,0,0,0,0,2,1,2,5
146409,2023,Japan,France,0,0,0,0,11/6/2023,0,0,0,0,0,0,0,0,0,0,0,0,0,0,0,0,0,0,0,0
146409,2023,Japan,Bulgaria,0,0,0,0,10/6/2023,0,0,0,0,0,0,0,0,0,0,0,0,0,0,0,0,0,0,0,0
146409,2023,Japan,Serbia,0,0,5,5,9/6/2023,0,0,0,0,0,1,1,2,0,3,0,3,0,0,0,0,1,0,0,1
146409,2023,Japan,Iran,0,0,6,6,6/6/2023,0,0,0,0,7,1,2,10,2,3,2,7,1,0,0,1,2,0,0,2
133009,2023,Japan,Italy,0,1,21,22,23/07/2023,33,0,77,110,0,0,1,1,0,0,0,0,0,0,0,0,8,7,4,19
133009,2023,Japan,Poland,0,0,9,9,22/07/2023,13,0,67,80,0,0,0,0,0,4,3,7,0,0,0,0,2,2,1,5
133009,2023,Japan,Slovenia,1,0,15,16,20/07/2023,28,0,59,87,0,0,1,1,0,1,6,7,0,0,1,1,6,0,2,8
133009,2023,Japan,Poland,0,0,0,0,9/7/2023,0,0,0,0,0,0,0,0,0,0,0,0,0,0,0,0,0,0,0,0
133009,2023,Japan,Italy,0,1,15,16,8/7/2023,24,2,82,108,0,0,1,1,0,0,3,3,0,0,1,1,7,6,1,14
133009,2023,Japan,Netherlands,0,1,20,21,7/7/2023,25,0,59,84,0,0,0,0,1,3,3,7,0,0,0,0,3,1,0,4
133009,2023,Japan,China,0,1,15,16,4/7/2023,27,0,69,96,0,0,1,1,0,2,1,3,0,0,0,0,9,3,2,14
133009,2023,Japan,Argentina,1,1,15,17,24/06/2023,21,0,87,108,0,0,0,0,0,7,0,7,0,0,0,0,7,8,1,16
133009,2023,Japan,Brazil,1,1,17,19,22/06/2023,23,0,88,111,0,0,0,0,0,3,2,5,0,0,0,0,5,7,3,15
133009,2023,Japan,Cuba,0,1,16,17,21/06/2023,29,0,29,58,0,0,0,0,0,2,1,3,0,0,0,0,1,1,0,2
133009,2023,Japan,Canada,0,0,17,17,20/06/2023,19,0,61,80,0,0,0,0,0,3,3,6,0,0,0,0,7,2,1,10
133009,2023,Japan,France,0,0,12,12,11/6/2023,8,0,51,59,0,0,0,0,0,0,0,0,0,0,0,0,5,1,0,6
133009,2023,Japan,Bulgaria,0,1,13,14,10/6/2023,22,0,47,69,1,0,0,1,0,2,2,4,0,0,0,0,1,0,0,1
133009,2023,Japan,Serbia,1,0,16,17,9/6/2023,19,1,70,90,1,0,0,1,0,2,3,5,0,0,0,0,5,0,2,7
133009,2023,Japan,Iran,1,0,17,18,6/6/2023,5,0,66,71,0,0,0,0,0,1,0,1,0,0,1,1,5,0,1,6
142561,2023,Japan,Italy,0,0,0,0,23/07/2023,0,0,0,0,0,0,0,0,0,0,0,0,0,0,0,0,0,0,0,0
142561,2023,Japan,Poland,0,1,3,4,22/07/2023,0,0,0,0,0,0,1,1,0,1,1,2,0,0,0,0,0,0,0,0
142561,2023,Japan,Slovenia,0,0,0,0,20/07/2023,0,0,0,0,0,0,0,0,0,0,0,0,0,0,0,0,0,0,0,0
142561,2023,Japan,Poland,0,0,6,6,9/7/2023,0,0,1,1,2,0,2,4,0,5,1,6,0,1,0,1,1,0,0,1
142561,2023,Japan,Italy,0,0,0,0,8/7/2023,0,0,0,0,0,0,0,0,0,0,0,0,0,0,0,0,0,0,0,0
142561,2023,Japan,Netherlands,0,0,0,0,7/7/2023,0,0,0,0,0,0,0,0,0,0,0,0,0,0,0,0,0,0,0,0
142561,2023,Japan,China,0,1,2,3,4/7/2023,0,0,0,0,1,2,0,3,1,2,2,5,0,0,0,0,0,0,0,0
142561,2023,Japan,Argentina,0,0,0,0,24/06/2023,0,0,0,0,0,0,0,0,1,0,0,1,0,0,0,0,0,0,0,0
142561,2023,Japan,Brazil,0,2,4,6,22/06/2023,0,0,1,1,0,0,2,2,0,1,0,1,0,0,0,0,1,0,0,1
142561,2023,Japan,Cuba,0,0,0,0,21/06/2023,0,0,0,0,0,0,0,0,0,0,0,0,0,0,0,0,0,0,0,0
142561,2023,Japan,Canada,0,0,0,0,20/06/2023,0,0,0,0,0,0,0,0,0,0,0,0,0,0,0,0,0,0,0,0
142561,2023,Japan,France,0,1,13,14,11/6/2023,0,0,0,0,6,0,4,10,2,5,3,10,0,0,0,0,1,0,1,2
142561,2023,Japan,Bulgaria,0,1,7,8,10/6/2023,0,0,1,1,4,0,0,4,2,6,4,12,1,0,0,1,2,0,0,2
142561,2023,Japan,Serbia,0,1,6,7,9/6/2023,0,0,1,1,6,0,0,6,0,6,3,9,0,0,0,0,0,1,0,1
142561,2023,Japan,Iran,0,0,0,0,6/6/2023,0,0,0,0,0,0,0,0,0,0,0,0,0,0,0,0,0,0,0,0
178761,2023,Japan,Italy,0,0,0,0,23/07/2023,0,0,0,0,0,0,0,0,0,0,0,0,0,0,1,1,1,0,0,1
178761,2023,Japan,Poland,0,0,0,0,22/07/2023,0,0,0,0,0,0,0,0,0,0,0,0,0,0,1,1,0,0,0,0
178761,2023,Japan,Slovenia,0,0,0,0,20/07/2023,0,0,0,0,0,0,0,0,0,0,0,0,0,0,0,0,0,0,0,0
178761,2023,Japan,Poland,0,1,2,3,9/7/2023,0,0,2,2,5,0,4,9,0,0,0,0,0,0,9,9,2,1,0,3
178761,2023,Japan,Italy,0,0,0,0,8/7/2023,0,0,0,0,0,0,0,0,0,0,0,0,1,0,3,4,0,0,0,0
178761,2023,Japan,Netherlands,0,1,2,3,7/7/2023,0,0,0,0,4,0,2,6,0,0,0,0,3,0,2,5,1,0,0,1
178761,2023,Japan,China,0,0,1,1,4/7/2023,0,0,0,0,0,0,0,0,0,0,0,0,0,0,1,1,0,0,0,0
178761,2023,Japan,Argentina,0,0,0,0,24/06/2023,0,0,0,0,0,0,0,0,0,0,0,0,1,0,0,1,0,0,0,0
178761,2023,Japan,Brazil,0,0,1,1,22/06/2023,0,0,0,0,0,0,0,0,0,0,0,0,0,0,0,0,0,1,0,1
178761,2023,Japan,Cuba,0,0,0,0,21/06/2023,0,0,0,0,0,0,0,0,0,0,0,0,1,0,0,1,0,0,0,0
178761,2023,Japan,Canada,0,0,0,0,20/06/2023,0,0,2,2,0,0,0,0,0,0,0,0,1,0,3,4,1,0,0,1
178761,2023,Japan,France,0,0,0,0,11/6/2023,0,0,0,0,0,0,0,0,0,0,0,0,0,0,0,0,0,0,0,0
178761,2023,Japan,Bulgaria,0,0,0,0,10/6/2023,0,0,0,0,0,0,0,0,0,0,0,0,1,0,0,1,0,0,0,0
178761,2023,Japan,Serbia,0,0,0,0,9/6/2023,0,0,0,0,0,0,0,0,0,0,0,0,0,0,0,0,0,0,0,0
178761,2023,Japan,Iran,0,0,0,0,6/6/2023,0,0,0,0,0,0,0,0,0,0,0,0,0,0,0,0,0,0,0,0
178762,2023,Japan,Italy,0,2,6,8,23/07/2023,0,0,2,2,11,6,12,29,1,1,4,6,4,4,12,20,6,2,0,8
178762,2023,Japan,Poland,3,3,12,18,22/07/2023,0,0,4,4,12,5,7,24,1,4,4,9,7,1,15,23,6,4,0,10
178762,2023,Japan,Slovenia,0,2,13,15,20/07/2023,1,0,6,7,9,4,5,18,0,4,1,5,5,0,15,20,7,1,1,9
178762,2023,Japan,Poland,0,0,0,0,9/7/2023,0,0,0,0,0,0,0,0,0,0,0,0,0,0,0,0,0,0,0,0
178762,2023,Japan,Italy,0,0,0,0,8/7/2023,0,0,0,0,0,0,0,0,0,0,0,0,0,0,0,0,0,0,0,0
178762,2023,Japan,Netherlands,0,3,13,16,7/7/2023,0,0,5,5,9,1,5,15,1,3,1,5,3,1,18,22,8,1,0,9
178762,2023,Japan,China,4,5,15,24,4/7/2023,0,0,8,8,10,6,9,25,0,2,0,2,10,2,28,40,7,4,1,12
178762,2023,Japan,Argentina,1,3,15,19,24/06/2023,0,0,4,4,29,3,8,40,2,6,4,12,13,2,29,44,9,4,0,13
178762,2023,Japan,Brazil,2,4,12,18,22/06/2023,0,0,7,7,19,1,11,31,0,5,1,6,8,0,17,25,9,2,2,13
178762,2023,Japan,Cuba,0,1,8,9,21/06/2023,0,0,2,2,13,2,4,19,1,2,1,4,3,1,12,16,6,3,0,9
178762,2023,Japan,Canada,0,1,11,12,20/06/2023,0,0,1,1,15,4,10,29,3,3,5,11,1,3,12,16,10,4,1,15
178762,2023,Japan,France,2,3,15,20,11/6/2023,0,0,2,2,14,5,7,26,1,2,1,4,7,0,14,21,4,0,0,4
178762,2023,Japan,Bulgaria,0,1,7,8,10/6/2023,0,0,3,3,10,0,3,13,0,1,2,3,5,2,8,15,8,0,3,11
178762,2023,Japan,Serbia,2,3,16,21,9/6/2023,0,0,1,1,13,6,3,22,0,1,3,4,6,0,15,21,8,1,1,10
178762,2023,Japan,Iran,1,3,10,14,6/6/2023,0,0,2,2,9,3,10,22,0,0,1,1,4,1,15,20,8,0,2,10
180990,2023,Japan,Italy,0,0,0,0,23/07/2023,0,0,0,0,0,0,0,0,0,0,0,0,0,0,0,0,0,0,0,0
180990,2023,Japan,Poland,0,0,0,0,22/07/2023,0,0,0,0,0,0,0,0,0,0,0,0,0,0,0,0,0,0,0,0
180990,2023,Japan,Slovenia,0,0,0,0,20/07/2023,0,0,0,0,0,0,0,0,0,0,0,0,0,0,0,0,0,0,0,0
180990,2023,Japan,Poland,0,0,0,0,9/7/2023,0,0,3,3,0,0,0,0,0,0,0,0,6,2,7,15,8,2,2,12
180990,2023,Japan,Italy,0,0,0,0,8/7/2023,0,0,0,0,0,0,0,0,0,0,0,0,0,0,0,0,0,0,0,0
180990,2023,Japan,Netherlands,0,0,0,0,7/7/2023,0,0,4,4,0,0,0,0,0,0,0,0,2,0,5,7,8,1,0,9
180990,2023,Japan,China,0,0,0,0,4/7/2023,0,0,0,0,0,0,0,0,0,0,0,0,0,0,0,0,0,0,0,0
180990,2023,Japan,Argentina,0,0,0,0,24/06/2023,0,0,0,0,0,0,0,0,0,0,0,0,0,0,0,0,0,0,0,0
180990,2023,Japan,Brazil,0,0,0,0,22/06/2023,0,0,0,0,0,0,0,0,0,0,0,0,0,0,0,0,0,0,0,0
180990,2023,Japan,Cuba,0,0,0,0,21/06/2023,0,0,0,0,0,0,0,0,0,0,0,0,0,0,0,0,0,0,0,0
180990,2023,Japan,Canada,0,0,0,0,20/06/2023,0,0,0,0,0,0,0,0,0,0,0,0,0,0,0,0,0,0,0,0
180990,2023,Japan,France,0,0,0,0,11/6/2023,0,0,0,0,0,0,0,0,0,0,0,0,0,0,0,0,0,0,0,0
180990,2023,Japan,Bulgaria,0,0,0,0,10/6/2023,0,0,0,0,0,0,0,0,0,0,0,0,0,0,0,0,0,0,0,0
180990,2023,Japan,Serbia,0,0,0,0,9/6/2023,0,0,0,0,0,0,0,0,0,0,0,0,0,0,0,0,0,0,0,0
180990,2023,Japan,Iran,0,0,0,0,6/6/2023,0,0,0,0,0,0,0,0,0,0,0,0,0,0,0,0,0,0,0,0
142568,2023,Japan,Italy,0,3,13,16,23/07/2023,0,1,7,8,21,8,19,48,0,4,3,7,7,2,18,27,4,3,0,7
142568,2023,Japan,Poland,4,4,10,18,22/07/2023,0,0,4,4,17,2,9,28,1,2,0,3,1,1,29,31,3,3,4,10
142568,2023,Japan,Slovenia,1,3,5,9,20/07/2023,1,0,2,3,22,2,13,37,4,8,3,15,2,0,18,20,5,2,0,7
142568,2023,Japan,Poland,1,2,4,7,9/7/2023,0,0,3,3,6,2,5,13,0,2,2,4,0,2,11,13,1,1,1,3
142568,2023,Japan,Italy,1,3,12,16,8/7/2023,0,0,2,2,17,8,17,42,3,2,0,5,2,2,13,17,7,2,4,13
142568,2023,Japan,Netherlands,1,5,12,18,7/7/2023,0,0,4,4,14,5,8,27,2,6,6,14,8,0,12,20,1,1,1,3
142568,2023,Japan,China,1,4,10,15,4/7/2023,0,0,2,2,16,4,15,35,1,1,4,6,3,1,15,19,2,3,1,6
142568,2023,Japan,Argentina,1,6,15,22,24/06/2023,0,0,4,4,16,5,6,27,0,1,6,7,8,1,20,29,6,2,1,9
142568,2023,Japan,Brazil,2,4,10,16,22/06/2023,0,0,6,6,25,3,15,43,0,7,4,11,13,1,26,40,3,1,0,4
142568,2023,Japan,Cuba,0,4,8,12,21/06/2023,0,0,2,2,5,1,5,11,0,2,3,5,3,1,5,9,4,1,0,5
142568,2023,Japan,Canada,3,5,9,17,20/06/2023,0,0,2,2,19,2,9,30,1,5,2,8,7,3,17,27,5,4,1,10
142568,2023,Japan,France,1,3,14,18,11/6/2023,0,1,6,7,14,2,8,24,1,3,2,6,11,1,16,28,10,1,1,12
142568,2023,Japan,Bulgaria,3,5,8,16,10/6/2023,0,0,1,1,12,3,12,27,2,3,4,9,7,1,17,25,9,0,1,10
142568,2023,Japan,Serbia,1,3,13,17,9/6/2023,0,0,1,1,15,4,7,26,1,1,1,3,9,0,20,29,7,0,0,7
142568,2023,Japan,Iran,1,4,9,14,6/6/2023,0,0,2,2,18,5,7,30,1,2,2,5,3,2,10,15,5,0,0,5
192453,2023,Japan,Italy,0,0,2,2,23/07/2023,0,0,0,0,0,1,0,1,0,0,0,0,0,0,0,0,0,0,0,0
192453,2023,Japan,Poland,1,2,0,3,22/07/2023,0,0,0,0,3,2,1,6,0,1,0,1,0,0,0,0,2,0,0,2
192453,2023,Japan,Slovenia,0,0,0,0,20/07/2023,0,0,0,0,0,0,0,0,0,0,0,0,0,0,0,0,0,0,0,0
172893,2023,Japan,Italy,0,0,0,0,23/07/2023,0,0,6,6,0,0,0,0,0,0,0,0,7,0,12,19,14,5,0,19
172893,2023,Japan,Poland,0,0,0,0,22/07/2023,0,0,2,2,0,0,0,0,0,0,0,0,3,2,16,21,11,4,0,15
172893,2023,Japan,Slovenia,0,0,0,0,20/07/2023,0,0,6,6,0,0,0,0,0,0,0,0,5,0,8,13,10,4,1,15
172893,2023,Japan,Poland,0,0,0,0,9/7/2023,0,0,0,0,0,0,0,0,0,0,0,0,0,0,0,0,0,0,0,0
172893,2023,Japan,Italy,0,0,0,0,8/7/2023,0,0,5,5,0,0,0,0,0,0,0,0,4,0,14,18,9,7,1,17
172893,2023,Japan,Netherlands,0,0,0,0,7/7/2023,0,0,2,2,0,0,0,0,0,0,0,0,3,1,5,9,5,3,0,8
172893,2023,Japan,China,0,0,0,0,4/7/2023,0,0,8,8,0,0,0,0,0,0,0,0,4,2,14,20,7,2,2,11
172893,2023,Japan,Argentina,0,0,0,0,24/06/2023,0,0,6,6,0,0,0,0,0,0,0,0,5,1,7,13,10,4,3,17
172893,2023,Japan,Brazil,0,0,0,0,22/06/2023,0,0,5,5,0,0,0,0,0,0,0,0,12,1,13,26,11,3,4,18
172893,2023,Japan,Cuba,0,0,0,0,21/06/2023,0,0,2,2,0,0,0,0,0,0,0,0,3,1,8,12,6,3,1,10
172893,2023,Japan,Canada,0,0,0,0,20/06/2023,0,0,11,11,0,0,0,0,0,0,0,0,3,2,17,22,12,4,0,16
172893,2023,Japan,France,0,0,0,0,11/6/2023,0,0,4,4,0,0,0,0,0,0,0,0,7,1,9,17,8,1,3,12
172893,2023,Japan,Bulgaria,0,0,0,0,10/6/2023,0,0,1,1,0,0,0,0,0,0,0,0,5,1,4,10,7,1,1,9
172893,2023,Japan,Serbia,0,0,0,0,9/6/2023,0,0,3,3,0,0,0,0,0,0,0,0,9,2,7,18,10,1,2,13
172893,2023,Japan,Iran,0,0,0,0,6/6/2023,0,0,2,2,0,0,0,0,0,0,0,0,2,0,6,8,11,1,1,13
142562,2023,Japan,Italy,0,0,0,0,23/07/2023,1,0,1,2,0,0,0,0,0,0,0,0,0,0,0,0,0,0,0,0
142562,2023,Japan,Poland,0,0,1,1,22/07/2023,3,1,12,16,0,0,0,0,0,0,1,1,0,0,1,1,0,1,0,1
142562,2023,Japan,Slovenia,0,0,0,0,20/07/2023,0,0,0,0,0,0,0,0,0,0,0,0,0,0,0,0,0,0,0,0
142562,2023,Japan,Poland,0,1,6,7,9/7/2023,16,0,55,71,0,0,0,0,1,5,1,7,0,0,0,0,7,4,0,11
142562,2023,Japan,Italy,0,0,0,0,8/7/2023,0,0,0,0,0,0,0,0,0,0,0,0,0,0,0,0,0,0,0,0
142562,2023,Japan,Netherlands,0,0,0,0,7/7/2023,0,0,1,1,0,0,0,0,0,0,0,0,0,0,0,0,0,0,0,0
142562,2023,Japan,China,0,0,0,0,4/7/2023,0,0,10,10,0,0,0,0,0,0,0,0,0,0,0,0,1,0,0,1
189039,2023,Japan,Italy,0,0,0,0,23/07/2023,0,0,0,0,0,0,0,0,0,0,0,0,0,0,0,0,0,0,0,0
189039,2023,Japan,Poland,0,0,9,9,9/7/2023,0,0,0,0,2,1,2,5,0,1,1,2,1,1,0,2,2,1,0,3
189039,2023,Japan,Italy,0,0,0,0,8/7/2023,0,0,0,0,0,0,0,0,0,0,0,0,0,0,0,0,0,0,0,0
189039,2023,Japan,Netherlands,0,0,0,0,7/7/2023,0,0,0,0,0,0,0,0,0,0,0,0,0,0,0,0,0,0,0,0
189039,2023,Japan,China,0,0,0,0,4/7/2023,0,0,0,0,0,0,0,0,0,0,0,0,0,0,0,0,0,0,0,0
188782,2023,Slovenia,Netherlands,0,0,0,0,9/7/2023,0,0,0,0,0,0,0,0,0,0,0,0,0,0,0,0,0,0,0,0
188782,2023,Japan,Netherlands,0,0,0,0,7/7/2023,0,0,0,0,0,0,0,0,0,0,0,0,0,0,0,0,0,0,0,0
188782,2023,Brazil,Netherlands,0,0,0,0,6/7/2023,0,0,0,0,0,0,0,0,0,0,0,0,0,0,0,0,0,0,0,0
188782,2023,Canada,Netherlands,0,1,1,2,5/7/2023,0,0,0,0,2,0,0,2,1,0,2,3,0,0,0,0,0,0,0,0
188782,2023,Netherlands,Serbia,0,0,0,0,25/06/2023,0,0,0,0,0,0,0,0,0,0,0,0,0,0,0,0,0,0,0,0
188782,2023,Netherlands,Iran,0,0,0,0,24/06/2023,0,0,0,0,0,0,0,0,0,0,0,0,0,0,0,0,0,0,0,0
188782,2023,Netherlands,Poland,0,0,0,0,22/06/2023,0,0,0,0,0,0,0,0,0,0,0,0,0,0,0,0,0,0,0,0
188782,2023,Netherlands,China,0,1,1,2,20/06/2023,0,0,0,0,0,0,0,0,1,0,0,1,0,0,0,0,0,0,0,0
188782,2023,Argentina,Netherlands,0,0,0,0,11/6/2023,0,0,0,0,0,0,0,0,0,0,0,0,0,0,0,0,0,0,0,0
188782,2023,Netherlands,Germany,0,0,0,0,9/6/2023,0,0,0,0,0,0,0,0,0,0,0,0,0,0,0,0,0,0,0,0
188782,2023,Netherlands,Cuba,0,0,0,0,8/6/2023,0,0,0,0,0,0,0,0,0,0,0,0,0,0,0,0,0,0,0,0
188782,2023,USA,Netherlands,0,0,0,0,7/6/2023,0,0,0,0,0,0,0,0,0,0,0,0,0,0,0,0,0,0,0,0
141546,2023,Slovenia,Netherlands,0,1,9,10,9/7/2023,17,0,58,75,1,0,0,1,0,2,4,6,0,0,1,1,1,1,0,2
141546,2023,Japan,Netherlands,0,1,10,11,7/7/2023,20,0,62,82,0,0,0,0,0,2,2,4,0,0,1,1,1,2,1,4
141546,2023,Brazil,Netherlands,0,0,3,3,6/7/2023,15,0,34,49,1,0,2,3,0,1,1,2,0,0,0,0,0,1,0,1
141546,2023,Canada,Netherlands,1,0,11,12,5/7/2023,18,0,61,79,1,0,0,1,0,3,1,4,0,0,0,0,4,2,2,8
141546,2023,Netherlands,Serbia,0,0,16,16,25/06/2023,30,2,73,105,2,0,0,2,2,4,1,7,0,0,0,0,4,1,0,5
141546,2023,Netherlands,Iran,0,0,7,7,24/06/2023,21,0,55,76,1,0,0,1,1,0,0,1,0,1,0,1,4,1,1,6
141546,2023,Netherlands,Poland,0,3,11,14,22/06/2023,15,3,62,80,1,0,0,1,0,2,1,3,0,0,0,0,3,0,0,3
141546,2023,Netherlands,China,0,0,15,15,20/06/2023,13,0,47,60,1,0,0,1,1,1,1,3,0,1,0,1,4,3,2,9
141546,2023,Argentina,Netherlands,2,0,15,17,11/6/2023,22,0,82,104,2,0,0,2,2,5,3,10,0,0,1,1,3,5,1,9
141546,2023,Netherlands,Germany,0,1,8,9,9/6/2023,9,1,51,61,1,0,0,1,2,5,5,12,0,0,0,0,6,2,1,9
141546,2023,Netherlands,Cuba,0,0,10,10,8/6/2023,17,0,44,61,1,0,0,1,0,0,3,3,0,0,0,0,5,1,2,8
141546,2023,USA,Netherlands,0,1,7,8,7/6/2023,8,0,33,41,0,0,1,1,0,1,0,1,0,0,0,0,0,1,0,1
139929,2023,Slovenia,Netherlands,1,2,4,7,9/7/2023,0,0,1,1,2,5,6,13,1,1,1,3,6,2,9,17,1,0,2,3
139929,2023,Japan,Netherlands,0,2,6,8,7/7/2023,0,1,3,4,7,5,9,21,1,0,0,1,5,1,6,12,4,4,0,8
139929,2023,Brazil,Netherlands,0,0,0,0,6/7/2023,0,0,0,0,0,0,0,0,0,0,0,0,0,0,0,0,0,0,0,0
139929,2023,Canada,Netherlands,0,3,11,14,5/7/2023,0,0,3,3,11,1,12,24,0,3,1,4,4,2,23,29,3,0,1,4
139929,2023,Netherlands,Serbia,3,3,14,20,25/06/2023,0,0,7,7,16,5,11,32,0,3,0,3,6,4,31,41,5,0,0,5
139929,2023,Netherlands,Iran,0,3,7,10,24/06/2023,0,0,1,1,6,2,7,15,1,0,0,1,1,2,14,17,3,1,0,4
139929,2023,Netherlands,Poland,0,5,5,10,22/06/2023,0,0,4,4,9,2,2,13,1,5,0,6,5,1,5,11,2,2,1,5
139929,2023,Netherlands,China,2,2,7,11,20/06/2023,0,0,4,4,10,4,11,25,2,1,4,7,2,1,12,15,5,0,0,5
139929,2023,Argentina,Netherlands,1,2,16,19,11/6/2023,0,0,0,0,12,5,12,29,1,3,1,5,7,5,23,35,6,5,1,12
139929,2023,Netherlands,Germany,2,2,8,12,9/6/2023,0,0,2,2,15,2,9,26,4,2,1,7,0,0,11,11,1,0,0,1
139929,2023,Netherlands,Cuba,0,1,11,12,8/6/2023,0,0,4,4,11,1,6,18,4,0,0,4,1,1,4,6,6,2,2,10
139929,2023,USA,Netherlands,1,1,6,8,7/6/2023,0,0,1,1,4,5,5,14,0,0,2,2,2,2,13,17,7,4,0,11
137345,2023,Slovenia,Netherlands,0,1,1,2,9/7/2023,0,0,1,1,3,1,3,7,1,1,1,3,1,0,4,5,0,3,0,3
137345,2023,Japan,Netherlands,0,0,0,0,7/7/2023,0,0,0,0,0,0,0,0,0,0,0,0,0,0,0,0,0,0,0,0
137345,2023,Brazil,Netherlands,0,3,1,4,6/7/2023,0,0,2,2,3,3,5,11,0,1,1,2,3,1,18,22,1,0,0,1
137345,2023,Canada,Netherlands,0,0,0,0,5/7/2023,0,0,0,0,0,0,0,0,0,0,0,0,0,0,0,0,0,0,0,0
137345,2023,Netherlands,Serbia,0,0,0,0,25/06/2023,0,0,0,0,0,0,0,0,0,0,0,0,0,0,0,0,0,0,0,0
137345,2023,Netherlands,Iran,0,0,0,0,24/06/2023,0,0,0,0,0,0,0,0,0,0,0,0,0,0,0,0,0,0,0,0
137345,2023,Netherlands,Poland,1,1,2,4,22/06/2023,0,0,1,1,5,3,3,11,0,1,2,3,2,1,11,14,0,0,0,0
137345,2023,Netherlands,China,0,0,0,0,20/06/2023,0,0,0,0,0,0,0,0,0,0,0,0,0,0,0,0,0,0,0,0
169921,2023,Slovenia,Netherlands,0,0,0,0,9/7/2023,0,0,0,0,0,0,0,0,0,0,0,0,0,0,0,0,0,0,0,0
169921,2023,Japan,Netherlands,0,0,0,0,7/7/2023,0,0,0,0,0,0,0,0,0,0,0,0,0,0,0,0,0,0,0,0
169921,2023,Argentina,Netherlands,0,0,0,0,11/6/2023,0,0,0,0,0,0,0,0,0,0,0,0,0,0,0,0,0,0,0,0
169921,2023,Netherlands,Germany,0,0,0,0,9/6/2023,0,0,0,0,0,0,0,0,0,0,0,0,0,0,0,0,0,0,0,0
169921,2023,Netherlands,Cuba,0,0,0,0,8/6/2023,0,0,0,0,0,0,0,0,0,0,0,0,0,0,0,0,0,0,0,0
169921,2023,USA,Netherlands,0,0,0,0,7/6/2023,0,0,0,0,0,0,0,0,0,0,0,0,0,0,0,0,0,0,0,0
188784,2023,Slovenia,Netherlands,0,0,1,1,9/7/2023,1,0,0,1,0,0,0,0,0,0,0,0,0,0,0,0,0,0,0,0
188784,2023,Japan,Netherlands,0,0,0,0,7/7/2023,0,0,7,7,0,1,0,1,1,0,1,2,0,0,0,0,0,0,0,0
188784,2023,Brazil,Netherlands,0,1,3,4,6/7/2023,6,2,19,27,0,0,1,1,1,0,1,2,0,0,0,0,1,1,0,2
188784,2023,Canada,Netherlands,1,1,1,3,5/7/2023,3,0,12,15,0,0,1,1,0,1,2,3,0,0,0,0,0,0,1,1
188784,2023,Netherlands,Serbia,0,0,0,0,25/06/2023,2,0,1,3,0,0,0,0,0,0,0,0,0,0,0,0,0,0,0,0
188784,2023,Netherlands,Iran,0,1,4,5,24/06/2023,2,0,21,23,0,0,0,0,1,0,0,1,0,0,0,0,0,0,0,0
188784,2023,Netherlands,Poland,0,0,0,0,22/06/2023,2,0,3,5,0,0,0,0,0,0,0,0,0,0,0,0,0,0,0,0
188784,2023,Netherlands,China,0,0,0,0,20/06/2023,0,0,0,0,0,0,0,0,0,0,0,0,0,0,0,0,0,0,0,0
188784,2023,Argentina,Netherlands,0,1,1,2,11/6/2023,2,0,3,5,0,0,0,0,0,0,1,1,0,0,0,0,0,0,0,0
188784,2023,Netherlands,Germany,0,0,0,0,9/6/2023,0,0,0,0,0,0,0,0,0,0,0,0,0,0,0,0,0,0,0,0
188784,2023,Netherlands,Cuba,0,0,0,0,8/6/2023,0,0,0,0,0,0,0,0,0,0,0,0,0,0,0,0,0,0,0,0
188784,2023,USA,Netherlands,0,2,0,2,7/6/2023,9,0,22,31,0,0,0,0,0,1,0,1,0,0,0,0,3,0,0,3
131980,2023,Slovenia,Netherlands,0,0,2,2,9/7/2023,0,0,0,0,1,1,2,4,0,0,0,0,4,0,4,8,0,1,1,2
131980,2023,Japan,Netherlands,0,2,13,15,7/7/2023,0,0,4,4,7,6,9,22,3,3,1,7,10,1,27,38,3,8,1,12
131980,2023,Brazil,Netherlands,1,1,5,7,6/7/2023,0,0,2,2,1,2,6,9,1,0,3,4,0,0,4,4,1,1,0,2
131980,2023,Canada,Netherlands,0,2,17,19,5/7/2023,0,0,4,4,10,3,10,23,2,3,1,6,6,3,16,25,7,0,0,7
131980,2023,Netherlands,Serbia,0,0,0,0,25/06/2023,0,0,0,0,0,1,0,1,0,1,0,1,1,0,1,2,0,0,0,0
131980,2023,Netherlands,Iran,0,1,9,10,24/06/2023,0,1,2,3,4,1,3,8,0,1,0,1,5,0,13,18,1,3,1,5
131980,2023,Netherlands,Poland,0,1,14,15,22/06/2023,0,0,5,5,6,1,6,13,0,5,1,6,7,3,24,34,4,5,0,9
131980,2023,Netherlands,China,0,1,8,9,20/06/2023,0,0,1,1,2,2,5,9,1,4,5,10,2,2,10,14,3,0,1,4
131980,2023,Argentina,Netherlands,0,1,3,4,11/6/2023,0,0,2,2,0,0,3,3,0,0,0,0,3,0,6,9,1,0,0,1
131980,2023,Netherlands,Germany,0,0,10,10,9/6/2023,0,0,3,3,1,2,3,6,0,2,1,3,3,0,13,16,2,2,1,5
131980,2023,Netherlands,Cuba,0,1,7,8,8/6/2023,0,1,4,5,0,3,1,4,0,6,1,7,4,1,10,15,3,0,1,4
131980,2023,USA,Netherlands,0,0,6,6,7/6/2023,0,0,0,0,2,1,2,5,0,1,0,1,3,3,15,21,2,0,0,2
156678,2023,Slovenia,Netherlands,0,4,8,12,9/7/2023,0,0,0,0,6,0,3,9,2,3,2,7,0,0,0,0,1,0,1,2
156678,2023,Japan,Netherlands,1,5,7,13,7/7/2023,0,0,0,0,5,2,3,10,2,7,4,13,0,0,0,0,1,2,1,4
156678,2023,Brazil,Netherlands,0,4,5,9,6/7/2023,0,0,2,2,4,1,1,6,1,2,4,7,0,1,2,3,3,0,2,5
156678,2023,Canada,Netherlands,0,3,6,9,5/7/2023,0,0,0,0,6,2,2,10,2,4,1,7,0,0,0,0,1,0,0,1
156678,2023,Netherlands,Serbia,0,5,9,14,25/06/2023,0,0,1,1,2,3,3,8,5,10,6,21,0,1,0,1,4,0,0,4
156678,2023,Netherlands,Iran,0,4,10,14,24/06/2023,0,1,1,2,2,2,8,12,5,9,3,17,0,0,0,0,1,0,0,1
156678,2023,Netherlands,Poland,3,6,5,14,22/06/2023,0,0,0,0,9,0,1,10,4,7,4,15,0,0,0,0,2,0,0,2
156678,2023,Netherlands,China,0,0,0,0,20/06/2023,0,0,0,0,0,0,0,0,0,0,0,0,0,0,0,0,0,0,0,0
156678,2023,Argentina,Netherlands,1,2,10,13,11/6/2023,0,1,2,3,9,1,5,15,2,5,4,11,0,0,0,0,4,2,0,6
156678,2023,Netherlands,Germany,2,4,11,17,9/6/2023,0,0,1,1,4,2,2,8,1,3,2,6,0,0,1,1,0,3,0,3
156678,2023,Netherlands,Cuba,0,5,8,13,8/6/2023,0,0,0,0,5,0,5,10,1,4,3,8,0,0,1,1,3,0,0,3
156678,2023,USA,Netherlands,0,3,6,9,7/6/2023,0,0,2,2,5,0,6,11,0,1,4,5,0,0,0,0,3,0,0,3
170436,2023,Slovenia,Netherlands,0,3,6,9,9/7/2023,0,0,0,0,5,4,7,16,0,3,0,3,3,2,18,23,3,1,0,4
170436,2023,Japan,Netherlands,0,2,3,5,7/7/2023,0,0,1,1,2,1,3,6,0,1,0,1,4,0,5,9,3,3,0,6
170436,2023,Brazil,Netherlands,0,1,7,8,6/7/2023,0,0,6,6,6,4,9,19,1,1,0,2,7,0,11,18,8,2,0,10
170436,2023,Canada,Netherlands,0,0,1,1,5/7/2023,0,0,0,0,3,0,0,3,0,1,0,1,2,0,4,6,0,0,1,1
170436,2023,Netherlands,Serbia,4,3,15,22,25/06/2023,0,0,2,2,12,6,12,30,1,1,1,3,8,1,19,28,1,1,0,2
170436,2023,Netherlands,Iran,3,2,11,16,24/06/2023,0,0,1,1,16,8,7,31,1,3,2,6,5,1,20,26,2,1,3,6
170436,2023,Netherlands,Poland,0,2,1,3,22/06/2023,0,0,0,0,0,0,0,0,0,0,0,0,0,0,1,1,0,0,0,0
170436,2023,Netherlands,China,0,0,1,1,20/06/2023,0,0,0,0,0,0,0,0,0,1,0,1,0,0,1,1,0,0,0,0
170436,2023,Argentina,Netherlands,2,5,10,17,11/6/2023,0,0,4,4,18,6,6,30,0,0,2,2,10,3,21,34,5,5,2,12
170436,2023,Netherlands,Germany,1,2,2,5,9/6/2023,0,0,2,2,3,2,2,7,0,0,0,0,4,0,6,10,2,1,1,4
170436,2023,Netherlands,Cuba,1,2,5,8,8/6/2023,0,0,0,0,2,0,3,5,0,0,0,0,2,0,2,4,0,1,0,1
170436,2023,USA,Netherlands,0,0,4,4,7/6/2023,0,0,1,1,2,3,9,14,0,0,0,0,2,1,5,8,1,0,0,1
137498,2023,Slovenia,Netherlands,2,6,11,19,9/7/2023,0,0,3,3,18,7,6,31,2,2,2,6,0,0,0,0,3,2,0,5
137498,2023,Japan,Netherlands,0,2,6,8,7/7/2023,0,0,0,0,3,0,0,3,0,0,0,0,0,0,0,0,1,0,0,1
137498,2023,Brazil,Netherlands,0,3,2,5,6/7/2023,0,0,2,2,7,5,9,21,1,1,0,2,0,0,0,0,3,3,0,6
137498,2023,Canada,Netherlands,2,7,3,12,5/7/2023,0,0,3,3,22,5,11,38,0,4,0,4,0,0,0,0,4,3,2,9
137498,2023,Netherlands,Serbia,7,1,9,17,25/06/2023,0,0,1,1,7,4,10,21,0,1,0,1,0,0,0,0,3,0,0,3
137498,2023,Netherlands,Iran,6,3,9,18,24/06/2023,0,0,1,1,20,7,10,37,1,1,3,5,0,1,0,1,5,1,0,6
137498,2023,Netherlands,Poland,2,7,14,23,22/06/2023,0,0,1,1,21,5,11,37,0,1,1,2,1,0,0,1,2,2,0,4
137498,2023,Netherlands,China,0,3,7,10,20/06/2023,0,0,3,3,17,4,8,29,2,1,1,4,0,0,0,0,3,0,0,3
137498,2023,Argentina,Netherlands,1,5,14,20,11/6/2023,0,0,3,3,16,11,14,41,0,1,3,4,1,0,0,1,5,6,3,14
137498,2023,Netherlands,Germany,3,6,9,18,9/6/2023,0,0,3,3,10,8,7,25,1,1,3,5,1,0,0,1,4,0,1,5
137498,2023,Netherlands,Cuba,0,7,7,14,8/6/2023,0,0,3,3,22,4,13,39,0,5,3,8,0,0,1,1,1,2,0,3
137498,2023,USA,Netherlands,2,3,10,15,7/6/2023,0,0,1,1,21,6,6,33,1,2,1,4,0,0,0,0,4,1,0,5
154521,2023,Slovenia,Netherlands,0,1,1,2,9/7/2023,0,0,0,0,0,0,0,0,0,0,0,0,1,0,0,1,0,0,0,0
154521,2023,Japan,Netherlands,1,5,7,13,7/7/2023,0,0,1,1,18,6,13,37,2,1,3,6,1,0,2,3,4,4,0,8
154521,2023,Brazil,Netherlands,0,2,1,3,6/7/2023,0,0,0,0,9,3,3,15,1,1,1,3,0,0,1,1,0,1,0,1
154521,2023,Canada,Netherlands,0,1,0,1,5/7/2023,0,0,1,1,2,0,1,3,0,0,0,0,0,0,0,0,0,0,0,0
154521,2023,Netherlands,Serbia,0,2,7,9,25/06/2023,0,0,1,1,13,5,3,21,0,2,1,3,0,0,0,0,4,3,2,9
154521,2023,Netherlands,Iran,1,2,5,8,24/06/2023,0,0,1,1,2,2,1,5,1,0,0,1,0,0,0,0,2,0,0,2
154521,2023,Netherlands,Poland,0,0,1,1,22/06/2023,0,0,0,0,2,1,0,3,0,1,0,1,0,0,0,0,0,0,0,0
154521,2023,Netherlands,China,0,0,0,0,20/06/2023,0,0,0,0,0,0,0,0,0,0,0,0,0,0,0,0,0,0,0,0
121992,2023,Slovenia,Netherlands,0,0,0,0,9/7/2023,0,0,4,4,0,0,0,0,0,0,0,0,2,0,9,11,3,3,3,9
121992,2023,Japan,Netherlands,0,0,0,0,7/7/2023,0,0,3,3,0,0,0,0,0,0,0,0,2,2,13,17,0,5,1,6
121992,2023,Brazil,Netherlands,0,0,0,0,6/7/2023,0,0,2,2,0,0,0,0,0,0,0,0,3,1,10,14,7,3,2,12
121992,2023,Canada,Netherlands,0,0,0,0,5/7/2023,0,0,3,3,0,0,0,0,0,0,0,0,1,0,16,17,8,2,0,10
121992,2023,Netherlands,Serbia,0,0,0,0,25/06/2023,0,0,2,2,0,0,0,0,0,0,0,0,8,0,15,23,7,5,2,14
121992,2023,Netherlands,Iran,0,0,0,0,24/06/2023,0,0,4,4,0,0,0,0,0,0,0,0,5,2,15,22,8,2,1,11
121992,2023,Netherlands,Poland,0,0,0,0,22/06/2023,0,0,2,2,0,0,0,0,0,0,0,0,2,0,17,19,6,1,0,7
121992,2023,Netherlands,China,0,0,0,0,20/06/2023,0,0,4,4,0,0,0,0,0,0,0,0,4,2,16,22,9,1,1,11
121992,2023,Argentina,Netherlands,0,0,0,0,11/6/2023,0,0,7,7,0,0,0,0,0,0,0,0,9,0,11,20,12,6,0,18
121992,2023,Netherlands,Germany,0,0,0,0,9/6/2023,0,0,3,3,0,0,0,0,0,0,0,0,0,0,16,16,8,4,0,12
121992,2023,Netherlands,Cuba,0,0,0,0,8/6/2023,0,0,4,4,0,0,0,0,0,0,0,0,5,1,18,24,8,2,0,10
121992,2023,USA,Netherlands,0,0,0,0,7/6/2023,0,0,4,4,0,0,0,0,0,0,0,0,4,0,8,12,7,1,3,11
150703,2023,Slovenia,Netherlands,0,2,8,10,9/7/2023,0,0,0,0,5,0,0,5,2,2,2,6,0,0,1,1,1,0,2,3
150703,2023,Japan,Netherlands,0,2,11,13,7/7/2023,0,0,0,0,5,0,1,6,1,1,4,6,0,0,0,0,3,0,0,3
150703,2023,Brazil,Netherlands,0,1,13,14,6/7/2023,0,0,0,0,2,2,1,5,0,2,2,4,0,0,2,2,3,0,0,3
150703,2023,Canada,Netherlands,2,2,14,18,5/7/2023,0,0,3,3,5,1,2,8,2,1,2,5,0,0,0,0,2,1,1,4
150703,2023,Netherlands,Serbia,0,1,8,9,25/06/2023,0,0,1,1,4,0,0,4,1,5,4,10,0,0,1,1,1,0,1,2
150703,2023,Netherlands,Iran,0,0,2,2,24/06/2023,0,0,0,0,1,0,0,1,0,0,4,4,0,0,0,0,0,0,0,0
150703,2023,Netherlands,Poland,1,2,13,16,22/06/2023,0,0,0,0,2,1,3,6,2,2,1,5,0,0,0,0,1,3,0,4
150703,2023,Netherlands,China,0,2,10,12,20/06/2023,0,1,0,1,2,1,2,5,2,1,2,5,0,0,0,0,0,0,0,0
150703,2023,Argentina,Netherlands,0,5,12,17,11/6/2023,0,0,1,1,3,0,5,8,4,8,5,17,0,0,0,0,0,1,1,2
150703,2023,Netherlands,Germany,0,0,11,11,9/6/2023,0,0,0,0,2,0,0,2,4,3,3,10,0,0,0,0,0,3,0,3
150703,2023,Netherlands,Cuba,0,2,10,12,8/6/2023,0,0,1,1,1,0,3,4,1,4,4,9,0,0,1,1,1,2,1,4
150703,2023,USA,Netherlands,0,2,10,12,7/6/2023,0,0,0,0,2,0,3,5,1,1,2,4,0,0,1,1,4,1,2,7
188785,2023,Slovenia,Netherlands,0,0,0,0,9/7/2023,0,0,0,0,0,0,0,0,0,0,0,0,0,0,0,0,0,0,0,0
188785,2023,Japan,Netherlands,0,0,0,0,7/7/2023,0,0,0,0,0,0,0,0,0,0,0,0,0,0,0,0,0,0,0,0
188785,2023,Brazil,Netherlands,0,0,0,0,6/7/2023,0,0,0,0,0,0,0,0,0,0,0,0,0,0,0,0,0,0,0,0
188785,2023,Canada,Netherlands,0,0,0,0,5/7/2023,0,0,0,0,0,0,0,0,0,0,0,0,0,0,0,0,0,0,0,0
188785,2023,Netherlands,Serbia,0,0,0,0,25/06/2023,0,0,0,0,0,0,0,0,0,0,0,0,0,0,0,0,0,0,0,0
188785,2023,Netherlands,Iran,0,0,0,0,24/06/2023,0,0,0,0,0,0,0,0,0,0,0,0,0,0,0,0,0,0,0,0
188785,2023,Netherlands,Poland,0,0,0,0,22/06/2023,0,0,0,0,0,0,0,0,0,0,0,0,0,0,0,0,0,0,0,0
188785,2023,Netherlands,China,0,0,0,0,20/06/2023,0,0,0,0,0,0,0,0,0,0,0,0,0,0,0,0,0,0,0,0
188785,2023,Argentina,Netherlands,0,0,0,0,11/6/2023,0,0,0,0,0,0,0,0,0,0,0,0,0,0,0,0,0,0,0,0
188785,2023,Netherlands,Germany,0,0,0,0,9/6/2023,0,0,0,0,0,0,0,0,0,0,0,0,0,0,0,0,0,0,0,0
188785,2023,Netherlands,Cuba,0,0,0,0,8/6/2023,0,0,0,0,0,0,0,0,0,0,0,0,0,0,0,0,0,0,0,0
188785,2023,USA,Netherlands,0,0,0,0,7/6/2023,0,0,0,0,0,0,0,0,0,0,0,0,0,0,0,0,0,0,0,0
153388,2023,Poland,USA,0,0,0,0,23/07/2023,0,0,0,0,0,0,0,0,0,0,0,0,0,0,0,0,0,0,0,0
153388,2023,Japan,Poland,0,0,0,0,22/07/2023,0,0,0,0,0,0,0,0,0,0,0,0,0,0,0,0,0,0,0,0
153388,2023,Poland,Brazil,0,0,0,0,20/07/2023,0,0,0,0,0,0,0,0,0,0,0,0,0,0,0,0,0,0,0,0
153388,2023,Japan,Poland,0,0,0,0,9/7/2023,0,0,0,0,0,0,0,0,0,0,0,0,0,0,0,0,0,0,0,0
153388,2023,Poland,Canada,0,0,0,0,8/7/2023,0,0,1,1,0,0,0,0,0,0,0,0,6,2,18,26,4,4,0,8
153388,2023,Poland,Brazil,0,0,0,0,7/7/2023,0,0,4,4,0,0,0,0,0,0,0,0,2,0,10,12,1,1,0,2
153388,2023,Poland,Slovenia,0,0,0,0,5/7/2023,0,0,1,1,0,0,0,0,0,0,0,0,4,1,11,16,5,5,0,10
162105,2023,Poland,USA,1,3,13,17,23/07/2023,0,0,0,0,23,4,8,35,1,3,3,7,0,0,1,1,3,4,1,8
162105,2023,Japan,Poland,0,4,13,17,22/07/2023,0,0,4,4,15,3,9,27,4,5,4,13,0,0,3,3,5,3,0,8
162105,2023,Poland,Brazil,0,2,2,4,20/07/2023,0,0,2,2,2,0,4,6,1,2,2,5,0,0,0,0,0,2,0,2
162105,2023,Japan,Poland,1,1,12,14,9/7/2023,0,0,4,4,11,0,6,17,0,4,1,5,0,0,0,0,5,3,1,9
162105,2023,Poland,Canada,0,2,9,11,8/7/2023,0,0,3,3,9,0,7,16,1,3,4,8,1,0,0,1,2,1,1,4
162105,2023,Poland,Brazil,0,0,6,6,7/7/2023,0,1,0,1,7,1,2,10,1,0,1,2,0,0,0,0,1,1,0,2
162105,2023,Poland,Slovenia,0,1,5,6,5/7/2023,0,0,1,1,7,3,11,21,2,2,4,8,1,0,0,1,4,5,1,10
115806,2023,Poland,USA,0,0,0,0,23/07/2023,0,0,0,0,0,0,0,0,0,0,0,0,0,0,0,0,0,0,0,0
115806,2023,Japan,Poland,0,0,0,0,22/07/2023,0,0,0,0,0,0,0,0,0,0,0,0,0,0,0,0,0,0,0,0
115806,2023,Poland,Brazil,0,3,5,8,20/07/2023,0,0,0,0,6,5,4,15,1,3,0,4,0,0,0,0,3,1,0,4
115806,2023,Japan,Poland,0,0,0,0,9/7/2023,0,0,0,0,0,0,0,0,0,0,0,0,0,0,0,0,0,0,0,0
115806,2023,Poland,Canada,0,0,0,0,8/7/2023,0,0,0,0,0,0,0,0,0,0,0,0,0,0,0,0,0,0,0,0
115806,2023,Poland,Brazil,0,5,2,7,7/7/2023,0,0,1,1,10,2,8,20,0,3,0,3,1,1,0,2,3,0,1,4
115806,2023,Poland,Slovenia,2,4,11,17,5/7/2023,0,0,3,3,8,6,8,22,0,1,7,8,1,0,0,1,3,0,0,3
115806,2023,Italy,Poland,0,3,8,11,25/06/2023,0,0,0,0,20,6,10,36,0,0,5,5,1,0,0,1,8,4,0,12
115806,2023,Poland,USA,0,3,7,10,24/06/2023,0,0,3,3,10,4,11,25,1,3,0,4,0,1,0,1,3,2,0,5
115806,2023,Netherlands,Poland,0,2,6,8,22/06/2023,0,0,0,0,6,1,5,12,0,1,1,2,0,0,0,0,3,0,0,3
115806,2023,Germany,Poland,0,5,8,13,21/06/2023,0,0,1,1,16,6,8,30,2,8,0,10,0,0,0,0,2,0,0,2
119646,2023,Poland,USA,2,1,5,8,23/07/2023,0,0,0,0,3,2,7,12,2,2,3,7,1,1,15,17,1,0,1,2
119646,2023,Japan,Poland,0,4,7,11,22/07/2023,0,0,5,5,21,2,6,29,2,2,5,9,4,3,7,14,1,1,2,4
119646,2023,Poland,Brazil,2,3,14,19,20/07/2023,0,0,3,3,6,4,11,21,3,3,0,6,2,1,19,22,5,1,1,7
119646,2023,Japan,Poland,3,5,4,12,9/7/2023,0,1,2,3,10,0,9,19,3,3,0,6,1,1,5,7,2,1,0,3
119646,2023,Poland,Canada,2,2,1,5,8/7/2023,0,0,0,0,4,1,3,8,0,0,0,0,0,0,0,0,0,0,0,0
119646,2023,Poland,Brazil,1,7,7,15,7/7/2023,0,0,0,0,20,0,13,33,1,2,1,4,1,3,16,20,4,2,0,6
119646,2023,Poland,Slovenia,0,0,0,0,5/7/2023,0,0,0,0,0,0,0,0,0,0,0,0,0,0,0,0,0,0,0,0
119646,2023,Italy,Poland,2,3,9,14,25/06/2023,0,0,4,4,14,3,11,28,0,3,2,5,5,2,29,36,3,2,1,6
119646,2023,Poland,USA,0,2,2,4,24/06/2023,0,0,2,2,3,2,8,13,0,1,3,4,1,2,12,15,1,1,1,3
119646,2023,Netherlands,Poland,0,3,2,5,22/06/2023,0,0,0,0,13,2,3,18,1,3,0,4,0,0,5,5,0,0,0,0
119646,2023,Germany,Poland,2,3,12,17,21/06/2023,0,0,5,5,15,7,15,37,2,0,3,5,4,1,33,38,4,4,0,8
150742,2023,Poland,USA,0,0,0,0,23/07/2023,0,0,0,0,0,0,0,0,0,0,0,0,0,0,0,0,0,0,0,0
150742,2023,Japan,Poland,0,0,1,1,22/07/2023,0,0,0,0,2,1,4,7,0,0,0,0,0,0,2,2,1,0,0,1
150742,2023,Poland,Brazil,0,0,0,0,20/07/2023,0,0,0,0,1,0,0,1,0,0,0,0,0,0,0,0,0,0,0,0
150742,2023,Japan,Poland,0,0,2,2,9/7/2023,0,0,0,0,0,0,1,1,0,0,0,0,0,0,2,2,1,0,1,2
150742,2023,Poland,Canada,0,1,2,3,8/7/2023,0,0,0,0,0,0,0,0,0,0,0,0,0,0,0,0,0,0,0,0
150742,2023,Poland,Brazil,2,1,16,19,7/7/2023,0,0,1,1,9,4,6,19,0,4,3,7,3,0,18,21,3,2,0,5
150742,2023,Poland,Slovenia,0,4,10,14,5/7/2023,0,0,0,0,13,1,10,24,1,2,2,5,2,0,10,12,2,0,1,3
150742,2023,Italy,Poland,0,0,0,0,25/06/2023,0,0,0,0,0,0,1,1,0,0,0,0,1,0,0,1,0,0,0,0
150742,2023,Poland,USA,0,2,7,9,24/06/2023,0,0,4,4,5,3,4,12,1,2,1,4,6,1,13,20,3,1,0,4
150742,2023,Netherlands,Poland,0,0,0,0,22/06/2023,0,0,0,0,0,0,0,0,0,0,0,0,0,0,0,0,0,0,0,0
150742,2023,Germany,Poland,1,2,12,15,21/06/2023,0,0,5,5,10,4,6,20,3,3,1,7,1,0,13,14,7,1,0,8
142679,2023,Poland,USA,0,3,16,19,23/07/2023,1,0,4,5,13,4,8,25,1,5,0,6,3,0,15,18,6,1,0,7
142679,2023,Japan,Poland,1,2,15,18,22/07/2023,0,0,4,4,12,1,6,19,1,3,1,5,3,4,25,32,6,2,0,8
142679,2023,Poland,Brazil,2,1,7,10,20/07/2023,0,0,5,5,12,2,4,18,2,1,1,4,1,3,12,16,1,2,0,3
142679,2023,Japan,Poland,0,2,12,14,9/7/2023,0,0,5,5,11,2,4,17,0,3,1,4,2,0,17,19,4,1,0,5
142679,2023,Poland,Canada,0,2,11,13,8/7/2023,0,0,5,5,7,0,5,12,1,2,0,3,4,1,8,13,4,5,0,9
142679,2023,Poland,Brazil,0,0,1,1,7/7/2023,0,0,0,0,1,0,1,2,0,0,0,0,0,0,2,2,2,0,0,2
142679,2023,Poland,Slovenia,1,2,17,20,5/7/2023,0,0,5,5,18,3,15,36,1,8,4,13,12,1,28,41,7,5,0,12
115794,2023,Poland,USA,0,0,0,0,23/07/2023,0,0,0,0,0,0,0,0,0,0,0,0,0,0,0,0,0,0,0,0
115794,2023,Japan,Poland,0,0,0,0,22/07/2023,0,0,1,1,0,0,0,0,0,0,0,0,0,0,0,0,0,0,0,0
115794,2023,Poland,Brazil,0,0,0,0,20/07/2023,0,0,0,0,0,0,0,0,0,0,0,0,0,0,0,0,0,0,0,0
115794,2023,Japan,Poland,0,0,1,1,9/7/2023,2,0,6,8,0,0,0,0,0,2,0,2,0,0,0,0,1,1,0,2
115794,2023,Poland,Canada,0,0,10,10,8/7/2023,13,1,43,57,1,0,0,1,1,0,1,2,0,0,0,0,5,3,1,9
115794,2023,Poland,Brazil,0,0,0,0,7/7/2023,0,0,0,0,0,0,0,0,0,0,0,0,0,0,0,0,0,0,0,0
115794,2023,Poland,Slovenia,0,0,0,0,5/7/2023,3,0,8,11,0,0,0,0,0,0,0,0,0,0,1,1,1,0,0,1
115794,2023,Italy,Poland,0,0,12,12,25/06/2023,20,0,54,74,0,0,0,0,1,2,4,7,0,0,1,1,11,4,2,17
115794,2023,Poland,USA,0,1,3,4,24/06/2023,4,0,32,36,0,0,0,0,0,1,0,1,0,0,0,0,2,1,0,3
115794,2023,Netherlands,Poland,0,0,7,7,22/06/2023,10,0,34,44,1,0,0,1,0,0,0,0,0,0,0,0,2,2,0,4
115794,2023,Germany,Poland,1,1,11,13,21/06/2023,23,0,55,78,0,0,0,0,0,1,1,2,0,0,0,0,8,0,2,10
115794,2023,Serbia,Poland,0,0,4,4,11/6/2023,14,0,27,41,0,0,0,0,0,1,1,2,0,0,0,0,2,0,0,2
115794,2023,Poland,Bulgaria,0,0,6,6,9/6/2023,4,0,32,36,0,0,0,0,0,0,1,1,0,0,0,0,1,0,0,1
115794,2023,Poland,Iran,0,0,12,12,8/6/2023,19,1,71,91,0,0,0,0,1,1,3,5,0,0,1,1,4,0,4,8
115794,2023,Poland,France,0,0,0,0,7/6/2023,3,0,3,6,0,0,0,0,0,0,0,0,0,0,2,2,0,1,0,1
152870,2023,Poland,USA,1,2,11,14,23/07/2023,0,0,0,0,4,0,2,6,3,6,3,12,0,0,0,0,4,0,0,4
152870,2023,Japan,Poland,0,3,2,5,22/07/2023,0,0,0,0,1,0,1,2,1,3,0,4,0,0,0,0,0,0,0,0
152870,2023,Poland,Brazil,1,1,5,7,20/07/2023,0,0,1,1,4,0,2,6,2,4,3,9,0,0,0,0,1,2,0,3
152870,2023,Japan,Poland,0,0,7,7,9/7/2023,0,0,1,1,6,0,2,8,3,5,7,15,0,0,0,0,0,0,0,0
152870,2023,Poland,Canada,0,0,0,0,8/7/2023,0,0,0,0,0,0,0,0,0,0,0,0,0,0,0,0,0,0,0,0
152870,2023,Poland,Brazil,0,5,15,20,7/7/2023,0,0,1,1,2,2,0,4,1,7,6,14,1,0,0,1,5,0,0,5
152870,2023,Poland,Slovenia,1,3,10,14,5/7/2023,0,0,1,1,6,0,2,8,2,5,7,14,0,0,1,1,3,1,0,4
152870,2023,Italy,Poland,2,1,10,13,25/06/2023,0,1,4,5,8,0,2,10,4,3,3,10,0,0,1,1,2,0,0,2
152870,2023,Poland,USA,1,1,8,10,24/06/2023,0,0,0,0,3,0,2,5,2,4,6,12,0,0,1,1,6,1,0,7
152870,2023,Netherlands,Poland,5,2,14,21,22/06/2023,0,0,0,0,10,0,1,11,2,4,3,9,0,0,0,0,1,2,0,3
152870,2023,Germany,Poland,2,1,7,10,21/06/2023,0,0,1,1,1,0,3,4,0,0,2,2,0,0,0,0,1,0,0,1
153395,2023,Poland,USA,0,0,1,1,23/07/2023,0,0,0,0,0,0,0,0,0,0,0,0,0,0,0,0,0,0,0,0
153395,2023,Japan,Poland,0,0,0,0,22/07/2023,0,0,0,0,1,0,0,1,0,0,0,0,0,0,3,3,0,1,0,1
153395,2023,Poland,Brazil,0,0,0,0,20/07/2023,0,0,0,0,0,0,0,0,0,0,0,0,0,0,0,0,0,0,0,0
153395,2023,Japan,Poland,0,0,0,0,9/7/2023,0,0,0,0,1,0,1,2,0,0,0,0,1,0,0,1,1,0,0,1
153395,2023,Poland,Canada,0,1,10,11,8/7/2023,0,0,2,2,9,4,12,25,2,1,2,5,6,3,6,15,3,1,1,5
153395,2023,Poland,Brazil,0,0,1,1,7/7/2023,0,0,1,1,0,0,0,0,0,0,0,0,0,0,0,0,0,0,0,0
153395,2023,Poland,Slovenia,1,0,5,6,5/7/2023,0,0,0,0,6,2,8,16,1,0,4,5,0,3,3,6,2,0,1,3
153395,2023,Serbia,Poland,0,1,4,5,11/6/2023,0,0,0,0,6,2,6,14,1,1,2,4,3,1,6,10,3,0,0,3
153395,2023,Poland,Bulgaria,1,2,15,18,9/6/2023,0,0,4,4,4,1,3,8,1,0,0,1,3,1,9,13,5,0,0,5
153395,2023,Poland,Iran,1,3,14,18,8/6/2023,0,1,5,6,15,2,7,24,0,4,1,5,10,2,17,29,11,0,1,12
153395,2023,Poland,France,2,3,15,20,7/6/2023,0,0,2,2,4,4,7,15,3,1,2,6,7,1,10,18,3,0,1,4
118614,2023,Poland,USA,0,0,0,0,23/07/2023,0,0,1,1,0,0,0,0,0,0,0,0,3,1,17,21,8,1,1,10
118614,2023,Japan,Poland,0,0,0,0,22/07/2023,0,0,2,2,0,0,0,0,0,0,0,0,6,1,10,17,9,5,2,16
118614,2023,Poland,Brazil,0,0,0,0,20/07/2023,0,0,11,11,0,0,0,0,0,0,0,0,3,1,11,15,10,2,0,12
118614,2023,Japan,Poland,0,0,0,0,9/7/2023,0,0,2,2,0,0,0,0,0,0,0,0,2,1,12,15,8,2,1,11
118614,2023,Poland,Canada,0,0,0,0,8/7/2023,0,0,0,0,0,0,0,0,0,0,0,0,0,0,0,0,0,0,0,0
118614,2023,Poland,Brazil,0,0,0,0,7/7/2023,0,0,5,5,0,0,0,0,0,0,0,0,0,0,9,9,3,2,0,5
118614,2023,Poland,Slovenia,0,0,0,0,5/7/2023,0,0,5,5,0,0,0,0,0,0,0,0,3,0,9,12,6,4,1,11
118614,2023,Italy,Poland,0,0,0,0,25/06/2023,0,0,9,9,0,0,0,0,0,0,0,0,1,1,11,13,9,1,2,12
118614,2023,Poland,USA,0,0,0,0,24/06/2023,0,0,4,4,0,0,0,0,0,0,0,0,1,0,9,10,5,2,1,8
118614,2023,Netherlands,Poland,0,0,0,0,22/06/2023,0,0,4,4,0,0,0,0,0,0,0,0,9,3,18,30,6,3,0,9
118614,2023,Germany,Poland,0,0,0,0,21/06/2023,0,0,10,10,0,0,0,0,0,0,0,0,4,0,16,20,14,3,0,17
165942,2023,Poland,USA,1,2,8,11,23/07/2023,30,0,65,95,0,0,0,0,0,2,1,3,0,0,0,0,2,3,0,5
165942,2023,Japan,Poland,0,0,14,14,22/07/2023,20,0,57,77,0,0,0,0,0,3,0,3,0,0,1,1,6,4,1,11
165942,2023,Poland,Brazil,0,0,11,11,20/07/2023,15,1,40,56,0,0,0,0,1,0,5,6,0,0,0,0,3,3,2,8
165942,2023,Japan,Poland,1,0,9,10,9/7/2023,12,0,40,52,0,0,0,0,0,3,1,4,0,0,0,0,3,2,0,5
165942,2023,Poland,Canada,0,0,0,0,8/7/2023,2,0,9,11,0,0,0,0,0,0,0,0,0,0,0,0,1,1,0,2
165942,2023,Poland,Brazil,0,2,10,12,7/7/2023,19,0,60,79,0,0,2,2,0,1,3,4,0,0,0,0,6,1,1,8
165942,2023,Poland,Slovenia,0,1,12,13,5/7/2023,27,0,87,114,0,0,0,0,0,2,2,4,0,0,0,0,7,5,1,13
150734,2023,Poland,USA,1,2,7,10,23/07/2023,0,0,0,0,4,0,1,5,0,3,2,5,0,0,1,1,2,1,0,3
150734,2023,Japan,Poland,3,2,16,21,22/07/2023,0,0,2,2,4,2,3,9,1,5,5,11,0,0,1,1,1,3,2,6
150734,2023,Poland,Brazil,4,2,10,16,20/07/2023,0,0,1,1,6,0,4,10,0,1,7,8,0,0,0,0,2,1,2,5
150734,2023,Japan,Poland,0,0,0,0,9/7/2023,0,0,0,0,0,0,0,0,0,0,0,0,0,0,0,0,0,0,0,0
150734,2023,Poland,Canada,0,0,0,0,8/7/2023,0,0,0,0,0,0,0,0,0,0,0,0,0,0,0,0,0,0,0,0
150734,2023,Poland,Brazil,0,0,0,0,7/7/2023,0,0,0,0,0,0,0,0,0,0,0,0,0,0,0,0,0,0,0,0
150734,2023,Poland,Slovenia,1,6,14,21,5/7/2023,0,0,2,2,8,1,7,16,2,4,5,11,0,0,1,1,5,2,2,9
150734,2023,Serbia,Poland,2,2,10,14,11/6/2023,0,0,0,0,6,2,2,10,0,2,3,5,0,0,0,0,4,0,0,4
150734,2023,Poland,Bulgaria,1,2,12,15,9/6/2023,0,0,2,2,5,6,5,16,2,2,9,13,0,0,0,0,4,0,1,5
150734,2023,Poland,Iran,0,1,15,16,8/6/2023,0,0,0,0,13,1,4,18,2,5,9,16,0,0,0,0,1,0,1,2
150734,2023,Poland,France,0,4,11,15,7/6/2023,0,0,0,0,10,0,3,13,2,2,5,9,1,0,2,3,3,0,0,3
152866,2023,Poland,USA,0,1,5,6,23/07/2023,0,0,4,4,7,2,5,14,1,0,1,2,3,1,11,15,5,1,1,7
152866,2023,Japan,Poland,0,0,0,0,22/07/2023,0,0,0,0,0,0,0,0,0,0,0,0,0,0,0,0,0,0,0,0
152866,2023,Poland,Brazil,0,0,0,0,20/07/2023,0,0,0,0,0,0,0,0,0,0,0,0,0,0,0,0,0,0,0,0
152866,2023,Italy,Poland,0,4,14,18,25/06/2023,0,0,4,4,11,2,12,25,1,2,6,9,6,1,12,19,7,2,2,11
152866,2023,Poland,USA,0,0,4,4,24/06/2023,0,0,1,1,4,2,5,11,0,2,1,3,3,3,4,10,2,2,1,5
152866,2023,Netherlands,Poland,0,6,12,18,22/06/2023,0,0,1,1,8,3,5,16,0,3,0,3,6,2,21,29,7,5,1,13
152866,2023,Germany,Poland,0,1,1,2,21/06/2023,0,0,2,2,0,0,2,2,0,1,0,1,0,0,3,3,1,0,0,1
152869,2023,Poland,USA,1,0,11,12,23/07/2023,0,1,0,1,5,1,3,9,1,4,2,7,0,0,0,0,1,1,0,2
152869,2023,Japan,Poland,0,1,8,9,22/07/2023,0,0,0,0,5,0,0,5,0,2,2,4,0,0,1,1,1,1,0,2
152869,2023,Poland,Brazil,0,0,0,0,20/07/2023,0,0,0,0,0,0,0,0,0,0,0,0,0,0,0,0,0,0,0,0
152869,2023,Japan,Poland,3,3,8,14,9/7/2023,0,0,0,0,5,0,2,7,1,2,4,7,0,0,1,1,2,3,0,5
152869,2023,Poland,Canada,1,3,10,14,8/7/2023,0,0,0,0,6,1,2,9,4,2,3,9,0,0,0,0,2,1,0,3
152869,2023,Poland,Brazil,0,2,5,7,7/7/2023,0,0,1,1,3,0,0,3,2,2,1,5,0,0,1,1,0,1,0,1
152869,2023,Poland,Slovenia,0,1,2,3,5/7/2023,0,0,0,0,0,0,2,2,0,3,0,3,0,0,2,2,0,0,0,0
152869,2023,Italy,Poland,3,5,17,25,25/06/2023,0,0,6,6,1,1,4,6,2,7,4,13,0,0,0,0,1,0,2,3
152869,2023,Poland,USA,1,3,11,15,24/06/2023,0,0,1,1,4,4,1,9,2,3,1,6,0,0,0,0,0,1,0,1
152869,2023,Netherlands,Poland,0,1,7,8,22/06/2023,0,0,1,1,4,0,0,4,1,0,1,2,0,0,0,0,0,1,0,1
152869,2023,Germany,Poland,0,2,11,13,21/06/2023,0,0,1,1,6,1,4,11,4,2,7,13,0,0,2,2,2,1,0,3
124926,2023,Bulgaria,Serbia,0,0,0,0,8/7/2023,0,0,0,0,0,0,0,0,0,0,0,0,0,0,0,0,0,0,0,0
124926,2023,Serbia,France,0,0,0,0,7/7/2023,0,0,0,0,0,0,0,0,0,0,0,0,0,0,0,0,0,0,0,0
124926,2023,Serbia,Cuba,0,1,5,6,7/7/2023,0,0,3,3,1,7,3,11,0,0,1,1,2,2,7,11,2,0,0,2
124926,2023,Argentina,Serbia,0,0,0,0,4/7/2023,0,0,0,0,0,0,0,0,0,0,0,0,0,0,0,0,0,0,0,0
136360,2023,Bulgaria,Serbia,0,0,0,0,8/7/2023,0,0,3,3,0,0,0,0,0,0,0,0,2,1,5,8,4,7,2,13
136360,2023,Serbia,France,0,0,0,0,7/7/2023,0,0,8,8,0,0,0,0,0,0,0,0,2,1,13,16,5,4,3,12
136360,2023,Serbia,Cuba,0,0,0,0,7/7/2023,0,0,6,6,0,0,0,0,0,0,0,0,3,2,11,16,5,2,2,9
136360,2023,Argentina,Serbia,0,0,0,0,4/7/2023,0,1,7,8,0,0,0,0,0,0,0,0,3,1,13,17,4,6,0,10
136360,2023,Netherlands,Serbia,0,0,0,0,25/06/2023,0,0,12,12,0,0,0,0,0,0,0,0,5,5,21,31,8,2,0,10
136360,2023,Serbia,Italy,0,0,0,0,23/06/2023,0,0,10,10,0,0,0,0,0,0,0,0,2,1,7,10,4,1,0,5
136360,2023,Serbia,Germany,0,0,0,0,22/06/2023,0,0,6,6,0,0,0,0,0,0,0,0,3,1,15,19,3,6,0,9
136360,2023,USA,Serbia,0,0,0,0,20/06/2023,0,1,8,9,0,0,0,0,0,0,0,0,6,1,10,17,9,7,0,16
136360,2023,Serbia,Poland,0,0,0,0,11/6/2023,0,0,8,8,0,0,0,0,0,0,0,0,3,1,10,14,10,0,1,11
136360,2023,Japan,Serbia,0,0,0,0,9/6/2023,0,1,4,5,0,0,0,0,0,0,0,0,3,0,11,14,8,2,1,11
136360,2023,Serbia,China,0,0,0,0,8/6/2023,0,0,5,5,0,0,0,0,0,0,0,0,3,0,8,11,8,2,2,12
136360,2023,Slovenia,Serbia,0,0,0,0,7/6/2023,0,0,4,4,0,0,0,0,0,0,0,0,3,1,22,26,10,1,0,11
192041,2023,Bulgaria,Serbia,0,0,0,0,8/7/2023,0,0,0,0,0,0,0,0,0,0,0,0,0,0,0,0,0,0,0,0
192041,2023,Serbia,France,0,0,0,0,7/7/2023,0,0,0,0,0,0,0,0,0,0,0,0,0,0,0,0,0,0,0,0
192041,2023,Serbia,Cuba,0,1,1,2,7/7/2023,0,0,0,0,0,0,0,0,0,0,0,0,0,0,0,0,0,0,0,0
192041,2023,Argentina,Serbia,0,0,0,0,4/7/2023,0,0,0,0,0,0,0,0,0,0,0,0,0,0,0,0,0,0,0,0
192041,2023,Serbia,Poland,0,0,0,0,11/6/2023,0,0,0,0,0,0,0,0,0,0,0,0,0,0,0,0,0,0,0,0
192041,2023,Japan,Serbia,0,0,1,1,9/6/2023,0,0,0,0,0,0,1,1,0,0,0,0,0,0,0,0,0,0,0,0
192041,2023,Serbia,China,0,1,0,1,8/6/2023,0,0,0,0,0,0,1,1,1,0,0,1,0,0,0,0,0,0,0,0
192041,2023,Slovenia,Serbia,0,1,2,3,7/6/2023,0,0,1,1,0,0,0,0,0,0,0,0,0,0,1,1,3,0,0,3
146579,2023,Bulgaria,Serbia,0,1,8,9,8/7/2023,0,0,1,1,4,1,1,6,3,3,5,11,0,0,0,0,1,0,0,1
146579,2023,Serbia,France,2,1,16,19,7/7/2023,0,0,0,0,5,3,2,10,4,3,5,12,0,0,1,1,3,1,0,4
146579,2023,Serbia,Cuba,0,0,13,13,7/7/2023,0,0,1,1,4,1,5,10,3,6,2,11,0,0,0,0,1,1,0,2
146579,2023,Argentina,Serbia,0,2,13,15,4/7/2023,0,0,3,3,5,1,5,11,0,3,1,4,0,0,0,0,5,2,1,8
146579,2023,Netherlands,Serbia,1,1,21,23,25/06/2023,0,0,2,2,11,3,4,18,5,6,4,15,0,0,2,2,3,1,0,4
146579,2023,Serbia,Italy,0,0,0,0,23/06/2023,0,0,0,0,0,0,0,0,0,0,0,0,0,0,0,0,0,0,0,0
146579,2023,Serbia,Germany,2,2,17,21,22/06/2023,0,0,2,2,6,2,1,9,5,4,3,12,0,0,1,1,3,1,2,6
146579,2023,USA,Serbia,1,2,12,15,20/06/2023,0,0,3,3,8,0,2,10,2,3,3,8,0,0,0,0,1,2,1,4
146579,2023,Serbia,Poland,0,0,12,12,11/6/2023,0,0,1,1,4,1,2,7,3,5,3,11,0,0,0,0,4,0,0,4
146579,2023,Japan,Serbia,0,4,8,12,9/6/2023,0,0,0,0,6,0,1,7,1,4,1,6,0,0,0,0,2,0,0,2
146579,2023,Serbia,China,1,0,15,16,8/6/2023,0,0,1,1,4,1,1,6,1,2,1,4,0,0,0,0,2,0,0,2
146579,2023,Slovenia,Serbia,0,1,16,17,7/6/2023,0,0,1,1,7,1,2,10,2,2,0,4,0,0,0,0,1,0,0,1
132022,2023,Bulgaria,Serbia,1,1,16,18,8/7/2023,0,0,2,2,7,1,7,15,1,1,1,3,2,1,12,15,1,2,1,4
132022,2023,Serbia,France,0,4,9,13,7/7/2023,1,0,2,3,11,6,11,28,1,5,5,11,8,0,28,36,3,3,0,6
132022,2023,Serbia,Cuba,0,2,6,8,7/7/2023,0,0,1,1,4,3,3,10,1,1,2,4,1,2,15,18,4,1,0,5
132022,2023,Argentina,Serbia,1,4,7,12,4/7/2023,0,0,3,3,9,6,10,25,0,1,1,2,9,4,22,35,6,2,1,9
132022,2023,Netherlands,Serbia,2,2,22,26,25/06/2023,1,0,5,6,10,6,6,22,1,1,0,2,9,5,25,39,7,2,0,9
132022,2023,Serbia,Italy,0,0,0,0,23/06/2023,0,0,0,0,0,0,0,0,0,0,0,0,0,0,0,0,0,0,0,0
132022,2023,Serbia,Germany,0,2,14,16,22/06/2023,0,1,8,9,11,1,15,27,1,4,3,8,7,5,16,28,8,0,3,11
132022,2023,USA,Serbia,1,4,6,11,20/06/2023,0,0,5,5,6,5,12,23,0,0,3,3,2,2,19,23,2,2,0,4
162122,2023,Bulgaria,Serbia,0,0,0,0,8/7/2023,0,0,0,0,0,0,0,0,0,0,0,0,0,0,0,0,0,0,0,0
162122,2023,Serbia,France,0,5,13,18,7/7/2023,0,0,3,3,9,6,10,25,0,3,4,7,5,1,13,19,4,3,2,9
162122,2023,Serbia,Cuba,2,6,14,22,7/7/2023,0,0,1,1,13,6,9,28,1,4,1,6,8,1,24,33,10,2,0,12
162122,2023,Argentina,Serbia,1,3,10,14,4/7/2023,0,0,5,5,14,3,14,31,1,2,1,4,3,0,21,24,6,4,0,10
162122,2023,Netherlands,Serbia,2,3,10,15,25/06/2023,0,0,1,1,20,6,8,34,4,2,5,11,6,4,9,19,5,3,0,8
162122,2023,Serbia,Italy,0,2,7,9,23/06/2023,0,0,6,6,10,6,8,24,0,2,0,2,3,1,13,17,2,2,0,4
162122,2023,Serbia,Germany,1,3,14,18,22/06/2023,0,0,5,5,12,1,2,15,1,3,3,7,1,3,18,22,8,2,0,10
162122,2023,USA,Serbia,1,1,6,8,20/06/2023,1,0,1,2,4,4,5,13,0,0,0,0,1,1,11,13,3,3,0,6
162122,2023,Serbia,Poland,3,3,7,13,11/6/2023,0,0,3,3,12,1,4,17,0,2,0,2,5,0,2,7,1,0,2,3
162122,2023,Japan,Serbia,1,5,14,20,9/6/2023,0,0,2,2,8,0,12,20,1,2,1,4,7,0,19,26,5,0,0,5
162122,2023,Serbia,China,4,1,10,15,8/6/2023,0,0,2,2,10,4,6,20,2,4,1,7,9,0,11,20,6,0,2,8
162122,2023,Slovenia,Serbia,1,2,12,15,7/6/2023,0,0,5,5,12,2,14,28,1,2,1,4,7,0,16,23,15,0,0,15
173249,2023,Bulgaria,Serbia,0,0,0,0,8/7/2023,0,0,2,2,0,0,0,0,0,0,0,0,0,0,0,0,0,0,0,0
173249,2023,Serbia,France,0,0,0,0,7/7/2023,0,0,0,0,0,0,0,0,0,2,0,2,0,0,0,0,1,0,0,1
173249,2023,Serbia,Cuba,0,0,0,0,7/7/2023,2,0,1,3,0,0,0,0,0,0,2,2,0,0,0,0,0,0,0,0
173249,2023,Argentina,Serbia,0,0,1,1,4/7/2023,1,0,14,15,0,0,0,0,0,0,1,1,0,0,0,0,3,0,0,3
173249,2023,Netherlands,Serbia,0,0,0,0,25/06/2023,0,0,1,1,0,0,0,0,0,0,0,0,0,0,0,0,0,0,0,0
173249,2023,Serbia,Italy,0,1,7,8,23/06/2023,14,1,61,76,0,0,0,0,0,2,2,4,0,0,1,1,5,2,0,7
173249,2023,Serbia,Germany,0,0,0,0,22/06/2023,1,0,4,5,0,0,0,0,0,0,0,0,0,0,0,0,0,0,0,0
173249,2023,USA,Serbia,0,0,0,0,20/06/2023,2,0,5,7,0,0,0,0,0,0,0,0,0,0,0,0,0,0,0,0
173249,2023,Serbia,Poland,0,0,0,0,11/6/2023,0,0,0,0,0,0,0,0,0,0,0,0,0,0,0,0,0,0,0,0
173249,2023,Japan,Serbia,0,5,7,12,9/6/2023,15,0,69,84,0,0,1,1,0,3,2,5,0,0,0,0,0,0,0,0
173249,2023,Serbia,China,0,0,0,0,8/6/2023,2,0,5,7,0,0,0,0,0,0,0,0,0,0,0,0,0,0,0,0
173249,2023,Slovenia,Serbia,0,0,3,3,7/6/2023,2,0,14,16,0,0,0,0,1,1,0,2,0,0,0,0,2,0,0,2
173251,2023,Bulgaria,Serbia,2,4,8,14,8/7/2023,0,0,1,1,9,5,8,22,0,1,4,5,8,1,17,26,5,4,1,10
173251,2023,Serbia,France,0,0,0,0,7/7/2023,0,0,0,0,0,0,1,1,0,0,0,0,0,0,1,1,0,0,0,0
173251,2023,Serbia,Cuba,0,0,0,0,7/7/2023,0,0,0,0,0,0,0,0,0,0,0,0,0,0,0,0,0,0,0,0
173251,2023,Argentina,Serbia,0,0,1,1,4/7/2023,0,0,0,0,2,1,1,4,0,0,0,0,0,0,1,1,1,0,0,1
173251,2023,Netherlands,Serbia,0,1,1,2,25/06/2023,0,0,0,0,3,0,4,7,0,0,1,1,1,0,4,5,0,0,1,1
173251,2023,Serbia,Italy,0,2,10,12,23/06/2023,0,0,0,0,14,5,10,29,1,1,1,3,3,3,36,42,5,2,0,7
173251,2023,Serbia,Germany,0,0,0,0,22/06/2023,0,0,0,0,0,0,0,0,0,0,0,0,0,0,0,0,0,0,0,0
173251,2023,USA,Serbia,0,5,5,10,20/06/2023,0,0,0,0,5,6,10,21,1,1,1,3,1,2,21,24,7,1,0,8
173251,2023,Serbia,Poland,1,2,7,10,11/6/2023,0,0,1,1,5,1,8,14,1,0,2,3,3,2,18,23,3,0,0,3
173251,2023,Japan,Serbia,1,4,9,14,9/6/2023,0,0,1,1,17,2,11,30,4,1,1,6,3,4,24,31,4,1,1,6
173251,2023,Serbia,China,0,0,0,0,8/6/2023,0,0,0,0,0,0,0,0,0,0,0,0,0,0,0,0,0,0,0,0
173251,2023,Slovenia,Serbia,0,1,6,7,7/6/2023,0,0,0,0,7,3,9,19,1,0,1,2,3,1,17,21,7,0,0,7
150382,2023,Bulgaria,Serbia,0,0,0,0,8/7/2023,0,0,0,0,0,0,0,0,0,0,0,0,0,0,0,0,0,0,0,0
150382,2023,Serbia,France,0,0,0,0,7/7/2023,0,0,0,0,0,0,0,0,0,0,0,0,0,0,0,0,0,0,0,0
150382,2023,Serbia,Cuba,0,0,0,0,7/7/2023,0,0,0,0,0,0,0,0,0,0,0,0,0,0,0,0,0,0,0,0
150382,2023,Argentina,Serbia,0,0,0,0,4/7/2023,0,0,0,0,0,0,0,0,0,0,0,0,0,0,0,0,0,0,0,0
150382,2023,Netherlands,Serbia,0,0,0,0,25/06/2023,0,0,0,0,0,0,0,0,0,0,0,0,0,0,0,0,0,0,0,0
150382,2023,Serbia,Italy,1,0,9,10,23/06/2023,0,0,0,0,3,1,2,6,0,2,5,7,0,0,2,2,2,1,1,4
150382,2023,Serbia,Germany,0,0,0,0,22/06/2023,0,0,0,0,0,0,0,0,0,0,0,0,0,0,0,0,0,0,0,0
150382,2023,USA,Serbia,0,0,0,0,20/06/2023,0,0,0,0,0,0,0,0,0,0,0,0,0,0,0,0,0,0,0,0
143794,2023,Bulgaria,Serbia,1,2,11,14,8/7/2023,0,0,3,3,13,4,6,23,1,1,2,4,0,0,0,0,5,2,2,9
143794,2023,Serbia,France,0,5,10,15,7/7/2023,0,0,4,4,16,6,10,32,0,1,1,2,0,0,0,0,8,1,0,9
143794,2023,Serbia,Cuba,2,4,14,20,7/7/2023,0,0,4,4,15,7,13,35,1,3,3,7,0,1,0,1,3,4,2,9
143794,2023,Argentina,Serbia,2,3,10,15,4/7/2023,0,0,3,3,8,11,6,25,2,2,4,8,0,0,0,0,4,4,0,8
143794,2023,Netherlands,Serbia,1,7,14,22,25/06/2023,0,0,0,0,18,5,11,34,1,4,2,7,0,0,0,0,4,0,0,4
143794,2023,Serbia,Italy,0,0,0,0,23/06/2023,0,0,0,0,0,0,0,0,0,0,0,0,0,0,0,0,0,0,0,0
143794,2023,Serbia,Germany,1,4,10,15,22/06/2023,0,0,2,2,15,7,17,39,0,1,7,8,0,0,1,1,2,3,1,6
143794,2023,USA,Serbia,3,3,9,15,20/06/2023,0,0,3,3,16,4,17,37,0,4,3,7,0,0,0,0,4,4,1,9
143794,2023,Serbia,Poland,1,3,7,11,11/6/2023,0,0,2,2,18,3,9,30,0,1,1,2,0,0,0,0,6,0,0,6
143794,2023,Japan,Serbia,0,4,10,14,9/6/2023,0,0,1,1,17,4,10,31,0,0,1,1,0,0,0,0,6,0,0,6
143794,2023,Serbia,China,2,2,13,17,8/6/2023,0,0,2,2,16,5,8,29,1,0,2,3,0,0,2,2,3,0,1,4
143794,2023,Slovenia,Serbia,0,4,12,16,7/6/2023,0,0,3,3,20,6,11,37,1,2,4,7,0,0,0,0,6,1,0,7
116525,2023,Bulgaria,Serbia,0,0,0,0,8/7/2023,0,0,0,0,0,0,0,0,0,0,0,0,0,0,0,0,0,0,0,0
116525,2023,Serbia,France,0,0,0,0,7/7/2023,0,0,0,0,0,0,0,0,0,0,0,0,0,0,0,0,0,0,0,0
116525,2023,Serbia,Cuba,0,0,0,0,7/7/2023,0,0,0,0,0,0,0,0,0,0,0,0,0,0,0,0,0,0,0,0
116525,2023,Argentina,Serbia,0,0,0,0,4/7/2023,0,0,0,0,0,0,0,0,0,0,0,0,0,0,0,0,0,0,0,0
173250,2023,Bulgaria,Serbia,0,1,7,8,8/7/2023,20,0,41,61,1,0,0,1,0,4,3,7,0,0,0,0,3,1,0,4
173250,2023,Serbia,France,0,1,13,14,7/7/2023,21,0,66,87,0,0,0,0,2,1,4,7,0,0,0,0,4,1,0,5
173250,2023,Serbia,Cuba,2,3,12,17,7/7/2023,30,1,52,83,2,0,1,3,2,3,3,8,0,0,0,0,3,1,0,4
173250,2023,Argentina,Serbia,0,0,7,7,4/7/2023,14,0,61,75,1,0,0,1,0,2,1,3,0,0,1,1,3,4,0,7
173250,2023,Netherlands,Serbia,0,4,13,17,25/06/2023,33,0,67,100,1,0,1,2,0,3,4,7,0,0,0,0,9,3,1,13
173250,2023,Serbia,Italy,0,0,0,0,23/06/2023,0,0,0,0,0,0,0,0,0,0,0,0,0,0,0,0,0,0,0,0
173250,2023,Serbia,Germany,0,1,11,12,22/06/2023,17,0,57,74,0,0,0,0,1,3,1,5,0,1,1,2,7,8,0,15
173250,2023,USA,Serbia,0,2,13,15,20/06/2023,25,0,64,89,0,0,2,2,0,3,3,6,0,0,1,1,8,7,1,16
173250,2023,Serbia,Poland,1,1,14,16,11/6/2023,7,0,50,57,0,0,2,2,1,0,0,1,0,0,0,0,6,0,0,6
173250,2023,Japan,Serbia,0,0,1,1,9/6/2023,2,0,3,5,0,0,0,0,0,0,0,0,0,0,0,0,1,0,0,1
173250,2023,Serbia,China,0,0,10,10,8/6/2023,18,1,48,67,0,0,0,0,0,3,1,4,0,0,0,0,5,0,1,6
173250,2023,Slovenia,Serbia,0,3,8,11,7/6/2023,10,0,76,86,1,0,0,1,2,1,1,4,0,0,0,0,1,0,0,1
168276,2023,Bulgaria,Serbia,0,0,0,0,8/7/2023,0,0,0,0,0,0,0,0,0,0,0,0,0,0,0,0,0,0,0,0
168276,2023,Serbia,France,0,0,0,0,7/7/2023,0,0,0,0,0,0,0,0,0,0,0,0,0,0,0,0,0,0,0,0
168276,2023,Serbia,Cuba,0,0,0,0,7/7/2023,0,0,0,0,0,0,0,0,0,0,0,0,0,0,0,0,0,0,0,0
168276,2023,Argentina,Serbia,0,1,1,2,4/7/2023,0,0,2,2,3,2,1,6,0,0,0,0,0,0,0,0,2,1,0,3
168276,2023,Netherlands,Serbia,0,0,0,0,25/06/2023,0,0,0,0,0,0,0,0,0,0,0,0,0,0,0,0,0,0,0,0
168276,2023,Serbia,Italy,0,5,3,8,23/06/2023,0,0,0,0,10,8,8,26,2,2,3,7,0,0,0,0,3,4,1,8
168276,2023,Serbia,Germany,0,0,1,1,22/06/2023,0,0,0,0,0,0,0,0,0,0,0,0,0,0,0,0,0,0,0,0
168276,2023,USA,Serbia,0,0,3,3,20/06/2023,0,0,0,0,1,1,2,4,1,0,0,1,0,0,0,0,0,1,0,1
168276,2023,Serbia,Poland,0,0,0,0,11/6/2023,0,0,0,0,0,0,0,0,0,0,0,0,0,0,0,0,0,0,0,0
168276,2023,Japan,Serbia,0,0,1,1,9/6/2023,0,0,0,0,1,0,0,1,0,1,1,2,0,0,0,0,0,0,0,0
168276,2023,Serbia,China,0,1,1,2,8/6/2023,0,0,0,0,0,1,1,2,0,0,0,0,0,0,0,0,2,0,0,2
168276,2023,Slovenia,Serbia,0,0,5,5,7/6/2023,0,0,1,1,3,1,1,5,0,1,0,1,0,0,0,0,1,0,0,1
164985,2023,Bulgaria,Serbia,1,1,9,11,8/7/2023,0,0,0,0,6,0,2,8,0,4,6,10,0,0,0,0,2,0,1,3
164985,2023,Serbia,France,0,2,14,16,7/7/2023,0,0,1,1,7,0,1,8,3,5,3,11,0,0,1,1,2,2,0,4
164985,2023,Serbia,Cuba,1,2,14,17,7/7/2023,0,0,3,3,6,0,1,7,6,4,3,13,0,0,0,0,2,0,0,2
164985,2023,Argentina,Serbia,1,1,10,12,4/7/2023,0,0,1,1,4,3,1,8,2,4,7,13,0,0,0,0,3,0,0,3
164985,2023,Netherlands,Serbia,0,0,12,12,25/06/2023,0,0,1,1,7,1,2,10,1,5,9,15,0,0,1,1,2,0,1,3
164985,2023,Serbia,Italy,0,0,6,6,23/06/2023,0,0,0,0,3,0,2,5,3,2,2,7,0,0,0,0,0,1,1,2
164985,2023,Serbia,Germany,0,1,10,11,22/06/2023,0,0,0,0,7,1,4,12,4,4,7,15,0,0,0,0,2,0,1,3
164985,2023,USA,Serbia,0,3,5,8,20/06/2023,0,0,1,1,5,0,1,6,0,2,4,6,0,0,0,0,3,0,0,3
164985,2023,Serbia,Poland,0,0,11,11,11/6/2023,0,0,2,2,4,0,1,5,4,5,5,14,0,0,0,0,1,0,0,1
164985,2023,Japan,Serbia,0,0,13,13,9/6/2023,0,0,0,0,1,0,5,6,2,3,0,5,1,0,1,2,1,0,0,1
164985,2023,Serbia,China,1,0,11,12,8/6/2023,0,0,0,0,8,0,4,12,3,1,3,7,0,0,1,1,1,0,0,1
164985,2023,Slovenia,Serbia,0,0,16,16,7/6/2023,0,0,0,0,3,1,3,7,1,4,7,12,0,0,2,2,0,0,0,0
114962,2023,Japan,Slovenia,0,2,5,7,20/07/2023,0,0,0,0,11,0,5,16,1,10,8,19,2,0,3,5,3,0,0,3
114962,2023,Slovenia,Netherlands,0,2,9,11,9/7/2023,0,0,2,2,5,1,0,6,4,4,3,11,1,0,0,1,1,0,0,1
114962,2023,Slovenia,Italy,0,2,6,8,7/7/2023,0,0,0,0,1,1,4,6,1,2,3,6,0,0,0,0,3,1,0,4
114962,2023,China,Slovenia,0,3,14,17,6/7/2023,0,0,0,0,5,3,4,12,1,5,4,10,0,0,0,0,3,0,2,5
114962,2023,Poland,Slovenia,0,2,11,13,5/7/2023,0,0,1,1,7,0,3,10,1,3,8,12,0,0,1,1,3,2,2,7
114962,2023,Brazil,Slovenia,0,3,10,13,24/06/2023,0,0,2,2,6,1,0,7,0,2,4,6,0,0,0,0,0,2,0,2
114962,2023,Slovenia,Cuba,1,1,19,21,22/06/2023,0,0,1,1,4,0,4,8,1,2,0,3,0,0,2,2,0,0,0,0
114962,2023,Slovenia,Canada,2,1,5,8,21/06/2023,0,0,1,1,5,0,4,9,2,3,6,11,2,0,0,2,1,0,0,1
114962,2023,Argentina,Slovenia,0,4,13,17,20/06/2023,0,0,1,1,7,1,2,10,0,1,4,5,1,0,0,1,3,1,1,5
114962,2023,Slovenia,Iran,0,2,7,9,11/6/2023,0,0,0,0,2,0,2,4,1,3,4,8,0,0,0,0,5,1,0,6
114962,2023,France,Slovenia,0,2,15,17,10/6/2023,0,0,0,0,3,1,3,7,2,3,2,7,0,0,2,2,1,0,0,1
114962,2023,Slovenia,Bulgaria,0,2,6,8,8/6/2023,0,0,0,0,4,1,3,8,0,0,4,4,1,0,2,3,1,0,0,1
114962,2023,Slovenia,Serbia,0,4,12,16,7/6/2023,0,0,0,0,6,1,6,13,4,3,5,12,0,0,0,0,7,0,0,7
168715,2023,Japan,Slovenia,0,1,6,7,20/07/2023,7,0,26,33,0,0,0,0,0,3,2,5,0,0,0,0,1,0,0,1
168715,2023,Slovenia,Netherlands,0,1,1,2,9/7/2023,0,0,0,0,0,0,0,0,0,0,0,0,0,0,0,0,1,0,0,1
168715,2023,Slovenia,Italy,0,1,0,1,7/7/2023,1,0,5,6,0,0,1,1,0,1,1,2,0,0,0,0,0,1,0,1
168715,2023,China,Slovenia,0,0,2,2,6/7/2023,4,0,14,18,0,0,0,0,0,1,1,2,0,0,0,0,2,0,0,2
168715,2023,Poland,Slovenia,0,1,2,3,5/7/2023,2,0,18,20,0,0,0,0,1,0,2,3,0,0,0,0,0,0,0,0
168715,2023,Brazil,Slovenia,0,0,2,2,24/06/2023,2,0,4,6,0,0,0,0,0,0,0,0,0,0,0,0,1,1,0,2
168715,2023,Slovenia,Cuba,0,0,0,0,22/06/2023,0,0,0,0,0,0,0,0,0,0,0,0,0,0,0,0,0,0,0,0
168715,2023,Slovenia,Canada,0,0,0,0,21/06/2023,0,0,0,0,0,0,0,0,0,0,0,0,0,0,0,0,0,0,0,0
168715,2023,Argentina,Slovenia,0,0,1,1,20/06/2023,0,0,2,2,0,0,0,0,0,0,0,0,0,0,0,0,0,0,0,0
168715,2023,Slovenia,Iran,0,1,0,1,11/6/2023,0,0,0,0,0,0,0,0,0,0,0,0,0,0,0,0,0,0,0,0
168715,2023,France,Slovenia,0,2,12,14,10/6/2023,10,0,67,77,0,0,1,1,3,1,1,5,0,0,0,0,3,0,1,4
168715,2023,Slovenia,Bulgaria,0,0,0,0,8/6/2023,0,0,3,3,0,0,0,0,0,1,0,1,0,0,0,0,1,0,0,1
168715,2023,Slovenia,Serbia,0,0,1,1,7/6/2023,0,0,1,1,0,0,0,0,0,0,0,0,0,0,0,0,1,0,0,1
151391,2023,Japan,Slovenia,0,2,11,13,20/07/2023,0,0,1,1,2,0,1,3,1,3,3,7,0,0,0,0,0,0,0,0
151391,2023,Slovenia,Netherlands,0,1,15,16,9/7/2023,0,0,0,0,7,0,2,9,0,1,3,4,0,0,0,0,0,1,0,1
151391,2023,Slovenia,Italy,0,1,4,5,7/7/2023,0,0,2,2,1,4,1,6,1,0,3,4,0,0,2,2,1,0,0,1
151391,2023,China,Slovenia,4,3,16,23,6/7/2023,0,0,7,7,8,1,1,10,1,3,4,8,0,1,2,3,6,1,0,7
151391,2023,Poland,Slovenia,2,3,20,25,5/7/2023,0,0,3,3,5,0,6,11,4,6,5,15,0,0,4,4,7,1,1,9
151391,2023,Brazil,Slovenia,0,2,15,17,24/06/2023,0,0,4,4,3,1,2,6,1,5,6,12,0,0,4,4,2,3,0,5
151391,2023,Slovenia,Cuba,0,2,13,15,22/06/2023,0,0,2,2,3,0,2,5,6,1,5,12,0,0,0,0,0,1,1,2
151391,2023,Slovenia,Canada,0,0,16,16,21/06/2023,0,0,2,2,4,0,2,6,1,7,6,14,2,0,3,5,4,1,0,5
151391,2023,Argentina,Slovenia,1,2,14,17,20/06/2023,0,0,2,2,3,0,7,10,4,1,6,11,0,0,0,0,1,1,1,3
151391,2023,Slovenia,Iran,1,2,13,16,11/6/2023,0,0,1,1,4,0,1,5,1,3,1,5,0,0,0,0,3,0,0,3
151391,2023,France,Slovenia,0,4,16,20,10/6/2023,0,0,2,2,5,2,4,11,3,3,13,19,0,0,1,1,0,0,0,0
151391,2023,Slovenia,Bulgaria,1,1,10,12,8/6/2023,0,0,1,1,4,0,2,6,0,2,4,6,0,0,1,1,2,0,0,2
151391,2023,Slovenia,Serbia,1,2,19,22,7/6/2023,0,0,0,0,6,0,3,9,1,10,6,17,1,0,0,1,5,0,0,5
151405,2023,Japan,Slovenia,0,0,0,0,20/07/2023,0,0,0,0,0,0,0,0,0,0,0,0,0,0,0,0,0,0,0,0
151405,2023,Slovenia,Netherlands,0,1,0,1,9/7/2023,0,0,0,0,0,0,0,0,0,0,0,0,0,0,0,0,0,0,0,0
151405,2023,Slovenia,Italy,0,0,0,0,7/7/2023,0,0,0,0,0,0,0,0,0,0,0,0,0,0,0,0,0,0,0,0
151405,2023,China,Slovenia,0,0,0,0,6/7/2023,0,0,0,0,0,0,0,0,0,0,0,0,0,0,0,0,0,0,0,0
151405,2023,Poland,Slovenia,0,0,0,0,5/7/2023,0,0,0,0,0,0,0,0,0,0,0,0,0,0,0,0,0,0,0,0
151405,2023,Brazil,Slovenia,0,0,0,0,24/06/2023,0,0,0,0,0,0,0,0,0,0,0,0,0,0,0,0,0,0,0,0
151405,2023,Slovenia,Cuba,0,0,1,1,22/06/2023,0,0,0,0,0,0,0,0,0,0,0,0,0,0,0,0,1,0,0,1
151405,2023,Slovenia,Canada,0,0,0,0,21/06/2023,0,0,0,0,1,0,1,2,0,1,0,1,0,0,0,0,0,0,0,0
151405,2023,Argentina,Slovenia,0,1,4,5,20/06/2023,0,0,0,0,0,0,0,0,0,0,0,0,0,0,0,0,0,0,0,0
151405,2023,Slovenia,Iran,0,0,0,0,11/6/2023,0,0,0,0,0,0,0,0,0,0,0,0,0,0,0,0,0,0,0,0
151405,2023,France,Slovenia,0,0,0,0,10/6/2023,0,0,0,0,0,0,0,0,0,0,0,0,0,0,0,0,0,0,0,0
151405,2023,Slovenia,Bulgaria,0,2,9,11,8/6/2023,0,0,1,1,5,5,5,15,0,1,0,1,0,0,1,1,0,0,1,1
151405,2023,Slovenia,Serbia,0,0,1,1,7/6/2023,0,0,0,0,0,1,1,2,0,1,1,2,0,0,0,0,0,0,0,0
161756,2023,Japan,Slovenia,0,0,0,0,20/07/2023,0,0,0,0,0,0,0,0,0,0,0,0,0,0,0,0,0,0,0,0
161756,2023,Slovenia,Netherlands,0,0,0,0,9/7/2023,0,0,0,0,0,0,0,0,0,0,0,0,0,0,0,0,0,0,0,0
161756,2023,Slovenia,Italy,0,0,0,0,7/7/2023,0,0,0,0,0,0,0,0,0,0,0,0,0,0,0,0,0,0,0,0
161756,2023,China,Slovenia,0,0,0,0,6/7/2023,0,0,0,0,0,0,0,0,0,0,0,0,0,0,0,0,0,0,0,0
161756,2023,Poland,Slovenia,0,0,0,0,5/7/2023,0,0,0,0,0,0,0,0,0,0,0,0,0,0,0,0,0,0,0,0
161756,2023,Brazil,Slovenia,0,0,0,0,24/06/2023,0,0,0,0,0,0,0,0,0,0,0,0,0,0,0,0,0,0,0,0
161756,2023,Slovenia,Cuba,0,0,0,0,22/06/2023,0,0,0,0,0,0,0,0,0,0,0,0,0,0,0,0,0,0,0,0
161756,2023,Slovenia,Canada,0,0,0,0,21/06/2023,0,0,0,0,0,0,0,0,0,0,0,0,1,1,1,3,0,0,0,0
161756,2023,Argentina,Slovenia,0,0,0,0,20/06/2023,0,0,0,0,0,0,0,0,0,0,0,0,0,0,0,0,0,0,0,0
161756,2023,Slovenia,Iran,0,0,0,0,11/6/2023,0,0,0,0,0,0,0,0,0,0,0,0,0,0,0,0,0,0,0,0
161756,2023,France,Slovenia,0,0,0,0,10/6/2023,0,0,0,0,0,0,0,0,0,0,0,0,0,0,0,0,0,0,0,0
161756,2023,Slovenia,Bulgaria,0,0,0,0,8/6/2023,0,0,0,0,0,0,0,0,0,0,0,0,0,0,0,0,0,0,0,0
161756,2023,Slovenia,Serbia,0,0,0,0,7/6/2023,0,0,0,0,0,0,0,0,0,0,0,0,0,0,0,0,0,0,0,0
151404,2023,Japan,Slovenia,0,0,0,0,20/07/2023,0,0,0,0,0,0,0,0,0,0,0,0,0,0,0,0,0,0,0,0
151404,2023,Slovenia,Netherlands,0,0,0,0,9/7/2023,0,0,0,0,0,0,0,0,0,0,0,0,0,0,0,0,0,0,0,0
151404,2023,Slovenia,Italy,0,0,5,5,7/7/2023,0,0,1,1,4,1,3,8,0,4,2,6,0,0,0,0,0,1,1,2
151404,2023,China,Slovenia,0,0,0,0,6/7/2023,0,0,0,0,0,0,0,0,0,0,0,0,0,0,0,0,0,0,0,0
151404,2023,Poland,Slovenia,0,0,0,0,5/7/2023,0,0,0,0,0,0,0,0,0,0,0,0,0,0,0,0,0,0,0,0
151404,2023,Brazil,Slovenia,0,0,0,0,24/06/2023,0,0,0,0,0,0,0,0,0,0,0,0,0,0,0,0,0,0,0,0
151404,2023,Slovenia,Cuba,0,0,0,0,22/06/2023,0,0,0,0,0,0,0,0,0,0,0,0,0,0,0,0,0,0,0,0
151404,2023,Slovenia,Canada,0,1,0,1,21/06/2023,0,0,0,0,1,0,1,2,0,0,0,0,0,0,0,0,0,0,0,0
151404,2023,Argentina,Slovenia,0,0,0,0,20/06/2023,0,0,0,0,0,0,0,0,0,0,0,0,0,0,0,0,0,0,0,0
151404,2023,Slovenia,Iran,0,0,0,0,11/6/2023,0,0,0,0,0,0,0,0,0,0,0,0,0,0,0,0,0,0,0,0
151404,2023,France,Slovenia,0,0,0,0,10/6/2023,0,0,0,0,0,0,0,0,0,0,0,0,0,0,0,0,0,0,0,0
151404,2023,Slovenia,Bulgaria,0,0,0,0,8/6/2023,0,0,0,0,0,0,0,0,0,0,0,0,0,0,0,0,0,0,0,0
151404,2023,Slovenia,Serbia,0,0,0,0,7/6/2023,0,0,0,0,0,0,0,0,0,0,0,0,0,0,0,0,0,0,0,0
144483,2023,Japan,Slovenia,0,0,0,0,20/07/2023,0,0,0,0,0,0,0,0,0,0,0,0,0,0,0,0,0,0,0,0
144483,2023,Slovenia,Netherlands,0,0,0,0,9/7/2023,0,0,0,0,0,0,0,0,0,0,0,0,0,0,0,0,0,0,0,0
144483,2023,Slovenia,Italy,0,0,0,0,7/7/2023,0,0,0,0,0,0,0,0,0,0,0,0,0,0,0,0,0,0,0,0
144483,2023,China,Slovenia,0,0,0,0,6/7/2023,0,0,0,0,0,0,0,0,0,0,0,0,0,0,0,0,0,0,0,0
144483,2023,Poland,Slovenia,0,0,0,0,5/7/2023,0,0,0,0,0,0,0,0,0,0,0,0,0,0,0,0,0,0,0,0
144483,2023,Brazil,Slovenia,0,0,0,0,24/06/2023,0,0,0,0,0,0,0,0,0,0,0,0,0,0,0,0,0,0,0,0
144483,2023,Slovenia,Cuba,0,0,0,0,22/06/2023,0,0,0,0,0,0,0,0,0,0,0,0,0,0,0,0,0,0,0,0
144483,2023,Slovenia,Canada,0,0,0,0,21/06/2023,0,0,0,0,0,0,0,0,0,0,0,0,0,0,0,0,0,0,0,0
144483,2023,Argentina,Slovenia,0,0,0,0,20/06/2023,0,0,0,0,0,0,0,0,0,0,0,0,0,0,0,0,0,0,0,0
144483,2023,Slovenia,Iran,0,0,0,0,11/6/2023,0,0,0,0,0,0,0,0,0,0,0,0,0,0,0,0,0,0,0,0
144483,2023,France,Slovenia,0,0,0,0,10/6/2023,0,0,0,0,0,0,0,0,0,0,0,0,0,0,0,0,0,0,0,0
144483,2023,Slovenia,Bulgaria,0,0,0,0,8/6/2023,0,0,0,0,0,0,0,0,0,0,0,0,0,0,0,0,0,0,0,0
144483,2023,Slovenia,Serbia,0,0,0,0,7/6/2023,0,0,0,0,0,0,0,0,0,0,0,0,0,0,0,0,0,0,0,0
144415,2023,Japan,Slovenia,0,0,0,0,20/07/2023,0,0,11,11,0,0,0,0,0,0,0,0,5,1,4,10,9,7,1,17
144415,2023,Slovenia,Netherlands,0,0,0,0,9/7/2023,0,0,6,6,0,0,0,0,0,0,0,0,7,0,16,23,3,1,1,5
144415,2023,Slovenia,Italy,0,0,0,0,7/7/2023,0,0,7,7,0,0,0,0,0,0,0,0,7,1,11,19,7,2,2,11
144415,2023,China,Slovenia,0,0,0,0,6/7/2023,0,1,9,10,0,0,0,0,0,0,0,0,9,2,11,22,13,2,1,16
144415,2023,Poland,Slovenia,0,0,0,0,5/7/2023,0,0,6,6,0,0,0,0,0,0,0,0,14,2,12,28,16,5,2,23
144415,2023,Brazil,Slovenia,0,0,0,0,24/06/2023,0,0,7,7,0,0,0,0,0,0,0,0,4,2,16,22,15,8,0,23
144415,2023,Slovenia,Cuba,0,0,0,0,22/06/2023,0,0,6,6,0,0,0,0,0,0,0,0,4,2,13,19,9,1,1,11
144415,2023,Slovenia,Canada,0,0,0,0,21/06/2023,0,0,3,3,0,0,0,0,0,0,0,0,2,0,5,7,5,3,5,13
144415,2023,Argentina,Slovenia,0,0,0,0,20/06/2023,0,0,3,3,0,0,0,0,0,0,0,0,7,0,10,17,9,5,1,15
144415,2023,Slovenia,Iran,0,0,0,0,11/6/2023,0,0,3,3,0,0,0,0,0,0,0,0,6,0,13,19,9,1,1,11
144415,2023,France,Slovenia,0,0,0,0,10/6/2023,0,0,10,10,0,0,0,0,0,0,0,0,5,1,5,11,12,0,0,12
144415,2023,Slovenia,Bulgaria,0,0,0,0,8/6/2023,0,0,1,1,0,0,0,0,0,0,0,0,6,1,9,16,11,2,0,13
144415,2023,Slovenia,Serbia,0,0,0,0,7/6/2023,0,0,3,3,0,0,0,0,0,0,0,0,11,0,12,23,10,1,1,12
155920,2023,Japan,Slovenia,0,0,4,4,20/07/2023,0,0,0,0,0,1,2,3,0,1,1,2,2,0,6,8,0,1,0,1
155920,2023,Slovenia,Netherlands,0,0,0,0,9/7/2023,0,0,0,0,0,0,0,0,0,0,0,0,0,0,0,0,0,0,0,0
155920,2023,Slovenia,Italy,0,0,1,1,7/7/2023,0,0,0,0,2,0,6,8,0,1,0,1,2,2,4,8,0,0,0,0
155920,2023,China,Slovenia,1,0,15,16,6/7/2023,0,0,8,8,17,3,13,33,0,8,3,11,8,0,10,18,3,1,1,5
155920,2023,Poland,Slovenia,0,1,2,3,5/7/2023,0,0,2,2,3,1,0,4,1,0,0,1,1,0,2,3,0,0,0,0
155920,2023,Brazil,Slovenia,0,2,5,7,24/06/2023,0,0,1,1,6,0,7,13,0,3,2,5,3,1,6,10,0,1,1,2
155920,2023,Slovenia,Cuba,0,3,5,8,22/06/2023,0,0,1,1,12,2,7,21,1,2,1,4,3,0,8,11,4,3,0,7
155920,2023,Slovenia,Canada,0,0,1,1,21/06/2023,0,0,0,0,3,0,0,3,1,0,2,3,0,0,0,0,0,0,1,1
155920,2023,Argentina,Slovenia,0,0,0,0,20/06/2023,0,0,0,0,0,0,0,0,1,0,0,1,0,0,0,0,0,0,0,0
155920,2023,Slovenia,Iran,0,0,0,0,11/6/2023,0,0,0,0,0,0,0,0,0,0,0,0,0,0,0,0,0,0,0,0
155920,2023,France,Slovenia,0,0,0,0,10/6/2023,0,0,0,0,0,0,0,0,0,0,0,0,0,0,0,0,0,0,0,0
155920,2023,Slovenia,Bulgaria,0,0,1,1,8/6/2023,0,0,0,0,1,0,0,1,0,0,0,0,1,0,2,3,0,0,0,0
155920,2023,Slovenia,Serbia,0,0,0,0,7/6/2023,0,0,0,0,0,0,0,0,0,0,0,0,0,0,0,0,0,0,0,0
119018,2023,Japan,Slovenia,0,0,6,6,20/07/2023,9,1,35,45,0,0,1,1,0,2,2,4,0,0,0,0,3,3,0,6
119018,2023,Slovenia,Netherlands,0,0,11,11,9/7/2023,21,0,41,62,0,0,2,2,0,4,1,5,0,0,1,1,4,7,0,11
119018,2023,Slovenia,Italy,0,1,7,8,7/7/2023,20,1,46,67,0,0,0,0,0,1,3,4,0,0,0,0,7,3,3,13
119018,2023,China,Slovenia,0,2,7,9,6/7/2023,22,0,61,83,1,0,0,1,0,1,2,3,0,0,0,0,6,1,1,8
119018,2023,Poland,Slovenia,0,0,13,13,5/7/2023,21,1,81,103,1,0,0,1,0,1,2,3,0,0,0,0,5,6,0,11
119018,2023,Brazil,Slovenia,0,1,13,14,24/06/2023,24,1,52,77,0,0,2,2,1,2,6,9,0,0,0,0,11,4,0,15
119018,2023,Slovenia,Cuba,0,2,12,14,22/06/2023,16,0,50,66,1,1,0,2,1,0,4,5,0,0,0,0,2,4,1,7
119018,2023,Slovenia,Canada,1,2,6,9,21/06/2023,21,0,41,62,0,0,1,1,0,1,2,3,0,0,1,1,7,2,2,11
119018,2023,Argentina,Slovenia,0,0,11,11,20/06/2023,22,0,58,80,0,0,2,2,1,1,1,3,0,0,1,1,8,2,3,13
119018,2023,Slovenia,Iran,0,0,8,8,11/6/2023,14,1,61,76,0,0,0,0,2,1,1,4,0,0,0,0,6,0,1,7
119018,2023,France,Slovenia,0,0,1,1,10/6/2023,2,0,7,9,0,0,0,0,1,0,1,2,0,0,0,0,1,0,0,1
119018,2023,Slovenia,Bulgaria,0,3,6,9,8/6/2023,17,0,52,69,1,0,1,2,0,0,2,2,0,0,1,1,0,0,1,1
119018,2023,Slovenia,Serbia,0,2,9,11,7/6/2023,14,1,96,111,2,1,1,4,0,4,4,8,0,0,1,1,3,0,1,4
114957,2023,Japan,Slovenia,0,3,8,11,20/07/2023,0,0,4,4,12,4,14,30,0,2,4,6,2,0,12,14,7,2,1,10
114957,2023,Slovenia,Netherlands,2,1,13,16,9/7/2023,0,0,3,3,12,5,4,21,0,0,1,1,3,3,9,15,4,5,1,10
114957,2023,Slovenia,Italy,0,2,8,10,7/7/2023,0,0,5,5,10,3,11,24,0,1,2,3,1,0,16,17,5,1,0,6
114957,2023,China,Slovenia,0,3,15,18,6/7/2023,0,0,5,5,13,1,17,31,0,4,2,6,10,1,18,29,7,2,0,9
114957,2023,Poland,Slovenia,2,5,13,20,5/7/2023,0,1,6,7,14,6,21,41,0,5,2,7,5,3,20,28,6,4,0,10
114957,2023,Brazil,Slovenia,1,2,12,15,24/06/2023,0,0,7,7,15,2,10,27,1,4,2,7,3,1,17,21,6,3,0,9
114957,2023,Slovenia,Cuba,3,6,10,19,22/06/2023,0,0,5,5,16,0,5,21,0,4,2,6,3,1,11,15,3,3,0,6
114957,2023,Slovenia,Canada,0,1,12,13,21/06/2023,0,0,3,3,9,3,12,24,0,1,0,1,5,0,10,15,4,2,0,6
114957,2023,Argentina,Slovenia,1,3,11,15,20/06/2023,0,0,6,6,11,6,7,24,0,3,0,3,10,2,16,28,5,0,0,5
114957,2023,Slovenia,Iran,5,4,5,14,11/6/2023,0,0,6,6,6,5,10,21,2,3,1,6,6,1,13,20,6,0,0,6
114957,2023,France,Slovenia,1,4,7,12,10/6/2023,0,0,1,1,14,2,12,28,1,0,0,1,8,2,21,31,8,0,3,11
114957,2023,Slovenia,Bulgaria,2,1,7,10,8/6/2023,0,0,2,2,11,5,6,22,0,1,1,2,4,1,9,14,3,0,1,4
114957,2023,Slovenia,Serbia,1,2,16,19,7/6/2023,0,0,8,8,21,5,9,35,0,1,1,2,5,0,16,21,12,0,2,14
136918,2023,Japan,Slovenia,0,1,9,10,20/07/2023,0,0,3,3,8,2,12,22,1,0,0,1,4,1,12,17,3,4,1,8
136918,2023,Slovenia,Netherlands,1,5,9,15,9/7/2023,0,0,4,4,8,2,5,15,4,3,2,9,2,0,5,7,3,2,0,5
136918,2023,Slovenia,Italy,1,2,8,11,7/7/2023,0,0,6,6,8,6,6,20,3,3,2,8,0,1,3,4,5,2,0,7
136918,2023,China,Slovenia,1,3,9,13,6/7/2023,0,0,3,3,18,8,18,44,2,2,2,6,0,1,4,5,5,6,3,14
136918,2023,Poland,Slovenia,0,7,10,17,5/7/2023,0,1,5,6,19,8,17,44,1,2,1,4,1,0,10,11,9,3,2,14
136918,2023,Brazil,Slovenia,0,4,14,18,24/06/2023,0,0,4,4,18,7,12,37,0,7,1,8,2,0,10,12,1,3,1,5
136918,2023,Slovenia,Cuba,1,5,10,16,22/06/2023,0,0,4,4,12,2,6,20,1,2,2,5,2,0,3,5,2,6,1,9
136918,2023,Slovenia,Canada,2,2,12,16,21/06/2023,0,0,2,2,9,2,4,15,1,1,1,3,6,0,6,12,3,3,2,8
136918,2023,Argentina,Slovenia,3,5,12,20,20/06/2023,0,0,3,3,12,4,8,24,3,2,2,7,5,0,4,9,2,3,1,6
136918,2023,Slovenia,Iran,0,4,9,13,11/6/2023,0,0,5,5,8,1,16,25,1,1,5,7,0,0,9,9,7,0,1,8
136918,2023,France,Slovenia,0,5,10,15,10/6/2023,0,0,3,3,7,4,17,28,0,2,1,3,2,0,7,9,11,0,1,12
136918,2023,Slovenia,Bulgaria,0,0,4,4,8/6/2023,0,1,1,2,7,1,1,9,1,2,2,5,2,0,6,8,4,0,0,4
136918,2023,Slovenia,Serbia,0,3,11,14,7/6/2023,0,0,1,1,11,7,5,23,0,4,1,5,2,0,12,14,6,0,0,6
168747,2023,Japan,Slovenia,0,1,7,8,20/07/2023,0,0,2,2,8,2,11,21,2,7,0,9,3,0,6,9,7,2,1,10
168747,2023,Slovenia,Netherlands,1,2,5,8,9/7/2023,0,0,1,1,8,6,9,23,2,6,1,9,1,0,6,7,5,2,0,7
168747,2023,Slovenia,Italy,0,2,3,5,7/7/2023,0,0,0,0,5,3,12,20,1,2,1,4,1,2,12,15,4,1,0,5
168747,2023,China,Slovenia,0,0,0,0,6/7/2023,0,0,0,0,0,0,0,0,0,0,0,0,0,0,0,0,0,0,0,0
168747,2023,Poland,Slovenia,1,0,18,19,5/7/2023,0,0,2,2,15,3,13,31,1,3,2,6,1,1,15,17,3,5,1,9
168747,2023,Brazil,Slovenia,0,2,4,6,24/06/2023,0,0,1,1,7,1,7,15,0,1,3,4,1,0,5,6,2,1,0,3
168747,2023,Slovenia,Cuba,0,2,1,3,22/06/2023,0,0,0,0,1,0,5,6,0,2,0,2,0,1,4,5,0,1,1,2
168747,2023,Slovenia,Canada,2,3,5,10,21/06/2023,0,0,3,3,16,1,5,22,1,2,6,9,1,1,6,8,4,1,1,6
168747,2023,Argentina,Slovenia,0,4,5,9,20/06/2023,0,0,2,2,16,1,11,28,0,2,2,4,7,0,4,11,4,0,1,5
168747,2023,Slovenia,Iran,4,3,5,12,11/6/2023,0,0,2,2,20,3,10,33,1,7,1,9,3,0,6,9,4,0,0,4
168747,2023,France,Slovenia,2,7,7,16,10/6/2023,0,0,3,3,17,5,10,32,2,0,1,3,4,0,8,12,6,0,1,7
168747,2023,Slovenia,Bulgaria,0,1,9,10,8/6/2023,0,0,0,0,5,4,6,15,2,2,0,4,5,2,8,15,3,0,1,4
168747,2023,Slovenia,Serbia,0,4,11,15,7/6/2023,0,0,0,0,22,2,19,43,2,2,0,4,6,1,17,24,1,0,0,1
182325,2023,Japan,Slovenia,0,0,0,0,20/07/2023,0,0,0,0,0,0,0,0,0,0,0,0,0,0,0,0,0,0,0,0
182325,2023,Slovenia,Netherlands,0,0,0,0,9/7/2023,0,0,0,0,0,0,0,0,0,0,0,0,0,0,0,0,0,0,0,0
182325,2023,Slovenia,Italy,0,0,0,0,7/7/2023,0,0,0,0,0,0,0,0,0,0,0,0,0,0,0,0,0,0,0,0
182325,2023,China,Slovenia,0,0,0,0,6/7/2023,0,0,0,0,0,0,0,0,0,0,0,0,0,0,0,0,0,0,0,0
182325,2023,Poland,Slovenia,0,0,0,0,5/7/2023,0,0,0,0,0,0,0,0,0,0,0,0,0,0,0,0,0,0,0,0
182325,2023,Brazil,Slovenia,0,0,0,0,24/06/2023,0,0,0,0,0,0,0,0,0,0,0,0,0,0,0,0,0,0,0,0
182325,2023,Slovenia,Cuba,0,0,0,0,22/06/2023,0,0,0,0,1,0,0,1,0,0,0,0,0,0,0,0,0,0,0,0
182325,2023,Slovenia,Canada,0,0,0,0,21/06/2023,0,0,0,0,0,0,0,0,0,0,0,0,0,0,0,0,0,0,0,0
182325,2023,Argentina,Slovenia,0,0,0,0,20/06/2023,0,0,0,0,0,0,0,0,0,0,0,0,0,0,0,0,0,0,0,0
118893,2023,Poland,USA,1,1,10,12,23/07/2023,0,0,0,0,9,6,7,22,0,3,0,3,0,1,5,6,3,2,1,6
118893,2023,USA,Italy,0,2,11,13,22/07/2023,0,0,1,1,17,1,7,25,0,2,3,5,0,0,1,1,8,2,0,10
118893,2023,USA,France,2,2,10,14,19/07/2023,0,0,3,3,20,2,15,37,0,1,3,4,0,0,1,1,7,3,0,10
118893,2023,USA,Bulgaria,1,2,6,9,10/7/2023,0,0,0,0,6,2,3,11,1,3,6,10,0,0,0,0,2,0,1,3
118893,2023,USA,France,1,1,11,13,9/7/2023,0,0,3,3,7,2,5,14,0,2,0,2,0,0,2,2,4,2,0,6
118893,2023,USA,Argentina,2,6,13,21,8/7/2023,0,0,4,4,17,8,13,38,0,2,8,10,0,0,3,3,7,1,2,10
118893,2023,USA,Cuba,4,4,11,19,6/7/2023,0,0,0,0,9,2,8,19,0,4,3,7,0,0,2,2,4,0,0,4
118893,2023,Poland,USA,2,0,13,15,24/06/2023,0,0,3,3,7,3,5,15,0,3,4,7,0,0,1,1,9,2,0,11
118893,2023,Iran,USA,0,2,5,7,23/06/2023,0,0,1,1,13,2,7,22,0,3,0,3,0,0,2,2,4,3,0,7
118893,2023,USA,China,0,0,2,2,21/06/2023,0,0,1,1,1,0,0,1,0,0,0,0,0,0,0,0,0,1,0,1
118893,2023,USA,Serbia,2,2,16,20,20/06/2023,0,0,5,5,10,4,8,22,4,0,5,9,0,0,2,2,7,7,2,16
118893,2023,USA,Brazil,0,0,0,0,11/6/2023,0,0,0,0,0,0,0,0,0,0,0,0,0,0,0,0,0,0,0,0
118893,2023,Canada,USA,1,3,9,13,11/6/2023,0,0,2,2,14,3,6,23,3,3,3,9,0,0,4,4,6,1,0,7
118893,2023,Italy,USA,1,3,2,6,8/6/2023,0,1,0,1,6,0,13,19,0,3,2,5,0,0,1,1,6,2,4,12
118893,2023,USA,Netherlands,0,0,0,0,7/6/2023,0,0,0,0,0,0,0,0,0,0,0,0,0,0,0,0,0,0,0,0
132624,2023,Poland,USA,0,2,4,6,23/07/2023,0,0,1,1,9,5,4,18,2,3,3,8,5,0,14,19,2,2,0,4
132624,2023,USA,Italy,0,0,0,0,22/07/2023,0,0,0,0,0,0,0,0,0,0,0,0,0,0,0,0,0,0,0,0
132624,2023,USA,Bulgaria,0,0,0,0,10/7/2023,0,0,0,0,0,0,0,0,0,0,0,0,0,0,0,0,0,0,0,0
132624,2023,USA,France,1,3,6,10,9/7/2023,0,0,1,1,11,5,6,22,2,2,4,8,4,2,14,20,3,1,0,4
132624,2023,USA,Argentina,0,0,0,0,8/7/2023,0,0,0,0,0,0,0,0,0,0,0,0,0,0,0,0,0,0,0,0
132624,2023,USA,Cuba,1,5,5,11,6/7/2023,0,0,2,2,9,1,9,19,2,2,2,6,2,0,4,6,0,1,0,1
132624,2023,Poland,USA,1,4,4,9,24/06/2023,0,0,0,0,8,4,7,19,2,1,1,4,1,1,13,15,8,1,0,9
132624,2023,Iran,USA,7,1,14,22,23/06/2023,0,0,2,2,2,3,11,16,0,3,1,4,4,1,16,21,1,3,0,4
132624,2023,USA,China,0,0,0,0,21/06/2023,0,0,0,0,0,0,0,0,0,0,0,0,0,0,0,0,0,0,0,0
132624,2023,USA,Serbia,2,3,14,19,20/06/2023,0,0,3,3,13,1,12,26,0,1,1,2,3,3,13,19,6,2,0,8
132624,2023,USA,Brazil,0,1,5,6,11/6/2023,0,0,3,3,7,1,10,18,0,3,3,6,2,3,10,15,3,0,0,3
132624,2023,Canada,USA,1,3,8,12,11/6/2023,0,0,3,3,16,1,8,25,0,5,1,6,4,0,6,10,5,3,0,8
132624,2023,Italy,USA,0,0,0,0,8/6/2023,0,0,0,0,0,0,0,0,0,0,0,0,0,0,0,0,0,0,0,0
132624,2023,USA,Netherlands,0,4,5,9,7/6/2023,0,0,3,3,9,3,10,22,2,1,0,3,6,1,17,24,1,0,0,1
147721,2023,Poland,USA,0,0,0,0,23/07/2023,0,0,0,0,0,0,0,0,0,0,0,0,0,0,0,0,0,0,0,0
147721,2023,USA,Italy,0,0,0,0,22/07/2023,0,0,0,0,0,0,0,0,0,0,0,0,0,0,0,0,0,0,0,0
147721,2023,USA,France,0,0,0,0,19/07/2023,0,0,0,0,0,0,0,0,0,0,0,0,0,0,0,0,0,0,0,0
147721,2023,USA,Bulgaria,0,2,3,5,10/7/2023,0,0,2,2,6,1,5,12,2,0,2,4,0,0,0,0,4,0,0,4
147721,2023,USA,France,0,0,0,0,9/7/2023,0,0,0,0,0,0,0,0,0,0,0,0,0,0,0,0,0,0,0,0
147721,2023,USA,Argentina,0,0,3,3,8/7/2023,0,0,0,0,1,0,5,6,0,5,1,6,0,0,0,0,0,0,1,1
147721,2023,USA,Cuba,0,0,0,0,6/7/2023,0,0,0,0,0,0,0,0,0,0,0,0,0,0,0,0,0,0,0,0
147721,2023,Poland,USA,0,3,6,9,24/06/2023,0,0,1,1,4,0,3,7,1,3,4,8,0,0,0,0,1,0,0,1
147721,2023,Iran,USA,0,0,0,0,23/06/2023,0,0,0,0,0,0,0,0,0,0,0,0,0,0,0,0,0,0,0,0
147721,2023,USA,China,0,0,0,0,21/06/2023,0,0,0,0,0,0,0,0,0,0,0,0,0,0,0,0,0,0,0,0
147721,2023,USA,Serbia,0,1,12,13,20/06/2023,0,0,1,1,10,0,3,13,0,4,4,8,0,0,0,0,0,1,0,1
147721,2023,USA,Brazil,0,0,0,0,11/6/2023,0,0,0,0,0,0,0,0,0,0,0,0,0,0,0,0,0,0,0,0
147721,2023,Canada,USA,2,2,12,16,11/6/2023,0,0,1,1,4,0,3,7,1,1,3,5,0,0,0,0,2,0,0,2
147721,2023,Italy,USA,0,0,0,0,8/6/2023,0,0,0,0,0,0,0,0,0,0,0,0,0,0,0,0,0,0,0,0
147721,2023,USA,Netherlands,0,1,15,16,7/6/2023,0,0,0,0,5,0,4,9,0,2,3,5,1,0,0,1,2,1,1,4
139254,2023,Poland,USA,1,3,12,16,23/07/2023,0,0,4,4,13,3,7,23,0,6,0,6,6,1,13,20,7,4,1,12
139254,2023,USA,Italy,0,2,9,11,22/07/2023,0,1,2,3,8,4,5,17,3,1,7,11,2,2,16,20,6,3,2,11
139254,2023,USA,France,0,4,7,11,19/07/2023,0,0,5,5,10,5,8,23,2,2,8,12,5,2,13,20,6,1,0,7
139254,2023,USA,Bulgaria,0,0,0,0,10/7/2023,0,0,0,0,0,0,0,0,0,0,0,0,0,0,0,0,0,0,0,0
139254,2023,USA,France,0,4,9,13,9/7/2023,0,0,4,4,9,7,6,22,2,1,3,6,4,1,11,16,1,0,0,1
139254,2023,USA,Argentina,2,4,18,24,8/7/2023,0,0,6,6,22,7,12,41,1,3,4,8,8,3,29,40,8,2,0,10
139254,2023,USA,Cuba,1,4,7,12,6/7/2023,0,0,4,4,7,0,6,13,1,2,0,3,4,1,8,13,2,0,1,3
139254,2023,Poland,USA,2,5,4,11,24/06/2023,0,0,2,2,14,2,10,26,1,3,2,6,3,1,14,18,5,2,0,7
139254,2023,Iran,USA,0,0,0,0,23/06/2023,0,0,0,0,0,0,0,0,0,0,0,0,0,0,0,0,0,0,0,0
139254,2023,USA,China,0,2,7,9,21/06/2023,0,0,4,4,11,1,3,15,0,3,0,3,4,4,15,23,3,1,0,4
139254,2023,USA,Serbia,2,7,12,21,20/06/2023,0,1,1,2,14,5,11,30,1,5,5,11,6,2,23,31,7,1,0,8
139254,2023,USA,Brazil,1,2,4,7,11/6/2023,0,0,2,2,7,3,5,15,0,1,2,3,3,1,18,22,2,0,1,3
139254,2023,Canada,USA,0,4,7,11,11/6/2023,0,0,4,4,9,5,5,19,0,4,3,7,3,0,22,25,5,0,1,6
139254,2023,Italy,USA,4,2,10,16,8/6/2023,0,0,4,4,9,1,5,15,2,3,1,6,4,1,5,10,7,1,0,8
139254,2023,USA,Netherlands,3,3,3,9,7/6/2023,0,0,2,2,10,2,8,20,0,1,1,2,6,0,9,15,4,0,2,6
170104,2023,Poland,USA,0,0,0,0,23/07/2023,0,0,1,1,1,1,0,2,0,0,0,0,0,0,0,0,1,0,0,1
170104,2023,USA,Italy,0,0,0,0,22/07/2023,0,0,0,0,0,0,0,0,0,0,0,0,0,0,0,0,0,0,0,0
170104,2023,USA,France,0,1,0,1,19/07/2023,0,0,0,0,0,0,0,0,0,0,0,0,0,0,0,0,0,0,0,0
170104,2023,Poland,USA,0,1,1,2,24/06/2023,0,0,0,0,0,0,0,0,0,0,0,0,0,0,0,0,0,0,0,0
170104,2023,Iran,USA,1,1,1,3,23/06/2023,0,0,0,0,0,0,0,0,0,0,0,0,0,0,0,0,0,0,0,0
170104,2023,USA,China,0,2,11,13,21/06/2023,0,0,0,0,10,1,7,18,1,1,2,4,0,0,0,0,4,3,1,8
170104,2023,USA,Serbia,0,0,0,0,20/06/2023,0,0,0,0,0,0,0,0,0,0,0,0,0,0,0,0,0,0,0,0
170104,2023,USA,Brazil,3,4,6,13,11/6/2023,0,0,0,0,8,7,7,22,0,3,1,4,0,0,0,0,4,4,0,8
170104,2023,Canada,USA,0,0,0,0,11/6/2023,0,0,0,0,0,0,0,0,0,0,0,0,0,0,0,0,0,0,0,0
170104,2023,Italy,USA,0,0,0,0,8/6/2023,0,0,0,0,0,0,2,2,0,0,0,0,0,0,0,0,0,0,0,0
170104,2023,USA,Netherlands,2,2,8,12,7/6/2023,0,0,0,0,8,3,8,19,2,2,1,5,0,0,0,0,4,3,3,10
142445,2023,Poland,USA,0,0,0,0,23/07/2023,0,0,0,0,0,0,0,0,0,0,0,0,0,0,0,0,0,0,0,0
142445,2023,USA,Italy,0,0,0,0,22/07/2023,0,0,0,0,0,0,0,0,0,0,0,0,0,0,0,0,0,0,0,0
142445,2023,USA,France,0,0,0,0,19/07/2023,0,0,0,0,0,0,0,0,0,0,0,0,0,0,0,0,0,0,0,0
142445,2023,Poland,USA,0,0,0,0,24/06/2023,0,0,0,0,0,0,0,0,0,0,0,0,0,0,0,0,0,0,0,0
142445,2023,Iran,USA,0,0,0,0,23/06/2023,0,0,0,0,0,0,0,0,0,0,0,0,0,0,0,0,0,0,0,0
142445,2023,USA,China,0,0,0,0,21/06/2023,0,0,4,4,0,0,0,0,0,0,0,0,2,0,3,5,1,2,0,3
142445,2023,USA,Serbia,0,0,0,0,20/06/2023,0,0,0,0,0,0,0,0,0,0,0,0,0,0,0,0,0,0,0,0
124879,2023,Poland,USA,0,2,12,14,23/07/2023,28,0,60,88,0,0,1,1,0,0,3,3,0,0,0,0,2,2,1,5
124879,2023,USA,Italy,0,0,10,10,22/07/2023,23,0,44,67,1,0,1,2,2,1,4,7,0,0,2,2,3,2,0,5
124879,2023,USA,France,1,2,20,23,19/07/2023,49,0,52,101,0,0,1,1,0,5,2,7,0,0,1,1,12,3,1,16
124879,2023,USA,Bulgaria,0,0,0,0,10/7/2023,0,0,0,0,0,0,0,0,0,0,0,0,0,0,0,0,0,0,0,0
124879,2023,USA,France,0,1,12,13,9/7/2023,22,0,38,60,0,0,2,2,3,2,4,9,0,0,1,1,6,1,1,8
124879,2023,USA,Argentina,0,2,21,23,8/7/2023,38,0,86,124,1,1,1,3,0,5,2,7,0,0,0,0,10,3,1,14
124879,2023,USA,Cuba,0,2,6,8,6/7/2023,25,0,30,55,1,0,0,1,1,0,1,2,0,1,0,1,2,0,0,2
124879,2023,Poland,USA,1,1,13,15,24/06/2023,16,1,43,60,1,0,1,2,4,4,4,12,0,0,0,0,4,0,3,7
124879,2023,Iran,USA,0,2,8,10,23/06/2023,23,0,32,55,0,0,0,0,2,0,0,2,0,0,0,0,4,2,0,6
124879,2023,USA,China,0,0,1,1,21/06/2023,5,0,2,7,0,0,0,0,0,1,0,1,0,0,0,0,1,0,1,2
124879,2023,USA,Serbia,0,0,10,10,20/06/2023,35,0,47,82,0,1,3,4,0,2,2,4,0,0,0,0,7,5,1,13
124879,2023,USA,Brazil,0,0,0,0,11/6/2023,1,0,0,1,0,0,0,0,0,0,0,0,0,0,0,0,0,0,0,0
124879,2023,Canada,USA,0,0,14,14,11/6/2023,17,1,57,75,0,0,1,1,0,3,1,4,0,0,0,0,3,4,0,7
124879,2023,Italy,USA,1,1,9,11,8/6/2023,16,1,35,52,1,0,2,3,1,2,4,7,0,0,1,1,0,2,1,3
124879,2023,USA,Netherlands,1,0,12,13,7/6/2023,27,0,36,63,1,0,0,1,2,0,2,4,0,0,0,0,8,2,0,10
118901,2023,Poland,USA,0,1,6,7,23/07/2023,0,0,0,0,4,1,3,8,3,2,3,8,0,0,1,1,0,0,1,1
118901,2023,USA,Italy,0,2,10,12,22/07/2023,0,0,4,4,3,1,3,7,1,5,6,12,2,0,0,2,1,2,0,3
118901,2023,USA,France,1,3,9,13,19/07/2023,0,0,1,1,6,1,4,11,2,6,6,14,0,0,2,2,4,0,0,4
118901,2023,USA,Bulgaria,0,0,0,0,10/7/2023,0,0,0,0,0,0,0,0,0,0,0,0,0,0,0,0,0,0,0,0
118901,2023,USA,France,1,1,10,12,9/7/2023,0,0,4,4,4,0,4,8,0,5,7,12,0,0,0,0,0,0,2,2
118901,2023,USA,Argentina,0,5,12,17,8/7/2023,0,0,2,2,11,1,3,15,2,7,5,14,0,0,1,1,1,0,1,2
118901,2023,USA,Cuba,1,2,9,12,6/7/2023,0,0,0,0,4,1,0,5,1,2,3,6,1,0,0,1,1,0,0,1
118901,2023,Poland,USA,1,2,10,13,24/06/2023,0,0,0,0,4,1,0,5,0,2,3,5,0,0,1,1,1,1,0,2
118901,2023,Iran,USA,0,0,0,0,23/06/2023,0,0,0,0,0,0,0,0,0,0,0,0,0,0,0,0,0,0,0,0
118901,2023,USA,China,4,5,15,24,21/06/2023,0,0,0,0,5,0,1,6,1,3,5,9,0,0,1,1,1,1,0,2
118901,2023,USA,Serbia,0,0,0,0,20/06/2023,0,0,0,0,0,0,0,0,0,0,0,0,0,0,0,0,0,0,0,0
118901,2023,USA,Brazil,0,5,11,16,11/6/2023,0,0,1,1,5,1,4,10,0,6,5,11,0,0,0,0,3,1,0,4
118901,2023,Canada,USA,0,0,0,0,11/6/2023,0,0,0,0,0,0,0,0,0,0,0,0,0,0,0,0,0,0,0,0
118901,2023,Italy,USA,1,2,6,9,8/6/2023,0,0,0,0,7,0,1,8,2,1,4,7,0,0,0,0,4,0,0,4
118901,2023,USA,Netherlands,0,0,0,0,7/6/2023,0,0,0,0,0,0,0,0,0,0,0,0,0,0,0,0,0,0,0,0
147421,2023,Poland,USA,0,0,0,0,23/07/2023,3,0,2,5,0,0,1,1,1,1,0,2,0,0,0,0,0,0,0,0
147421,2023,USA,Italy,0,0,0,0,22/07/2023,0,0,0,0,0,0,0,0,0,0,0,0,0,0,0,0,0,0,0,0
147421,2023,USA,France,0,0,3,3,19/07/2023,0,0,0,0,0,0,0,0,0,0,0,0,0,0,0,0,2,0,0,2
147421,2023,USA,Bulgaria,1,5,7,13,10/7/2023,17,1,56,74,2,0,2,4,2,1,4,7,0,0,0,0,5,0,0,5
147421,2023,USA,France,0,0,0,0,9/7/2023,0,0,0,0,0,0,0,0,0,0,0,0,0,0,0,0,0,0,0,0
147421,2023,USA,Argentina,0,0,2,2,8/7/2023,0,0,0,0,0,0,0,0,0,0,0,0,0,0,0,0,0,0,0,0
147421,2023,USA,Cuba,0,0,0,0,6/7/2023,0,0,0,0,0,0,0,0,0,0,0,0,0,0,0,0,0,0,0,0
147421,2023,USA,Brazil,0,2,11,13,11/6/2023,24,1,68,93,3,1,0,4,1,3,3,7,0,0,0,0,6,2,2,10
147421,2023,Canada,USA,0,0,0,0,11/6/2023,0,0,0,0,0,0,0,0,0,0,0,0,0,0,0,0,0,0,0,0
147421,2023,Italy,USA,0,0,0,0,8/6/2023,0,0,1,1,0,0,0,0,0,0,0,0,0,0,0,0,0,0,0,0
147421,2023,USA,Netherlands,0,0,0,0,7/6/2023,0,0,0,0,0,0,0,0,0,0,0,0,0,0,0,0,0,0,0,0
143682,2023,Poland,USA,0,1,10,11,23/07/2023,0,0,2,2,7,3,5,15,2,0,0,2,2,4,8,14,5,5,0,10
143682,2023,USA,Italy,2,2,9,13,22/07/2023,0,0,3,3,12,3,11,26,2,0,2,4,2,2,3,7,10,2,1,13
143682,2023,USA,France,0,4,16,20,19/07/2023,0,1,3,4,14,5,11,30,2,3,0,5,7,1,20,28,9,1,1,11
143682,2023,USA,Bulgaria,0,5,9,14,10/7/2023,0,0,2,2,10,2,13,25,2,0,1,3,3,0,18,21,10,1,1,12
143682,2023,USA,France,0,0,0,0,9/7/2023,0,0,0,0,0,0,0,0,0,0,0,0,0,0,0,0,0,0,0,0
143682,2023,USA,Argentina,2,4,11,17,8/7/2023,0,0,4,4,15,4,18,37,1,2,2,5,11,0,24,35,10,2,1,13
143682,2023,USA,Cuba,0,1,0,1,6/7/2023,0,0,0,0,3,0,0,3,0,0,1,1,0,0,0,0,0,0,0,0
143682,2023,Poland,USA,0,0,0,0,24/06/2023,0,0,0,0,0,0,0,0,0,0,0,0,0,0,0,0,0,0,0,0
143682,2023,Iran,USA,2,2,7,11,23/06/2023,0,0,0,0,7,3,6,16,0,0,1,1,7,1,7,15,1,2,0,3
143682,2023,USA,China,1,3,8,12,21/06/2023,0,0,5,5,12,0,7,19,2,5,1,8,4,1,19,24,5,3,0,8
143682,2023,USA,Serbia,0,0,0,0,20/06/2023,0,0,0,0,0,0,0,0,0,0,0,0,0,0,0,0,0,0,0,0
133463,2023,Poland,USA,0,0,0,0,23/07/2023,0,0,0,0,1,0,2,3,0,0,0,0,1,0,2,3,0,0,0,0
133463,2023,USA,Italy,0,0,0,0,22/07/2023,0,0,0,0,0,0,0,0,0,0,0,0,0,0,0,0,0,0,0,0
133463,2023,USA,France,0,0,6,6,19/07/2023,0,0,2,2,4,1,4,9,0,0,3,3,1,0,6,7,2,1,1,4
133463,2023,USA,Bulgaria,0,2,9,11,10/7/2023,0,0,6,6,13,3,8,24,1,2,0,3,3,0,17,20,4,1,1,6
133463,2023,USA,France,0,0,0,0,9/7/2023,0,0,0,0,0,0,0,0,0,0,0,0,0,0,0,0,2,0,0,2
133463,2023,USA,Argentina,0,0,0,0,8/7/2023,0,0,0,0,0,0,0,0,0,0,0,0,0,0,0,0,0,0,0,0
133463,2023,USA,Cuba,0,0,0,0,6/7/2023,0,0,0,0,0,0,0,0,0,0,0,0,0,0,0,0,0,0,0,0
133463,2023,USA,Brazil,0,0,6,6,11/6/2023,0,0,0,0,3,2,5,10,1,1,0,2,1,1,4,6,3,1,0,4
133463,2023,Canada,USA,0,0,0,0,11/6/2023,0,0,0,0,0,0,0,0,0,0,0,0,0,0,0,0,0,0,0,0
133463,2023,Italy,USA,2,1,15,18,8/6/2023,0,0,1,1,7,1,4,12,0,2,1,3,2,0,13,15,4,0,0,4
133463,2023,USA,Netherlands,0,0,0,0,7/6/2023,0,0,0,0,0,0,0,0,0,0,0,0,0,0,0,0,0,0,0,0
148120,2023,Poland,USA,1,1,2,4,23/07/2023,0,0,0,0,1,0,0,1,0,2,2,4,0,0,0,0,2,0,1,3
148120,2023,USA,Italy,0,0,0,0,22/07/2023,0,0,0,0,0,0,0,0,0,0,0,0,0,0,0,0,0,0,0,0
148120,2023,USA,France,0,2,6,8,19/07/2023,0,0,0,0,5,2,4,11,1,6,3,10,0,0,0,0,1,1,0,2
148120,2023,USA,Bulgaria,1,1,6,8,10/7/2023,0,1,1,2,0,0,1,1,1,1,0,2,0,0,1,1,0,0,0,0
148120,2023,USA,France,1,2,10,13,9/7/2023,0,0,1,1,7,0,1,8,1,3,2,6,0,0,1,1,0,0,0,0
148120,2023,USA,Argentina,0,0,0,0,8/7/2023,0,0,0,0,0,0,0,0,0,0,0,0,0,0,0,0,0,0,0,0
148120,2023,USA,Cuba,0,0,0,0,6/7/2023,0,0,0,0,0,0,0,0,0,0,0,0,0,0,0,0,0,0,0,0
148120,2023,Poland,USA,0,0,0,0,24/06/2023,0,0,0,0,0,0,0,0,0,0,0,0,0,0,0,0,0,0,0,0
148120,2023,Iran,USA,1,2,4,7,23/06/2023,0,0,2,2,10,0,3,13,2,1,2,5,0,0,0,0,1,1,2,4
148120,2023,USA,China,1,4,4,9,21/06/2023,0,0,0,0,9,0,2,11,0,3,2,5,0,0,0,0,1,1,0,2
148120,2023,USA,Serbia,0,0,0,0,20/06/2023,0,0,0,0,0,0,0,0,0,0,0,0,0,0,0,0,0,0,0,0
148120,2023,USA,Brazil,0,3,10,13,11/6/2023,0,0,0,0,6,0,3,9,0,0,4,4,0,0,0,0,3,0,0,3
148120,2023,Canada,USA,0,0,0,0,11/6/2023,0,0,0,0,0,0,0,0,0,0,0,0,0,0,0,0,0,0,0,0
148120,2023,Italy,USA,1,2,11,14,8/6/2023,0,0,1,1,5,0,1,6,2,4,4,10,0,0,0,0,0,0,0,0
148120,2023,USA,Netherlands,0,0,0,0,7/6/2023,0,0,0,0,0,0,0,0,0,0,0,0,0,0,0,0,0,0,0,0
116069,2023,Poland,USA,0,2,14,16,23/07/2023,0,1,0,1,6,0,5,11,0,4,2,6,0,0,1,1,3,1,3,7
116069,2023,USA,Italy,1,1,13,15,22/07/2023,0,0,2,2,3,0,4,7,2,2,6,10,0,0,1,1,3,0,1,4
116069,2023,USA,France,1,0,5,6,19/07/2023,0,0,1,1,2,0,1,3,1,5,2,8,0,0,0,0,0,2,0,2
116069,2023,USA,Bulgaria,0,2,9,11,10/7/2023,0,0,1,1,5,0,1,6,1,3,2,6,1,0,1,2,3,2,0,5
116069,2023,USA,France,0,0,0,0,9/7/2023,0,0,0,0,0,0,0,0,0,0,0,0,0,0,0,0,0,0,0,0
116069,2023,USA,Argentina,0,4,7,11,8/7/2023,0,0,3,3,5,2,4,11,3,7,6,16,0,0,0,0,0,0,2,2
116069,2023,USA,Cuba,1,2,6,9,6/7/2023,0,0,2,2,5,0,1,6,2,0,2,4,0,0,0,0,1,0,0,1
116069,2023,Poland,USA,0,0,0,0,24/06/2023,0,0,0,0,0,0,0,0,0,0,0,0,0,0,0,0,0,0,0,0
116069,2023,Iran,USA,2,3,9,14,23/06/2023,0,0,1,1,1,0,3,4,3,2,2,7,0,0,0,0,2,1,0,3
116069,2023,USA,China,0,0,0,0,21/06/2023,0,0,0,0,0,0,0,0,0,0,0,0,0,0,0,0,0,0,0,0
116069,2023,USA,Serbia,0,4,9,13,20/06/2023,0,0,2,2,3,2,4,9,6,6,8,20,0,0,0,0,6,2,0,8
116069,2023,USA,Brazil,0,0,0,0,11/6/2023,0,0,0,0,0,0,0,0,0,0,0,0,0,0,0,0,0,0,0,0
116069,2023,Canada,USA,1,1,6,8,11/6/2023,0,0,0,0,3,2,2,7,2,3,3,8,0,0,0,0,5,1,0,6
116069,2023,Italy,USA,0,0,0,0,8/6/2023,0,0,0,0,0,0,0,0,0,0,0,0,0,0,0,0,0,0,0,0
116069,2023,USA,Netherlands,0,5,7,12,7/6/2023,0,0,3,3,8,0,1,9,2,1,4,7,0,0,0,0,4,0,0,4
119732,2023,Poland,USA,0,0,0,0,23/07/2023,0,0,4,4,0,0,0,0,0,0,0,0,6,1,13,20,4,4,1,9
119732,2023,USA,Italy,0,0,0,0,22/07/2023,0,0,6,6,0,0,0,0,0,0,0,0,3,0,8,11,10,2,1,13
119732,2023,USA,France,0,0,0,0,19/07/2023,0,0,10,10,0,0,0,0,0,0,0,0,3,3,13,19,10,10,0,20
119732,2023,USA,Bulgaria,0,0,0,0,10/7/2023,0,0,4,4,0,0,0,0,0,0,0,0,2,1,6,9,5,4,0,9
119732,2023,USA,France,0,0,0,0,9/7/2023,0,0,4,4,0,0,0,0,0,0,0,0,4,0,11,15,4,3,3,10
119732,2023,USA,Argentina,0,0,0,0,8/7/2023,0,1,6,7,0,0,0,0,0,0,0,0,10,1,16,27,3,2,2,7
119732,2023,USA,Cuba,0,0,0,0,6/7/2023,0,0,0,0,0,0,0,0,0,0,0,0,7,0,12,19,7,2,2,11
119732,2023,Poland,USA,0,0,0,0,24/06/2023,0,0,8,8,0,0,0,0,0,0,0,0,2,0,10,12,1,1,0,2
119732,2023,Iran,USA,0,0,0,0,23/06/2023,0,0,7,7,0,0,0,0,0,0,0,0,4,0,9,13,6,5,0,11
119732,2023,USA,China,0,0,0,0,21/06/2023,0,0,0,0,0,0,0,0,0,0,0,0,0,0,0,0,0,0,0,0
119732,2023,USA,Serbia,0,0,0,0,20/06/2023,0,0,8,8,0,0,0,0,0,0,0,0,5,1,7,13,8,3,0,11
119732,2023,USA,Brazil,0,0,0,0,11/6/2023,0,0,7,7,0,0,0,0,0,0,0,0,3,0,14,17,3,3,2,8
119732,2023,Canada,USA,0,0,0,0,11/6/2023,0,0,1,1,0,0,0,0,0,0,0,0,4,1,11,16,8,3,2,13
119732,2023,Italy,USA,0,0,0,0,8/6/2023,0,0,3,3,0,0,0,0,0,0,0,0,2,3,8,13,10,2,1,13
119732,2023,USA,Netherlands,0,0,0,0,7/6/2023,0,0,6,6,0,0,0,0,0,0,0,0,2,2,7,11,5,0,0,5
