Player_ID,Year,TeamA,TeamB,Serve_Points,Serve_Errors,Serve_Attempts,Total_Serves,Match_Date,Set_Successes,Set_Errors,Set_Attempts,Total_Sets,Attack_Success,Attack_Errors,Attack_Attempts,Total_Attacks,Block_Successful,Block_Errors,Block_Rebounds,Total_Blocks,Reception_Successful,Reception_Errors,Reception_Attemps,Total_Receptions,Dig_Success,Dig_Errors,Dig_Attempts,Total_Digs
160209,2021,Belgium,Canada,1,1,2,4,20/06/2021,2,0,10,12,0,0,0,0,1,0,1,2,0,0,0,0,1,0,1,2
160209,2021,Belgium,Italy,0,0,0,0,19/06/2021,0,0,0,0,0,0,0,0,0,0,0,0,0,0,0,0,0,0,0,0
160209,2021,Thailand,Belgium,0,0,0,0,18/06/2021,0,0,2,2,0,0,0,0,0,0,0,0,0,0,0,0,0,0,0,0
160209,2021,Belgium,Japan,0,0,0,0,14/06/2021,0,0,0,0,0,0,0,0,0,0,0,0,0,0,0,0,0,0,0,0
160209,2021,Türkiye,Belgium,0,0,0,0,13/06/2021,0,0,0,0,0,0,0,0,0,0,0,0,0,0,0,0,0,0,0,0
160209,2021,USA,Belgium,0,0,0,0,12/6/2021,1,0,2,3,0,0,0,0,0,0,0,0,0,0,0,0,0,0,0,0
160209,2021,Belgium,Serbia,0,0,0,0,8/6/2021,1,0,6,7,0,0,0,0,0,0,0,0,0,0,0,0,0,0,0,0
160209,2021,Belgium,Brazil,0,1,2,3,7/6/2021,3,0,20,23,0,0,0,0,0,0,1,1,0,0,0,0,0,1,0,1
160209,2021,China,Belgium,0,0,6,6,6/6/2021,4,0,12,16,0,0,0,0,2,0,0,2,0,0,0,0,0,1,0,1
160209,2021,Belgium,Poland,0,0,0,0,1/6/2021,0,0,0,0,0,0,0,0,0,0,0,0,0,0,0,0,0,0,0,0
160209,2021,Germany,Belgium,0,0,0,0,27/05/2021,0,0,1,1,0,0,1,1,0,0,0,0,0,0,0,0,0,0,0,0
160209,2021,Netherlands,Belgium,0,0,0,0,25/05/2021,0,0,0,0,0,0,0,0,0,0,0,0,0,0,0,0,0,0,0,0
152042,2021,Belgium,Canada,3,3,8,14,20/06/2021,0,0,2,2,23,3,17,43,0,4,1,5,2,0,10,12,14,1,0,15
152042,2021,Belgium,Italy,0,1,12,13,19/06/2021,0,0,1,1,33,10,24,67,1,4,1,6,6,0,11,17,4,1,1,6
152042,2021,Thailand,Belgium,1,3,11,15,18/06/2021,0,0,2,2,31,5,22,58,1,1,0,2,11,0,17,28,6,6,1,13
152042,2021,Belgium,Japan,0,2,10,12,14/06/2021,0,0,6,6,23,9,36,68,3,3,2,8,7,0,17,24,8,1,1,10
152042,2021,Türkiye,Belgium,0,4,10,14,13/06/2021,0,0,1,1,11,4,25,40,0,1,1,2,7,1,7,15,4,2,1,7
152042,2021,Belgium,Serbia,0,3,11,14,8/6/2021,0,0,4,4,27,7,43,77,1,7,1,9,3,0,4,7,13,4,3,20
152042,2021,Belgium,Brazil,0,0,7,7,7/6/2021,0,0,0,0,12,4,11,27,0,3,0,3,5,0,14,19,2,1,2,5
152042,2021,China,Belgium,1,2,10,13,6/6/2021,0,0,2,2,26,8,33,67,1,3,1,5,2,0,3,5,7,4,2,13
152042,2021,Belgium,Korea,2,1,13,16,2/6/2021,0,0,6,6,26,5,39,70,4,5,10,19,6,1,11,18,6,2,2,10
152042,2021,Belgium,Poland,1,2,13,16,1/6/2021,0,0,5,5,19,8,26,53,0,5,5,10,0,0,3,3,9,3,5,17
152042,2021,Belgium,Dominican Republic,0,2,16,18,31/05/2021,0,0,0,0,32,5,29,66,1,5,5,11,2,0,8,10,14,4,0,18
152042,2021,Germany,Belgium,1,2,6,9,27/05/2021,0,0,2,2,11,4,17,32,0,1,0,1,4,1,9,14,0,0,0,0
152042,2021,Belgium,Russia,2,1,17,20,26/05/2021,0,0,3,3,27,13,28,68,0,4,2,6,6,0,7,13,15,3,2,20
152042,2021,Netherlands,Belgium,0,2,5,7,25/05/2021,0,0,0,0,13,3,20,36,0,2,6,8,10,1,7,18,2,0,1,3
135880,2021,Belgium,Canada,0,0,0,0,20/06/2021,0,0,0,0,0,0,0,0,0,0,0,0,0,0,0,0,0,0,0,0
135880,2021,Belgium,Italy,0,0,3,3,19/06/2021,0,0,1,1,0,0,0,0,0,1,0,1,0,0,0,0,0,0,0,0
135880,2021,Thailand,Belgium,1,0,17,18,18/06/2021,0,0,2,2,1,0,2,3,2,2,3,7,0,0,1,1,3,1,0,4
135880,2021,Belgium,Japan,0,2,4,6,14/06/2021,0,0,0,0,1,1,3,5,1,2,10,13,0,0,0,0,1,0,0,1
135880,2021,Türkiye,Belgium,0,0,0,0,13/06/2021,0,0,0,0,0,0,0,0,0,0,0,0,0,0,0,0,0,0,0,0
135880,2021,USA,Belgium,0,0,5,5,12/6/2021,0,0,0,0,4,0,5,9,2,0,7,9,0,0,0,0,1,0,0,1
135880,2021,Belgium,Serbia,0,0,0,0,8/6/2021,0,0,0,0,0,0,0,0,0,0,1,1,0,0,0,0,0,0,0,0
135880,2021,Belgium,Brazil,0,0,0,0,7/6/2021,0,0,0,0,0,0,0,0,0,0,0,0,0,0,0,0,0,0,0,0
135880,2021,China,Belgium,0,0,0,0,6/6/2021,0,0,0,0,0,0,0,0,0,0,0,0,0,0,0,0,0,0,0,0
135880,2021,Belgium,Korea,0,0,3,3,2/6/2021,0,0,0,0,0,0,2,2,0,3,1,4,0,0,0,0,0,0,0,0
135880,2021,Belgium,Poland,0,0,0,0,1/6/2021,0,0,0,0,0,0,0,0,0,0,0,0,0,0,0,0,0,0,0,0
135880,2021,Belgium,Dominican Republic,0,1,9,10,31/05/2021,0,0,0,0,2,0,3,5,0,5,5,10,0,0,0,0,4,0,0,4
135880,2021,Germany,Belgium,0,0,0,0,27/05/2021,0,0,0,0,0,0,0,0,0,0,0,0,0,0,0,0,0,0,0,0
135880,2021,Belgium,Russia,0,0,12,12,26/05/2021,0,0,0,0,0,0,2,2,1,1,2,4,0,0,0,0,3,0,0,3
156326,2021,Belgium,Canada,0,2,2,4,20/06/2021,0,0,2,2,1,0,3,4,0,2,4,6,1,0,0,1,1,0,0,1
156326,2021,Belgium,Italy,0,1,15,16,19/06/2021,0,0,1,1,6,1,10,17,0,2,0,2,1,0,2,3,4,1,0,5
156326,2021,Thailand,Belgium,0,0,0,0,18/06/2021,0,0,0,0,1,1,1,3,0,0,0,0,1,0,1,2,0,0,0,0
156326,2021,Belgium,Japan,0,0,1,1,14/06/2021,0,0,0,0,0,0,0,0,0,0,0,0,0,0,5,5,0,0,0,0
156326,2021,Türkiye,Belgium,0,2,5,7,13/06/2021,0,0,0,0,1,2,10,13,1,3,0,4,3,2,6,11,4,3,0,7
156326,2021,USA,Belgium,0,0,2,2,12/6/2021,0,0,0,0,0,0,6,6,0,0,0,0,2,0,10,12,2,0,0,2
156326,2021,Belgium,Serbia,2,3,15,20,8/6/2021,0,1,3,4,9,7,21,37,3,2,2,7,3,1,20,24,15,4,2,21
156326,2021,Belgium,Brazil,1,1,5,7,7/6/2021,0,0,1,1,1,1,8,10,0,6,0,6,3,1,13,17,2,2,2,6
156326,2021,China,Belgium,2,1,6,9,6/6/2021,0,0,4,4,2,2,14,18,0,2,5,7,3,0,13,16,12,3,0,15
156326,2021,Belgium,Korea,0,2,15,17,2/6/2021,0,1,3,4,12,3,12,27,0,3,3,6,14,0,10,24,15,3,1,19
156326,2021,Belgium,Poland,0,3,21,24,1/6/2021,0,0,3,3,11,6,13,30,0,8,2,10,6,0,14,20,12,0,2,14
156326,2021,Belgium,Dominican Republic,1,2,14,17,31/05/2021,0,0,0,0,14,6,24,44,3,5,3,11,7,1,3,11,15,5,4,24
156326,2021,Germany,Belgium,0,1,5,6,27/05/2021,0,0,1,1,3,2,6,11,0,0,0,0,6,2,3,11,1,0,0,1
156326,2021,Belgium,Russia,0,1,12,13,26/05/2021,0,0,0,0,7,8,9,24,0,4,5,9,3,1,7,11,5,0,1,6
156326,2021,Netherlands,Belgium,0,2,7,9,25/05/2021,0,0,0,0,5,2,10,17,0,0,2,2,1,1,4,6,1,2,0,3
181274,2021,Belgium,Canada,0,0,0,0,20/06/2021,0,0,0,0,0,0,0,0,0,0,0,0,0,0,0,0,0,0,0,0
181274,2021,Belgium,Italy,0,0,0,0,19/06/2021,0,0,0,0,0,0,0,0,0,0,0,0,0,0,0,0,0,0,0,0
181274,2021,Belgium,Japan,0,0,0,0,14/06/2021,0,0,0,0,0,0,0,0,0,0,0,0,0,0,0,0,0,0,0,0
181274,2021,Türkiye,Belgium,0,0,1,1,13/06/2021,0,0,0,0,0,1,3,4,0,1,0,1,0,0,0,0,0,1,0,1
181274,2021,USA,Belgium,0,1,4,5,12/6/2021,0,0,2,2,4,6,21,31,0,5,3,8,0,1,6,7,6,0,1,7
181274,2021,Belgium,Serbia,0,0,0,0,8/6/2021,0,0,0,0,0,0,3,3,0,0,0,0,0,0,1,1,0,0,0,0
181274,2021,China,Belgium,0,0,0,0,6/6/2021,0,0,0,0,0,1,2,3,0,1,0,1,0,0,1,1,0,0,0,0
181274,2021,Belgium,Korea,0,0,0,0,2/6/2021,0,0,0,0,0,0,0,0,0,0,0,0,0,0,0,0,0,0,0,0
181274,2021,Belgium,Poland,0,0,0,0,1/6/2021,0,0,0,0,2,1,2,5,0,0,0,0,0,0,0,0,0,0,0,0
181274,2021,Belgium,Dominican Republic,0,0,0,0,31/05/2021,0,0,0,0,0,0,0,0,0,0,0,0,0,0,0,0,0,0,0,0
181274,2021,Germany,Belgium,0,2,1,3,27/05/2021,0,0,0,0,1,1,3,5,0,1,0,1,0,0,1,1,0,0,0,0
181274,2021,Belgium,Russia,0,0,0,0,26/05/2021,0,0,0,0,2,1,1,4,0,0,0,0,0,0,0,0,0,0,0,0
181274,2021,Netherlands,Belgium,0,0,0,0,25/05/2021,0,0,0,0,0,0,0,0,0,0,0,0,0,0,0,0,0,0,0,0
151117,2021,Belgium,Canada,2,0,11,13,20/06/2021,0,0,1,1,12,2,12,26,0,1,6,7,5,0,15,20,11,1,1,13
151117,2021,Belgium,Italy,1,2,16,19,19/06/2021,0,0,0,0,9,4,14,27,2,3,0,5,10,0,24,34,7,0,1,8
151117,2021,Thailand,Belgium,2,1,13,16,18/06/2021,0,0,1,1,10,4,22,36,0,2,2,4,16,1,14,31,6,3,0,9
151117,2021,Belgium,Japan,0,2,16,18,14/06/2021,0,0,2,2,11,4,19,34,0,7,7,14,8,1,38,47,8,1,1,10
151117,2021,Türkiye,Belgium,0,1,7,8,13/06/2021,0,0,3,3,3,2,14,19,0,2,0,2,0,0,4,4,1,3,0,4
151117,2021,USA,Belgium,2,0,8,10,12/6/2021,0,0,3,3,4,1,8,13,0,2,1,3,1,0,12,13,8,5,0,13
151117,2021,Belgium,Serbia,1,1,15,17,8/6/2021,0,0,2,2,8,3,23,34,1,4,1,6,14,2,40,56,19,3,3,25
151117,2021,Belgium,Brazil,0,0,7,7,7/6/2021,0,0,1,1,8,4,15,27,1,0,2,3,2,1,9,12,6,4,1,11
151117,2021,China,Belgium,3,0,14,17,6/6/2021,0,0,2,2,11,4,13,28,1,7,7,15,12,0,31,43,11,2,1,14
151117,2021,Belgium,Korea,0,1,17,18,2/6/2021,0,0,3,3,13,8,17,38,2,1,2,5,2,0,7,9,13,3,1,17
151117,2021,Belgium,Poland,1,0,12,13,1/6/2021,0,0,1,1,12,4,16,32,2,2,6,10,11,1,37,49,13,4,1,18
151117,2021,Belgium,Dominican Republic,4,0,18,22,31/05/2021,0,0,0,0,9,4,17,30,0,5,4,9,12,0,20,32,18,4,0,22
151117,2021,Germany,Belgium,1,0,10,11,27/05/2021,0,0,0,0,8,4,10,22,0,1,0,1,5,3,14,22,1,0,0,1
151117,2021,Belgium,Russia,0,1,12,13,26/05/2021,0,0,2,2,9,6,10,25,0,1,3,4,15,1,22,38,15,5,0,20
151117,2021,Netherlands,Belgium,1,2,8,11,25/05/2021,0,0,2,2,4,1,12,17,0,5,2,7,7,1,10,18,3,1,0,4
181275,2021,Belgium,Canada,0,0,0,0,20/06/2021,0,0,0,0,0,0,0,0,0,0,0,0,0,0,0,0,0,0,0,0
181275,2021,Belgium,Italy,0,0,0,0,19/06/2021,0,0,0,0,0,0,0,0,0,0,0,0,0,0,0,0,0,0,0,0
181275,2021,Thailand,Belgium,0,0,0,0,18/06/2021,0,0,0,0,0,0,0,0,0,0,0,0,0,0,0,0,0,0,0,0
181275,2021,Belgium,Japan,0,0,0,0,14/06/2021,0,1,16,17,0,0,0,0,0,0,0,0,5,1,4,10,22,7,4,33
181275,2021,Türkiye,Belgium,0,0,0,0,13/06/2021,0,0,0,0,0,0,0,0,0,0,0,0,0,0,0,0,0,0,0,0
181275,2021,USA,Belgium,0,1,1,2,12/6/2021,0,0,0,0,0,0,0,0,0,0,0,0,1,0,0,1,1,1,0,2
181275,2021,Belgium,Serbia,0,0,0,0,8/6/2021,0,0,0,0,0,0,0,0,0,0,0,0,0,0,0,0,0,1,0,1
181275,2021,Belgium,Brazil,0,0,0,0,7/6/2021,0,0,0,0,0,0,0,0,0,0,0,0,0,0,0,0,0,0,0,0
181275,2021,China,Belgium,0,0,0,0,6/6/2021,0,0,0,0,0,0,0,0,0,0,0,0,0,0,0,0,0,0,0,0
181275,2021,Belgium,Korea,0,0,0,0,2/6/2021,0,0,0,0,0,0,0,0,0,0,0,0,0,0,0,0,0,0,0,0
181275,2021,Belgium,Poland,0,0,0,0,1/6/2021,0,0,0,0,0,0,0,0,0,0,0,0,0,0,0,0,0,0,0,0
181275,2021,Belgium,Dominican Republic,0,0,0,0,31/05/2021,0,0,0,0,0,0,0,0,0,0,0,0,0,0,0,0,0,0,0,0
181275,2021,Germany,Belgium,0,0,0,0,27/05/2021,0,0,0,0,0,0,0,0,0,0,0,0,0,0,0,0,0,0,0,0
181275,2021,Belgium,Russia,0,0,0,0,26/05/2021,0,0,0,0,0,0,0,0,0,0,0,0,0,0,1,1,0,0,0,0
181275,2021,Netherlands,Belgium,0,0,0,0,25/05/2021,0,0,0,0,0,0,0,0,0,0,0,0,0,0,0,0,0,0,0,0
119429,2021,Belgium,Canada,2,0,8,10,20/06/2021,0,0,1,1,1,0,2,3,0,4,6,10,0,0,0,0,5,1,1,7
119429,2021,Belgium,Italy,0,1,4,5,19/06/2021,0,0,0,0,1,0,1,2,1,1,1,3,0,0,0,0,0,1,0,1
119429,2021,Thailand,Belgium,0,0,0,0,18/06/2021,0,0,0,0,0,0,0,0,0,0,0,0,0,0,0,0,0,0,0,0
119429,2021,Belgium,Japan,0,0,2,2,14/06/2021,0,0,0,0,2,0,1,3,1,1,0,2,0,0,0,0,0,1,0,1
119429,2021,Türkiye,Belgium,0,0,1,1,13/06/2021,0,0,2,2,0,0,3,3,4,1,0,5,0,0,1,1,1,0,0,1
119429,2021,USA,Belgium,0,1,2,3,12/6/2021,0,0,0,0,1,1,5,7,0,2,2,4,0,0,0,0,0,0,1,1
119429,2021,Belgium,Serbia,0,0,0,0,8/6/2021,0,0,0,0,0,0,0,0,0,0,0,0,0,0,0,0,0,0,0,0
119429,2021,Belgium,Brazil,0,2,4,6,7/6/2021,0,1,0,1,3,0,1,4,1,2,0,3,0,0,0,0,1,0,1,2
119429,2021,China,Belgium,0,0,0,0,6/6/2021,0,0,0,0,0,1,1,2,0,0,0,0,0,0,0,0,1,0,0,1
119429,2021,Belgium,Korea,0,0,0,0,2/6/2021,0,0,0,0,0,0,0,0,0,0,0,0,0,0,0,0,0,0,0,0
119429,2021,Belgium,Poland,0,0,4,4,1/6/2021,0,0,0,0,1,2,4,7,0,3,4,7,0,1,0,1,2,0,0,2
119429,2021,Belgium,Dominican Republic,0,0,4,4,31/05/2021,0,0,0,0,1,0,5,6,0,5,2,7,0,0,0,0,1,0,0,1
119429,2021,Germany,Belgium,0,0,4,4,27/05/2021,0,0,0,0,2,1,3,6,2,2,0,4,0,0,0,0,2,0,0,2
119429,2021,Belgium,Russia,0,2,3,5,26/05/2021,0,0,0,0,5,2,9,16,6,8,12,26,0,0,0,0,2,0,0,2
119429,2021,Netherlands,Belgium,0,2,3,5,25/05/2021,0,0,0,0,2,1,4,7,0,5,4,9,1,0,0,1,0,0,1,1
152039,2021,Türkiye,Belgium,0,0,0,0,13/06/2021,0,0,0,0,0,0,0,0,0,0,0,0,0,0,0,0,0,0,0,0
152039,2021,USA,Belgium,0,0,0,0,12/6/2021,0,0,0,0,0,0,0,0,0,0,0,0,0,0,1,1,0,0,0,0
156325,2021,Belgium,Canada,2,0,11,13,20/06/2021,0,0,0,0,4,2,5,11,2,4,5,11,0,0,0,0,2,4,1,7
156325,2021,Belgium,Italy,6,2,10,18,19/06/2021,0,0,0,0,9,4,4,17,1,4,2,7,0,0,2,2,2,0,0,2
156325,2021,Thailand,Belgium,2,3,12,17,18/06/2021,1,0,0,1,7,0,12,19,2,3,2,7,0,0,0,0,2,4,0,6
156325,2021,Belgium,Japan,3,4,11,18,14/06/2021,0,0,1,1,11,1,6,18,8,1,5,14,0,0,1,1,3,0,0,3
156325,2021,Türkiye,Belgium,1,1,5,7,13/06/2021,0,0,0,0,2,0,3,5,1,1,2,4,0,0,0,0,1,0,0,1
156325,2021,Belgium,Serbia,2,2,16,20,8/6/2021,0,0,2,2,10,2,10,22,1,4,9,14,0,0,0,0,4,0,3,7
156325,2021,Belgium,Brazil,0,0,7,7,7/6/2021,0,0,0,0,4,1,2,7,1,2,0,3,0,0,0,0,2,3,0,5
156325,2021,China,Belgium,1,2,12,15,6/6/2021,0,0,2,2,7,0,11,18,9,5,6,20,0,0,0,0,1,1,0,2
156325,2021,Belgium,Korea,1,2,11,14,2/6/2021,0,0,0,0,12,2,6,20,1,5,5,11,0,0,0,0,3,1,1,5
156325,2021,Belgium,Poland,3,0,12,15,1/6/2021,0,0,1,1,9,4,6,19,7,3,4,14,0,0,1,1,4,1,0,5
156325,2021,Belgium,Dominican Republic,2,2,15,19,31/05/2021,0,1,0,1,8,1,5,14,5,7,4,16,0,0,0,0,5,0,1,6
156325,2021,Germany,Belgium,0,0,7,7,27/05/2021,0,0,1,1,2,4,3,9,1,0,1,2,0,0,0,0,2,0,0,2
156325,2021,Belgium,Russia,0,0,0,0,26/05/2021,0,0,0,0,0,0,0,0,0,0,0,0,0,0,0,0,0,0,0,0
156325,2021,Netherlands,Belgium,0,2,10,12,25/05/2021,0,0,0,0,10,1,5,16,1,5,2,8,0,0,0,0,3,0,0,3
119420,2021,Thailand,Belgium,0,0,0,0,18/06/2021,0,0,0,0,0,0,0,0,0,0,0,0,0,0,0,0,0,0,0,0
119420,2021,Belgium,Japan,0,0,1,1,14/06/2021,0,0,0,0,0,0,0,0,0,0,0,0,0,0,1,1,0,0,0,0
119420,2021,USA,Belgium,0,0,5,5,12/6/2021,0,0,1,1,3,3,8,14,2,1,2,5,0,0,1,1,1,4,1,6
119420,2021,Belgium,Brazil,0,1,3,4,7/6/2021,0,0,0,0,3,3,3,9,0,0,4,4,0,0,1,1,2,0,0,2
119420,2021,Belgium,Korea,0,0,0,0,2/6/2021,0,0,0,0,0,0,0,0,0,0,0,0,0,0,0,0,0,0,0,0
119420,2021,Belgium,Dominican Republic,0,0,0,0,31/05/2021,0,0,0,0,0,0,0,0,0,0,0,0,0,0,0,0,0,0,0,0
119420,2021,Netherlands,Belgium,0,0,0,0,25/05/2021,0,0,0,0,0,0,0,0,0,0,0,0,0,0,0,0,0,0,0,0
160208,2021,Belgium,Canada,0,0,0,0,20/06/2021,0,0,0,0,0,0,0,0,0,0,0,0,0,0,0,0,0,0,0,0
160208,2021,Belgium,Italy,0,0,1,1,19/06/2021,0,0,2,2,0,0,1,1,0,0,0,0,0,0,0,0,0,0,0,0
160208,2021,Thailand,Belgium,0,0,0,0,18/06/2021,0,0,0,0,0,0,0,0,0,0,0,0,0,0,0,0,0,0,0,0
160208,2021,Belgium,Japan,0,0,1,1,14/06/2021,2,1,7,10,0,0,0,0,0,0,0,0,0,0,0,0,0,0,0,0
160208,2021,USA,Belgium,0,0,0,0,12/6/2021,0,0,0,0,0,0,0,0,0,0,0,0,0,0,0,0,0,0,0,0
160208,2021,Belgium,Serbia,0,0,0,0,8/6/2021,0,0,0,0,0,0,0,0,0,0,0,0,0,0,0,0,0,0,0,0
160208,2021,China,Belgium,0,0,0,0,6/6/2021,0,0,0,0,0,0,0,0,0,0,0,0,0,0,0,0,0,0,0,0
160208,2021,Belgium,Korea,0,0,2,2,2/6/2021,0,1,8,9,0,0,0,0,0,0,0,0,0,0,0,0,1,0,0,1
160208,2021,Belgium,Poland,0,0,0,0,1/6/2021,0,0,0,0,0,0,0,0,0,0,0,0,0,0,0,0,0,0,0,0
160208,2021,Belgium,Dominican Republic,0,0,0,0,31/05/2021,0,0,0,0,0,0,0,0,0,0,0,0,0,0,0,0,0,0,0,0
160208,2021,Germany,Belgium,0,0,0,0,27/05/2021,0,0,0,0,0,0,0,0,0,0,0,0,0,0,0,0,0,0,0,0
160208,2021,Belgium,Russia,0,0,0,0,26/05/2021,0,0,3,3,0,0,0,0,0,0,0,0,0,0,0,0,0,0,1,1
160208,2021,Netherlands,Belgium,0,0,0,0,25/05/2021,0,0,0,0,0,0,0,0,0,0,0,0,0,0,0,0,0,0,0,0
119537,2021,Belgium,Canada,1,0,6,7,20/06/2021,9,0,66,75,0,0,0,0,0,2,3,5,0,0,0,0,4,1,2,7
119537,2021,Belgium,Italy,1,2,13,16,19/06/2021,7,2,123,132,0,0,1,1,2,1,5,8,0,1,0,1,3,5,0,8
119537,2021,Thailand,Belgium,0,1,19,20,18/06/2021,24,1,110,135,0,0,3,3,0,3,1,4,0,0,0,0,9,5,0,14
119537,2021,Belgium,Japan,0,2,12,14,14/06/2021,25,1,85,111,0,0,1,1,0,8,5,13,0,0,1,1,12,2,4,18
119537,2021,Türkiye,Belgium,2,1,10,13,13/06/2021,2,0,77,79,0,0,3,3,0,1,0,1,0,0,0,0,3,3,0,6
119537,2021,USA,Belgium,0,1,11,12,12/6/2021,7,0,66,73,0,1,2,3,0,1,1,2,0,0,0,0,8,2,2,12
119537,2021,Belgium,Serbia,2,1,18,21,8/6/2021,40,1,117,158,0,0,2,2,0,2,9,11,0,0,0,0,19,4,3,26
119537,2021,Belgium,Brazil,0,0,3,3,7/6/2021,11,2,30,43,0,0,1,1,0,0,1,1,0,0,0,0,6,4,0,10
119537,2021,China,Belgium,0,0,17,17,6/6/2021,33,0,87,120,0,0,1,1,0,2,0,2,0,0,0,0,16,3,3,22
119537,2021,Belgium,Korea,0,2,19,21,2/6/2021,22,0,121,143,0,0,0,0,1,9,2,12,0,0,0,0,13,2,2,17
119537,2021,Belgium,Poland,1,0,17,18,1/6/2021,31,0,105,136,0,0,0,0,0,1,4,5,0,0,0,0,9,3,2,14
119537,2021,Belgium,Dominican Republic,4,1,17,22,31/05/2021,22,0,0,22,0,0,3,3,0,5,3,8,0,0,2,2,16,5,0,21
119537,2021,Germany,Belgium,0,1,8,9,27/05/2021,1,0,81,82,0,0,0,0,0,1,1,2,0,0,0,0,0,0,0,0
119537,2021,Belgium,Russia,0,1,13,14,26/05/2021,26,1,120,147,2,0,2,4,0,4,4,8,0,0,0,0,12,1,3,16
119537,2021,Netherlands,Belgium,1,0,10,11,25/05/2021,32,0,59,91,1,0,1,2,1,3,0,4,0,1,0,1,3,1,0,4
168160,2021,Belgium,Canada,0,0,0,0,20/06/2021,0,0,6,6,0,0,0,0,0,0,0,0,4,3,10,17,14,2,2,18
168160,2021,Belgium,Italy,0,0,0,0,19/06/2021,0,0,5,5,0,0,0,0,0,0,0,0,10,3,12,25,12,5,0,17
168160,2021,Thailand,Belgium,0,0,0,0,18/06/2021,0,0,8,8,0,0,0,0,0,0,0,0,14,2,6,22,20,14,1,35
168160,2021,Türkiye,Belgium,0,0,0,0,13/06/2021,0,0,3,3,0,0,0,0,0,0,0,0,13,2,17,32,11,12,0,23
168160,2021,USA,Belgium,0,0,0,0,12/6/2021,0,0,13,13,0,0,0,0,0,0,0,0,6,1,17,24,8,5,2,15
168160,2021,Belgium,Serbia,0,0,0,0,8/6/2021,0,0,17,17,0,0,0,0,0,0,0,0,5,1,4,10,25,9,7,41
168160,2021,Belgium,Brazil,0,0,0,0,7/6/2021,0,0,8,8,0,0,0,0,0,0,0,0,4,0,12,16,7,1,3,11
168160,2021,China,Belgium,0,0,0,0,6/6/2021,0,1,11,12,0,0,0,0,0,0,0,0,10,0,14,24,23,5,5,33
168160,2021,Belgium,Korea,0,0,0,0,2/6/2021,1,0,8,9,0,0,0,0,0,0,0,0,17,2,21,40,19,8,0,27
168160,2021,Belgium,Poland,0,0,0,0,1/6/2021,0,0,10,10,0,0,0,0,0,0,0,0,4,0,9,13,17,5,5,27
168160,2021,Belgium,Dominican Republic,0,0,0,0,31/05/2021,1,1,0,2,0,0,0,0,0,0,0,0,14,2,18,34,11,5,0,16
168160,2021,Germany,Belgium,0,0,0,0,27/05/2021,0,1,2,3,0,0,0,0,0,0,0,0,5,2,10,17,2,0,0,2
168160,2021,Belgium,Russia,0,0,0,0,26/05/2021,0,0,6,6,0,0,0,0,0,0,0,0,10,2,20,32,16,2,2,20
168160,2021,Netherlands,Belgium,0,0,0,0,25/05/2021,0,0,4,4,0,0,0,0,0,0,0,0,11,1,8,20,5,3,0,8
152040,2021,Belgium,Canada,0,0,8,8,20/06/2021,0,0,0,0,4,1,5,10,1,1,0,2,0,1,0,1,1,1,1,3
152040,2021,Belgium,Italy,2,1,12,15,19/06/2021,0,0,0,0,5,2,7,14,0,3,3,6,0,0,0,0,6,1,0,7
152040,2021,Thailand,Belgium,0,3,5,8,18/06/2021,0,0,0,0,20,0,11,31,1,1,0,2,0,0,0,0,9,3,1,13
152040,2021,Belgium,Japan,0,2,13,15,14/06/2021,0,0,0,0,6,1,11,18,1,3,4,8,0,0,0,0,5,3,2,10
152040,2021,Türkiye,Belgium,0,0,5,5,13/06/2021,0,0,0,0,2,0,4,6,0,1,1,2,0,0,0,0,0,0,0,0
152040,2021,USA,Belgium,1,0,7,8,12/6/2021,0,0,0,0,5,2,3,10,1,3,1,5,0,0,0,0,5,0,0,5
152040,2021,Belgium,Serbia,1,1,15,17,8/6/2021,0,0,2,2,11,3,11,25,7,6,8,21,0,0,0,0,6,1,1,8
152040,2021,Belgium,Brazil,1,0,4,5,7/6/2021,0,0,2,2,2,3,1,6,2,0,3,5,0,0,1,1,3,0,0,3
152040,2021,China,Belgium,1,1,19,21,6/6/2021,0,0,3,3,9,0,14,23,4,6,2,12,1,0,0,1,3,1,2,6
152040,2021,Belgium,Korea,1,1,13,15,2/6/2021,0,0,2,2,5,0,10,15,0,5,4,9,1,0,0,1,2,1,2,5
152040,2021,Belgium,Poland,2,1,10,13,1/6/2021,0,0,0,0,7,0,1,8,1,1,2,4,0,1,0,1,5,0,1,6
152040,2021,Belgium,Dominican Republic,0,0,0,0,31/05/2021,0,0,0,0,1,0,0,1,0,1,0,1,0,0,0,0,0,0,0,0
152040,2021,Germany,Belgium,0,2,0,2,27/05/2021,0,0,0,0,3,0,3,6,1,0,0,1,0,0,0,0,1,0,0,1
152040,2021,Belgium,Russia,1,2,8,11,26/05/2021,0,0,1,1,6,2,12,20,1,10,6,17,0,0,0,0,2,1,1,4
152040,2021,Netherlands,Belgium,0,0,1,1,25/05/2021,0,0,0,0,0,0,1,1,0,0,0,0,0,0,0,0,0,0,0,0
152057,2021,Belgium,Canada,0,1,1,2,20/06/2021,0,0,0,0,0,0,0,0,0,0,0,0,0,0,0,0,0,1,0,1
152057,2021,Belgium,Italy,0,1,0,1,19/06/2021,0,0,0,0,0,0,0,0,0,0,0,0,0,0,0,0,0,0,0,0
152057,2021,Thailand,Belgium,0,0,4,4,18/06/2021,0,0,1,1,0,0,0,0,0,0,0,0,0,0,0,0,0,0,0,0
152057,2021,Belgium,Japan,0,1,1,2,14/06/2021,0,0,0,0,0,0,0,0,0,0,0,0,0,0,0,0,1,1,0,2
152057,2021,Türkiye,Belgium,0,0,1,1,13/06/2021,0,0,0,0,0,0,0,0,0,0,0,0,0,0,0,0,0,0,0,0
152057,2021,USA,Belgium,1,1,1,3,12/6/2021,0,0,0,0,0,1,0,1,0,1,1,2,0,0,0,0,0,0,0,0
152057,2021,Belgium,Serbia,0,1,2,3,8/6/2021,0,0,0,0,0,1,1,2,0,0,0,0,0,0,0,0,2,0,0,2
152057,2021,Belgium,Brazil,0,0,0,0,7/6/2021,0,0,0,0,0,0,0,0,0,0,0,0,0,0,1,1,0,0,0,0
152057,2021,China,Belgium,1,0,8,9,6/6/2021,0,0,2,2,0,1,4,5,0,1,0,1,1,0,3,4,3,1,2,6
152057,2021,Belgium,Korea,0,0,0,0,2/6/2021,0,0,0,0,0,0,0,0,0,0,0,0,0,0,0,0,0,0,0,0
152057,2021,Belgium,Poland,0,0,1,1,1/6/2021,0,0,0,0,0,0,0,0,0,0,0,0,0,0,0,0,0,1,0,1
152057,2021,Belgium,Dominican Republic,0,0,3,3,31/05/2021,0,0,0,0,0,0,0,0,0,0,0,0,0,0,0,0,0,0,0,0
152057,2021,Germany,Belgium,0,1,1,2,27/05/2021,0,0,0,0,0,0,0,0,0,0,0,0,0,0,0,0,0,0,0,0
152057,2021,Belgium,Russia,0,1,8,9,26/05/2021,0,0,0,0,1,0,3,4,0,0,0,0,0,0,0,0,4,0,0,4
152057,2021,Netherlands,Belgium,0,1,3,4,25/05/2021,0,0,0,0,0,0,0,0,0,0,0,0,0,0,0,0,0,0,0,0
113245,2021,Brazil,USA,0,0,13,13,25/06/2021,0,0,2,2,9,0,3,12,3,4,7,14,0,0,0,0,3,0,2,5
113245,2021,Brazil,Japan,1,0,18,19,24/06/2021,0,0,3,3,4,1,9,14,3,4,6,13,0,0,0,0,6,0,0,6
113245,2021,Brazil,Türkiye,0,0,13,13,20/06/2021,0,0,3,3,7,2,2,11,0,4,1,5,0,0,1,1,1,0,0,1
113245,2021,Brazil,Netherlands,0,0,12,12,19/06/2021,0,0,5,5,7,0,3,10,0,3,3,6,0,0,1,1,6,0,0,6
113245,2021,Korea,Brazil,2,0,11,13,18/06/2021,0,1,1,2,5,1,2,8,1,1,2,4,0,0,2,2,5,3,0,8
113245,2021,Poland,Brazil,0,2,8,10,12/6/2021,0,0,1,1,4,1,4,9,3,5,3,11,0,0,1,1,3,0,0,3
113245,2021,China,Brazil,1,2,7,10,8/6/2021,0,0,3,3,16,1,7,24,2,7,12,21,0,0,1,1,4,1,0,5
113245,2021,Belgium,Brazil,0,1,5,6,7/6/2021,0,0,3,3,6,1,1,8,0,3,8,11,1,0,2,3,1,2,0,3
113245,2021,Brazil,Serbia,0,1,6,7,6/6/2021,0,0,3,3,1,0,4,5,2,3,2,7,1,0,1,2,3,0,1,4
113245,2021,Brazil,Italy,0,0,0,0,2/6/2021,0,0,0,0,0,0,0,0,0,0,0,0,0,0,0,0,0,0,0,0
113245,2021,Brazil,Russia,1,1,2,4,1/6/2021,0,0,3,3,7,1,5,13,2,4,7,13,1,0,0,1,5,0,0,5
113245,2021,Brazil,Japan,1,0,7,8,31/05/2021,0,0,1,1,2,0,2,4,1,4,0,5,0,0,0,0,3,0,0,3
113245,2021,Brazil,USA,0,1,4,5,27/05/2021,0,0,0,0,3,0,6,9,1,3,4,8,0,0,1,1,1,0,0,1
113245,2021,Brazil,Dominican Republic,0,0,12,12,26/05/2021,0,0,0,0,7,1,6,14,3,3,2,8,0,0,0,0,2,0,0,2
113245,2021,Brazil,Canada,0,0,0,0,25/05/2021,0,0,0,0,0,0,0,0,0,0,0,0,0,0,0,0,0,0,0,0
112625,2021,Brazil,USA,0,1,1,2,25/06/2021,1,0,12,13,0,0,0,0,0,0,0,0,0,0,0,0,0,2,0,2
112625,2021,Brazil,Türkiye,0,1,6,7,20/06/2021,3,0,14,17,0,0,0,0,0,0,0,0,0,0,0,0,3,1,1,5
112625,2021,Korea,Brazil,0,0,1,1,18/06/2021,1,0,3,4,0,0,0,0,0,0,0,0,0,0,0,0,0,0,0,0
112625,2021,Germany,Brazil,0,1,4,5,13/06/2021,0,1,13,14,0,0,0,0,0,0,0,0,0,0,0,0,0,0,0,0
112625,2021,China,Brazil,0,0,6,6,8/6/2021,4,1,14,19,0,0,0,0,0,0,0,0,0,0,0,0,2,0,2,4
112625,2021,Brazil,Serbia,0,2,3,5,6/6/2021,6,0,26,32,0,0,0,0,0,0,2,2,0,1,0,1,5,0,1,6
112625,2021,Brazil,Russia,0,1,1,2,1/6/2021,4,0,9,13,0,0,0,0,0,2,0,2,0,0,0,0,3,0,1,4
112625,2021,Brazil,USA,0,0,4,4,27/05/2021,6,0,17,23,0,0,0,0,0,0,1,1,0,0,0,0,2,0,0,2
112625,2021,Brazil,Canada,0,0,1,1,25/05/2021,0,0,13,13,0,0,0,0,1,1,0,2,0,0,0,0,3,0,0,3
113955,2021,Brazil,Japan,0,0,0,0,24/06/2021,0,0,0,0,0,0,0,0,0,0,0,0,0,0,0,0,0,0,0,0
113955,2021,Brazil,Netherlands,1,0,1,2,19/06/2021,0,0,1,1,1,0,1,2,0,0,1,1,0,0,0,0,0,0,1,1
113955,2021,Korea,Brazil,0,0,2,2,18/06/2021,0,0,0,0,2,0,2,4,1,5,0,6,0,0,0,0,1,1,0,2
113955,2021,Brazil,Thailand,0,0,10,10,14/06/2021,0,0,1,1,4,0,2,6,1,3,1,5,0,0,0,0,1,0,0,1
113955,2021,Germany,Brazil,0,0,0,0,13/06/2021,0,0,0,0,0,0,0,0,0,0,0,0,0,0,0,0,0,0,0,0
113955,2021,Poland,Brazil,0,0,2,2,12/6/2021,0,0,0,0,0,0,1,1,0,2,0,2,0,0,0,0,0,0,0,0
113955,2021,China,Brazil,0,0,0,0,8/6/2021,0,0,0,0,0,0,0,0,0,0,0,0,0,0,0,0,0,0,0,0
113955,2021,Brazil,Serbia,0,0,1,1,6/6/2021,0,0,1,1,3,0,0,3,2,1,2,5,0,0,0,0,1,0,0,1
113955,2021,Brazil,Italy,0,0,0,0,2/6/2021,0,0,0,0,0,0,0,0,0,0,0,0,0,0,0,0,0,0,0,0
113955,2021,Brazil,Japan,0,0,0,0,31/05/2021,0,0,0,0,0,0,0,0,0,0,0,0,0,0,0,0,0,0,0,0
113955,2021,Brazil,USA,1,0,6,7,27/05/2021,0,0,1,1,3,2,4,9,2,5,2,9,0,0,1,1,1,0,0,1
113955,2021,Brazil,Canada,0,0,0,0,25/05/2021,0,0,0,0,0,0,0,0,0,0,0,0,0,0,0,0,0,0,0,0
152135,2021,Brazil,USA,0,0,0,0,25/06/2021,0,0,0,0,0,0,0,0,0,0,0,0,0,0,0,0,0,0,0,0
152135,2021,Brazil,Japan,0,0,0,0,24/06/2021,0,0,0,0,0,0,0,0,0,0,0,0,0,0,0,0,0,0,0,0
152135,2021,Brazil,Türkiye,0,0,0,0,20/06/2021,0,0,0,0,0,0,0,0,0,0,0,0,0,0,0,0,0,0,0,0
152135,2021,Brazil,Netherlands,0,0,0,0,19/06/2021,0,0,0,0,0,0,0,0,0,0,0,0,0,0,0,0,0,0,0,0
152135,2021,Korea,Brazil,0,0,0,0,18/06/2021,0,0,0,0,0,0,0,0,0,0,0,0,0,0,0,0,0,0,0,0
152135,2021,Brazil,Thailand,0,0,0,0,14/06/2021,0,0,0,0,0,0,0,0,0,0,0,0,0,0,2,2,2,0,0,2
152135,2021,Germany,Brazil,0,0,0,0,13/06/2021,0,0,0,0,0,0,0,0,0,0,0,0,0,0,0,0,0,0,0,0
152135,2021,Poland,Brazil,0,0,0,0,12/6/2021,0,0,0,0,0,0,0,0,0,0,0,0,0,0,0,0,0,0,0,0
152135,2021,China,Brazil,0,0,0,0,8/6/2021,0,0,0,0,0,0,0,0,0,0,0,0,0,0,0,0,0,0,0,0
152135,2021,Belgium,Brazil,0,0,0,0,7/6/2021,0,0,0,0,0,0,0,0,0,0,0,0,0,0,0,0,0,0,0,0
152135,2021,Brazil,Serbia,0,0,0,0,6/6/2021,0,0,2,2,0,0,0,0,0,0,0,0,1,0,2,3,3,2,1,6
152135,2021,Brazil,Italy,0,0,0,0,2/6/2021,0,0,0,0,0,0,0,0,0,0,0,0,0,0,0,0,0,0,0,0
152135,2021,Brazil,Russia,0,0,0,0,1/6/2021,0,0,0,0,0,0,0,0,0,0,0,0,0,0,0,0,0,0,0,0
152135,2021,Brazil,Japan,0,0,0,0,31/05/2021,0,0,0,0,0,0,0,0,0,0,0,0,0,0,0,0,0,0,0,0
152135,2021,Brazil,USA,0,0,0,0,27/05/2021,0,0,0,0,0,0,0,0,0,0,0,0,0,0,0,0,0,0,0,0
152135,2021,Brazil,Dominican Republic,0,0,0,0,26/05/2021,0,0,0,0,0,0,0,0,0,0,0,0,0,0,0,0,0,0,0,0
152135,2021,Brazil,Canada,0,0,0,0,25/05/2021,0,0,0,0,0,0,0,0,0,0,0,0,0,0,0,0,0,0,0,0
136897,2021,Brazil,USA,0,0,0,0,25/06/2021,0,0,0,0,2,1,3,6,0,0,1,1,0,0,0,0,0,0,0,0
136897,2021,Brazil,Japan,0,0,0,0,24/06/2021,0,0,0,0,4,0,2,6,1,0,1,2,0,0,0,0,0,0,0,0
136897,2021,Brazil,Türkiye,0,0,0,0,20/06/2021,0,0,0,0,2,2,3,7,0,2,0,2,0,0,0,0,1,0,0,1
136897,2021,Brazil,Netherlands,0,0,0,0,19/06/2021,0,0,0,0,0,0,0,0,0,0,0,0,0,0,0,0,0,0,0,0
136897,2021,Korea,Brazil,0,0,1,1,18/06/2021,0,0,0,0,1,0,0,1,0,0,0,0,0,0,0,0,0,1,0,1
136897,2021,Brazil,Thailand,1,1,5,7,14/06/2021,0,0,0,0,4,0,3,7,0,1,0,1,1,0,1,2,2,0,1,3
136897,2021,Germany,Brazil,0,0,0,0,13/06/2021,0,0,0,0,1,0,4,5,0,0,0,0,0,0,0,0,0,0,0,0
136897,2021,Poland,Brazil,0,0,0,0,12/6/2021,0,0,0,0,3,0,0,3,0,0,1,1,0,0,0,0,0,0,0,0
136897,2021,China,Brazil,0,0,0,0,8/6/2021,0,0,0,0,7,2,4,13,0,1,3,4,0,0,0,0,0,0,2,2
136897,2021,Belgium,Brazil,0,0,1,1,7/6/2021,0,0,0,0,4,0,1,5,0,0,1,1,0,0,0,0,0,0,1,1
136897,2021,Brazil,Serbia,0,0,0,0,6/6/2021,0,0,0,0,0,0,0,0,0,0,0,0,0,0,0,0,0,0,0,0
136897,2021,Brazil,Italy,1,2,11,14,2/6/2021,0,0,1,1,15,2,16,33,1,1,3,5,5,0,12,17,10,5,1,16
136897,2021,Brazil,Russia,0,0,0,0,1/6/2021,0,0,0,0,0,0,0,0,0,0,0,0,0,0,0,0,0,0,0,0
136897,2021,Brazil,Japan,0,0,0,0,31/05/2021,0,0,0,0,3,1,2,6,0,0,1,1,0,0,0,0,0,0,0,0
151187,2021,Brazil,USA,0,0,14,14,25/06/2021,21,2,81,104,0,0,0,0,0,2,3,5,0,1,0,1,10,2,2,14
151187,2021,Brazil,Japan,0,0,13,13,24/06/2021,34,1,75,110,0,0,1,1,1,3,3,7,0,0,0,0,12,2,0,14
151187,2021,Brazil,Türkiye,1,0,11,12,20/06/2021,20,0,75,95,0,0,1,1,0,3,4,7,0,0,0,0,9,0,0,9
151187,2021,Brazil,Netherlands,0,0,10,10,19/06/2021,15,0,73,88,0,0,3,3,0,3,1,4,0,0,1,1,9,4,0,13
151187,2021,Korea,Brazil,1,0,10,11,18/06/2021,26,0,55,81,0,0,1,1,0,3,2,5,0,0,0,0,5,2,1,8
151187,2021,Brazil,Thailand,1,1,6,8,14/06/2021,15,0,38,53,0,0,1,1,0,1,1,2,0,0,0,0,6,0,0,6
151187,2021,Germany,Brazil,0,1,10,11,13/06/2021,20,0,69,89,1,0,0,1,1,0,0,1,0,0,0,0,6,6,2,14
151187,2021,Poland,Brazil,1,0,15,16,12/6/2021,10,1,53,64,0,0,0,0,0,0,2,2,0,0,0,0,4,1,0,5
151187,2021,China,Brazil,0,1,16,17,8/6/2021,45,0,79,124,3,0,3,6,0,1,1,2,0,0,1,1,13,2,1,16
151187,2021,Belgium,Brazil,0,1,11,12,7/6/2021,25,0,39,64,0,0,0,0,1,1,2,4,0,0,0,0,2,0,0,2
151187,2021,Brazil,Serbia,0,0,3,3,6/6/2021,4,0,27,31,0,0,0,0,0,0,1,1,0,0,0,0,4,0,0,4
151187,2021,Brazil,Italy,0,0,2,2,2/6/2021,9,0,21,30,0,0,0,0,0,1,0,1,0,0,0,0,1,1,0,2
151187,2021,Brazil,Russia,1,1,5,7,1/6/2021,32,0,40,72,0,0,1,1,0,2,0,2,0,0,0,0,5,0,1,6
151187,2021,Brazil,Japan,0,0,14,14,31/05/2021,27,0,55,82,1,0,0,1,2,3,1,6,0,0,0,0,6,2,0,8
151187,2021,Brazil,USA,1,1,13,15,27/05/2021,18,1,84,103,0,0,2,2,0,4,2,6,0,1,0,1,11,5,2,18
151187,2021,Brazil,Dominican Republic,0,1,7,8,26/05/2021,12,0,63,75,0,0,2,2,3,1,2,6,0,0,0,0,0,0,0,0
151187,2021,Brazil,Canada,0,0,10,10,25/05/2021,0,1,20,21,0,0,0,0,0,2,0,2,0,0,1,1,1,1,0,2
119575,2021,Brazil,Japan,0,0,2,2,24/06/2021,3,0,11,14,0,0,0,0,0,0,0,0,0,0,0,0,2,0,0,2
119575,2021,Brazil,Netherlands,0,0,2,2,19/06/2021,1,0,2,3,0,0,0,0,0,0,0,0,0,0,0,0,1,0,0,1
119575,2021,Brazil,Thailand,0,0,3,3,14/06/2021,4,0,15,19,0,0,0,0,0,0,0,0,0,0,0,0,2,1,0,3
119575,2021,Poland,Brazil,0,1,4,5,12/6/2021,2,0,15,17,0,0,0,0,0,0,0,0,0,0,0,0,3,0,0,3
119575,2021,Belgium,Brazil,0,0,1,1,7/6/2021,2,0,9,11,0,0,0,0,0,0,0,0,0,0,0,0,1,0,0,1
119575,2021,Brazil,Italy,0,1,10,11,2/6/2021,20,0,63,83,0,0,1,1,0,1,3,4,0,0,1,1,7,3,2,12
119575,2021,Brazil,Japan,0,0,1,1,31/05/2021,1,0,8,9,0,0,0,0,0,0,0,0,0,0,0,0,3,0,0,3
119575,2021,Brazil,Dominican Republic,0,1,4,5,26/05/2021,0,0,14,14,0,0,0,0,0,0,0,0,0,0,0,0,0,0,0,0
136896,2021,Brazil,USA,0,2,22,24,25/06/2021,0,0,0,0,16,6,19,41,2,4,2,8,7,0,8,15,10,4,2,16
136896,2021,Brazil,Japan,1,1,19,21,24/06/2021,0,0,2,2,17,3,11,31,0,3,1,4,11,0,23,34,14,1,3,18
136896,2021,Brazil,Türkiye,1,1,8,10,20/06/2021,0,0,4,4,8,4,14,26,0,0,2,2,4,1,5,10,7,2,3,12
136896,2021,Brazil,Netherlands,1,0,14,15,19/06/2021,0,0,1,1,16,3,8,27,0,0,4,4,6,1,8,15,4,3,0,7
136896,2021,Korea,Brazil,0,0,16,16,18/06/2021,0,0,0,0,8,3,15,26,1,2,3,6,3,0,12,15,9,1,1,11
136896,2021,Brazil,Thailand,0,2,10,12,14/06/2021,0,0,1,1,8,0,8,16,2,0,0,2,12,0,6,18,8,0,0,8
136896,2021,Germany,Brazil,0,1,11,12,13/06/2021,0,0,0,0,19,5,10,34,2,5,2,9,7,2,17,26,8,3,1,12
136896,2021,Poland,Brazil,0,1,11,12,12/6/2021,0,0,0,0,12,3,10,25,3,3,1,7,5,2,9,16,7,2,0,9
136896,2021,China,Brazil,1,1,15,17,8/6/2021,0,0,3,3,15,5,10,30,3,1,3,7,11,0,21,32,21,3,4,28
136896,2021,Belgium,Brazil,2,1,11,14,7/6/2021,0,0,1,1,8,4,9,21,1,0,2,3,5,0,8,13,10,1,3,14
136896,2021,Brazil,Serbia,0,0,13,13,6/6/2021,0,0,0,0,6,2,3,11,0,0,1,1,9,0,6,15,12,0,2,14
136896,2021,Brazil,Italy,1,1,10,12,2/6/2021,0,0,2,2,7,4,11,22,0,1,1,2,12,0,10,22,14,1,2,17
136896,2021,Brazil,Russia,0,0,10,10,1/6/2021,0,0,0,0,1,4,11,16,1,1,2,4,4,1,11,16,16,2,1,19
136896,2021,Brazil,Japan,1,1,15,17,31/05/2021,0,0,3,3,8,5,6,19,1,2,4,7,1,0,5,6,14,1,0,15
136896,2021,Brazil,USA,0,1,14,15,27/05/2021,0,0,2,2,13,8,18,39,2,3,1,6,5,1,7,13,13,1,1,15
136896,2021,Brazil,Dominican Republic,0,3,6,9,26/05/2021,0,0,0,0,12,1,11,24,0,2,1,3,13,1,6,20,2,0,0,2
136896,2021,Brazil,Canada,0,0,16,16,25/05/2021,0,0,0,0,11,5,11,27,4,3,0,7,15,0,10,25,3,3,0,6
115958,2021,Brazil,USA,0,0,12,12,25/06/2021,0,0,2,2,15,7,14,36,2,6,1,9,0,0,1,1,6,3,4,13
115958,2021,Brazil,Japan,0,0,15,15,24/06/2021,0,0,2,2,22,4,21,47,1,3,9,13,0,0,0,0,15,3,2,20
115958,2021,Brazil,Türkiye,1,0,7,8,20/06/2021,0,0,2,2,17,1,18,36,1,3,3,7,0,0,0,0,11,1,0,12
115958,2021,Brazil,Netherlands,0,0,9,9,19/06/2021,0,0,0,0,12,3,10,25,1,5,3,9,0,0,0,0,11,3,3,17
115958,2021,Korea,Brazil,0,1,7,8,18/06/2021,0,0,2,2,13,3,11,27,0,2,3,5,0,0,0,0,7,0,1,8
115958,2021,Brazil,Thailand,2,1,10,13,14/06/2021,0,0,0,0,7,2,7,16,2,1,0,3,0,0,0,0,3,0,0,3
115958,2021,Germany,Brazil,1,0,18,19,13/06/2021,0,1,0,1,12,5,14,31,1,2,1,4,0,0,0,0,6,1,6,13
115958,2021,Poland,Brazil,0,1,7,8,12/6/2021,0,0,2,2,11,8,9,28,3,1,2,6,0,0,0,0,5,1,1,7
115958,2021,China,Brazil,0,0,17,17,8/6/2021,0,0,2,2,22,5,31,58,4,6,3,13,0,0,0,0,9,1,2,12
115958,2021,Belgium,Brazil,0,2,9,11,7/6/2021,0,0,1,1,16,1,7,24,1,3,1,5,0,0,0,0,3,2,2,7
115958,2021,Brazil,Serbia,0,1,10,11,6/6/2021,0,0,1,1,12,1,4,17,0,2,2,4,0,0,0,0,3,1,0,4
115958,2021,Brazil,Italy,0,0,17,17,2/6/2021,0,0,1,1,15,4,15,34,2,2,3,7,0,0,0,0,12,3,1,16
115958,2021,Brazil,Russia,1,1,6,8,1/6/2021,0,0,0,0,11,3,10,24,2,0,1,3,0,0,0,0,3,1,1,5
115958,2021,Brazil,Japan,0,0,13,13,31/05/2021,0,0,1,1,11,3,13,27,3,2,5,10,0,0,0,0,3,1,0,4
115958,2021,Brazil,USA,0,1,8,9,27/05/2021,0,0,2,2,11,4,21,36,2,2,6,10,0,0,0,0,5,1,2,8
115958,2021,Brazil,Dominican Republic,0,1,9,10,26/05/2021,0,0,0,0,14,4,4,22,0,0,0,0,0,0,0,0,4,0,0,4
115958,2021,Brazil,Canada,0,0,13,13,25/05/2021,0,0,0,0,13,4,13,30,0,2,1,3,0,1,0,1,3,3,0,6
115952,2021,Brazil,USA,0,0,7,7,25/06/2021,0,0,1,1,3,2,5,10,0,2,1,3,9,0,16,25,2,0,2,4
115952,2021,Brazil,Japan,0,0,3,3,24/06/2021,0,0,2,2,5,1,6,12,1,3,0,4,6,0,3,9,3,0,2,5
115952,2021,Brazil,Türkiye,0,0,12,12,20/06/2021,0,0,0,0,6,2,6,14,0,1,0,1,4,0,10,14,4,2,2,8
115952,2021,Brazil,Netherlands,0,0,1,1,19/06/2021,0,0,0,0,1,0,3,4,1,1,1,3,0,0,0,0,1,0,0,1
112366,2021,Brazil,Japan,0,0,0,0,24/06/2021,0,0,0,0,0,0,0,0,0,0,0,0,0,0,0,0,0,0,0,0
112366,2021,Brazil,Netherlands,0,1,0,1,19/06/2021,0,0,0,0,2,0,1,3,0,0,0,0,0,0,0,0,0,0,0,0
112366,2021,Korea,Brazil,0,0,0,0,18/06/2021,0,0,0,0,0,0,0,0,0,0,0,0,0,0,0,0,0,0,0,0
112366,2021,Brazil,Thailand,0,0,0,0,14/06/2021,0,0,0,0,0,0,0,0,0,0,0,0,0,0,0,0,0,0,0,0
112366,2021,Poland,Brazil,0,1,0,1,12/6/2021,0,0,0,0,1,0,4,5,0,0,1,1,0,0,0,0,0,0,0,0
112366,2021,Belgium,Brazil,0,0,0,0,7/6/2021,0,0,0,0,0,0,0,0,0,0,0,0,0,0,0,0,0,0,0,0
112366,2021,Brazil,Serbia,2,0,5,7,6/6/2021,0,0,0,0,3,0,3,6,0,1,0,1,0,0,0,0,2,0,0,2
112366,2021,Brazil,Russia,0,0,1,1,1/6/2021,0,0,0,0,3,2,1,6,0,1,1,2,0,0,0,0,1,0,0,1
112366,2021,Brazil,Japan,0,0,0,0,31/05/2021,0,0,0,0,0,0,0,0,0,0,0,0,0,0,0,0,0,0,0,0
112366,2021,Brazil,USA,0,1,0,1,27/05/2021,0,0,0,0,0,0,0,0,0,0,0,0,0,0,0,0,0,0,0,0
112366,2021,Brazil,Dominican Republic,0,0,1,1,26/05/2021,0,0,0,0,2,0,3,5,0,0,0,0,0,0,0,0,0,0,0,0
112366,2021,Brazil,Canada,0,0,0,0,25/05/2021,0,0,0,0,0,0,0,0,0,0,0,0,0,0,0,0,0,0,0,0
144866,2021,Brazil,USA,0,2,12,14,25/06/2021,0,0,2,2,9,3,4,16,8,6,8,22,0,0,0,0,0,1,0,1
144866,2021,Brazil,Japan,0,0,4,4,24/06/2021,0,0,0,0,2,0,1,3,2,1,1,4,0,0,0,0,0,0,0,0
144866,2021,Brazil,Türkiye,0,1,2,3,20/06/2021,0,0,0,0,4,0,1,5,1,4,1,6,0,0,0,0,0,0,0,0
144866,2021,Brazil,Thailand,0,0,4,4,14/06/2021,0,0,1,1,1,0,1,2,2,1,1,4,0,0,0,0,0,0,0,0
144866,2021,Germany,Brazil,0,2,16,18,13/06/2021,0,0,0,0,7,1,4,12,1,6,3,10,0,0,0,0,2,0,0,2
144866,2021,Poland,Brazil,0,1,5,6,12/6/2021,0,0,1,1,2,1,3,6,2,4,0,6,0,0,0,0,0,1,0,1
144866,2021,China,Brazil,0,1,10,11,8/6/2021,0,0,6,6,4,2,3,9,0,7,7,14,0,0,0,0,2,1,1,4
144866,2021,Belgium,Brazil,0,0,7,7,7/6/2021,0,0,1,1,3,0,0,3,2,5,2,9,0,0,0,0,1,0,0,1
144866,2021,Brazil,Serbia,0,2,6,8,6/6/2021,0,0,2,2,1,0,0,1,1,4,1,6,0,0,0,0,2,0,0,2
144866,2021,Brazil,Italy,1,3,16,20,2/6/2021,0,0,5,5,8,2,4,14,5,7,2,14,0,1,0,1,2,2,0,4
144866,2021,Brazil,Russia,6,1,18,25,1/6/2021,0,0,5,5,8,1,7,16,1,2,2,5,0,0,0,0,2,1,0,3
144866,2021,Brazil,Japan,1,1,9,11,31/05/2021,0,0,2,2,4,2,5,11,4,3,4,11,0,0,0,0,1,1,0,2
144866,2021,Brazil,Dominican Republic,0,0,0,0,26/05/2021,0,0,0,0,0,0,0,0,0,0,0,0,0,0,0,0,0,0,0,0
144866,2021,Brazil,Canada,1,1,16,18,25/05/2021,0,0,0,0,6,0,2,8,6,3,0,9,0,0,0,0,0,2,0,2
112641,2021,Brazil,USA,0,1,9,10,25/06/2021,0,0,0,0,6,4,8,18,0,3,1,4,11,1,21,33,6,3,2,11
112641,2021,Brazil,Japan,0,1,10,11,24/06/2021,0,0,0,0,12,3,15,30,1,2,1,4,3,0,7,10,10,1,3,14
112641,2021,Brazil,Türkiye,2,2,7,11,20/06/2021,0,0,2,2,9,1,20,30,2,4,5,11,5,1,5,11,10,0,2,12
112641,2021,Brazil,Netherlands,0,0,8,8,19/06/2021,0,0,1,1,6,2,17,25,0,4,4,8,9,0,12,21,9,3,2,14
112641,2021,Korea,Brazil,1,1,12,14,18/06/2021,0,0,2,2,10,2,9,21,2,0,0,2,4,1,17,22,6,3,2,11
112641,2021,Brazil,Thailand,0,0,6,6,14/06/2021,0,1,0,1,9,0,9,18,1,1,0,2,4,0,2,6,4,1,0,5
112641,2021,Germany,Brazil,0,0,21,21,13/06/2021,0,0,8,8,8,2,10,20,5,4,5,14,8,2,14,24,15,1,2,18
112641,2021,Poland,Brazil,0,2,10,12,12/6/2021,0,0,5,5,4,3,10,17,2,2,6,10,8,1,15,24,8,4,1,13
112641,2021,China,Brazil,0,1,13,14,8/6/2021,0,0,2,2,12,3,20,35,3,7,7,17,9,2,22,33,13,5,1,19
112641,2021,Belgium,Brazil,0,2,13,15,7/6/2021,0,0,1,1,9,3,10,22,0,2,3,5,7,1,10,18,6,2,1,9
112641,2021,Brazil,Serbia,0,1,4,5,6/6/2021,0,0,3,3,10,0,9,19,1,1,2,4,4,0,1,5,6,0,0,6
112641,2021,Brazil,Italy,0,0,0,0,2/6/2021,0,0,0,0,0,0,0,0,0,0,0,0,0,0,0,0,0,0,0,0
112641,2021,Brazil,Russia,0,1,12,13,1/6/2021,0,0,2,2,11,3,11,25,1,1,3,5,6,0,4,10,10,2,2,14
112641,2021,Brazil,Japan,0,1,8,9,31/05/2021,0,0,0,0,21,4,13,38,0,4,6,10,12,1,11,24,7,4,1,12
112641,2021,Brazil,USA,0,1,10,11,27/05/2021,0,0,1,1,17,1,16,34,1,4,1,6,19,3,24,46,11,5,2,18
112641,2021,Brazil,Dominican Republic,2,1,12,15,26/05/2021,0,0,0,0,11,1,9,21,1,1,2,4,6,0,7,13,1,1,1,3
112641,2021,Brazil,Canada,1,0,18,19,25/05/2021,0,0,1,1,10,0,14,24,3,2,1,6,8,0,3,11,5,2,1,8
173849,2021,Brazil,USA,0,0,0,0,25/06/2021,0,0,1,1,0,0,0,0,0,1,0,1,0,0,0,0,0,0,0,0
173849,2021,Brazil,Türkiye,0,1,1,2,20/06/2021,0,0,0,0,2,0,1,3,0,0,0,0,0,0,0,0,1,0,0,1
173849,2021,Korea,Brazil,0,0,2,2,18/06/2021,0,0,0,0,0,0,0,0,0,0,0,0,0,0,0,0,0,1,0,1
173849,2021,Germany,Brazil,0,0,0,0,13/06/2021,0,0,0,0,0,0,0,0,0,0,0,0,0,0,0,0,0,0,0,0
173849,2021,Poland,Brazil,0,0,2,2,12/6/2021,0,0,0,0,0,0,0,0,0,0,0,0,0,0,0,0,0,0,0,0
173849,2021,China,Brazil,0,0,0,0,8/6/2021,0,0,0,0,0,0,0,0,0,0,0,0,0,0,0,0,0,0,0,0
173849,2021,Brazil,Serbia,1,1,2,4,6/6/2021,0,0,0,0,3,1,3,7,1,1,0,2,0,0,3,3,1,1,0,2
173849,2021,Brazil,Italy,0,0,3,3,2/6/2021,0,0,0,0,0,0,5,5,0,0,0,0,2,3,2,7,0,0,1,1
173849,2021,Brazil,USA,0,0,0,0,27/05/2021,0,0,0,0,0,0,0,0,0,0,0,0,0,0,0,0,0,0,0,0
173849,2021,Brazil,Dominican Republic,0,0,0,0,26/05/2021,0,0,0,0,1,0,0,1,0,0,0,0,1,0,0,1,0,0,0,0
173849,2021,Brazil,Canada,0,0,0,0,25/05/2021,0,0,0,0,1,0,0,1,0,0,0,0,0,0,0,0,0,0,0,0
119241,2021,Brazil,USA,0,0,0,0,25/06/2021,0,0,13,13,0,0,0,0,0,0,0,0,4,1,12,17,17,1,1,19
119241,2021,Brazil,Japan,0,0,0,0,24/06/2021,0,0,15,15,0,0,0,0,0,0,0,0,8,4,17,29,10,3,1,14
119241,2021,Brazil,Türkiye,0,0,0,0,20/06/2021,0,0,9,9,0,0,0,0,0,0,0,0,13,2,20,35,21,2,2,25
119241,2021,Brazil,Netherlands,0,0,0,0,19/06/2021,0,0,7,7,0,0,0,0,0,0,0,0,10,0,6,16,12,2,1,15
119241,2021,Korea,Brazil,0,0,0,0,18/06/2021,0,0,3,3,0,0,0,0,0,0,0,0,6,1,11,18,12,1,1,14
119241,2021,Brazil,Thailand,0,0,0,0,14/06/2021,0,0,6,6,0,0,0,0,0,0,0,0,3,0,1,4,8,1,0,9
119241,2021,Germany,Brazil,0,0,0,0,13/06/2021,0,0,8,8,0,0,0,0,0,0,0,0,8,1,13,22,16,5,0,21
119241,2021,Poland,Brazil,0,0,0,0,12/6/2021,0,0,3,3,0,0,0,0,0,0,0,0,4,1,5,10,15,1,5,21
119241,2021,China,Brazil,0,0,0,0,8/6/2021,0,0,12,12,0,0,0,0,0,0,0,0,8,0,18,26,21,5,4,30
119241,2021,Belgium,Brazil,0,0,0,0,7/6/2021,0,0,3,3,0,0,0,0,0,0,0,0,5,1,5,11,16,1,1,18
119241,2021,Brazil,Serbia,0,0,0,0,6/6/2021,0,0,2,2,0,0,0,0,0,0,0,0,1,0,2,3,3,0,0,3
119241,2021,Brazil,Italy,0,0,0,0,2/6/2021,0,0,2,2,0,0,0,0,0,0,0,0,4,1,14,19,14,1,0,15
119241,2021,Brazil,Russia,0,0,0,0,1/6/2021,0,0,4,4,0,0,0,0,0,0,0,0,10,0,10,20,13,2,1,16
119241,2021,Brazil,Japan,0,0,0,0,31/05/2021,0,0,5,5,0,0,0,0,0,0,0,0,13,1,8,22,16,1,2,19
119241,2021,Brazil,USA,0,0,0,0,27/05/2021,0,0,12,12,0,0,0,0,0,0,0,0,9,1,18,28,16,1,2,19
119241,2021,Brazil,Dominican Republic,0,0,0,0,26/05/2021,0,0,2,2,0,0,0,0,0,0,0,0,8,0,5,13,6,1,0,7
119241,2021,Brazil,Canada,0,0,0,0,25/05/2021,0,0,0,0,0,0,0,0,0,0,0,0,4,0,8,12,11,3,0,14
119566,2021,Brazil,USA,0,0,0,0,25/06/2021,0,0,0,0,0,0,0,0,0,0,0,0,0,0,0,0,0,0,0,0
119566,2021,Brazil,Japan,1,2,12,15,24/06/2021,0,0,2,2,3,1,3,7,3,5,4,12,0,0,0,0,5,0,0,5
119566,2021,Brazil,Türkiye,1,1,17,19,20/06/2021,0,0,4,4,5,0,5,10,1,7,4,12,0,0,0,0,5,2,1,8
119566,2021,Brazil,Netherlands,1,0,10,11,19/06/2021,0,0,1,1,3,1,5,9,3,3,6,12,0,0,0,0,4,0,0,4
119566,2021,Korea,Brazil,0,0,6,6,18/06/2021,0,0,2,2,5,3,4,12,3,2,1,6,0,0,0,0,2,0,0,2
119566,2021,Brazil,Thailand,0,0,5,5,14/06/2021,0,0,0,0,4,0,3,7,3,3,1,7,0,0,0,0,0,0,0,0
119566,2021,Germany,Brazil,0,1,8,9,13/06/2021,0,0,2,2,10,1,5,16,2,6,7,15,0,0,1,1,2,0,0,2
119566,2021,China,Brazil,0,1,8,9,8/6/2021,0,0,1,1,2,0,2,4,0,2,7,9,0,0,1,1,2,0,1,3
119566,2021,Belgium,Brazil,0,0,3,3,7/6/2021,0,0,1,1,1,0,1,2,1,1,1,3,1,0,0,1,1,0,0,1
119566,2021,Brazil,Italy,1,2,11,14,2/6/2021,0,0,1,1,6,1,7,14,4,8,1,13,0,0,1,1,2,0,1,3
119566,2021,Brazil,Russia,0,0,0,0,1/6/2021,0,0,0,0,0,0,0,0,0,0,0,0,0,0,0,0,0,0,0,0
119566,2021,Brazil,Japan,0,0,0,0,31/05/2021,0,0,0,0,0,0,0,0,0,0,0,0,0,0,0,0,0,0,0,0
119566,2021,Brazil,USA,0,0,4,4,27/05/2021,0,0,1,1,1,0,2,3,0,3,3,6,0,0,1,1,2,1,0,3
119566,2021,Brazil,Dominican Republic,0,0,0,0,26/05/2021,0,0,0,0,0,0,0,0,0,0,0,0,0,0,0,0,0,0,0,0
119566,2021,Brazil,Canada,1,0,16,17,25/05/2021,0,0,0,0,5,2,7,14,5,1,1,7,0,0,1,1,1,0,0,1
141658,2021,Brazil,Thailand,1,0,4,5,14/06/2021,0,0,0,0,6,0,4,10,0,0,0,0,0,0,0,0,0,0,0,0
141658,2021,Germany,Brazil,0,0,1,1,13/06/2021,0,0,0,0,0,0,0,0,0,0,0,0,0,0,0,0,0,0,0,0
141658,2021,China,Brazil,0,0,4,4,8/6/2021,0,0,0,0,0,0,0,0,0,0,0,0,0,0,0,0,0,0,0,0
141658,2021,Belgium,Brazil,0,0,4,4,7/6/2021,0,0,0,0,0,0,0,0,0,0,0,0,0,0,0,0,1,0,0,1
141658,2021,Brazil,Italy,0,0,0,0,2/6/2021,0,0,0,0,1,0,3,4,0,0,1,1,0,0,0,0,1,0,0,1
141658,2021,Brazil,Russia,0,1,3,4,1/6/2021,0,0,0,0,1,0,0,1,0,0,0,0,0,0,0,0,0,0,1,1
141658,2021,Brazil,Japan,0,0,0,0,31/05/2021,0,0,0,0,0,0,0,0,0,0,0,0,0,0,0,0,0,0,0,0
141658,2021,Brazil,USA,0,0,4,4,27/05/2021,0,0,0,0,2,2,3,7,0,0,0,0,0,0,0,0,0,0,0,0
141658,2021,Brazil,Dominican Republic,0,0,0,0,26/05/2021,0,0,0,0,0,0,0,0,0,0,0,0,0,0,0,0,0,0,0,0
141658,2021,Brazil,Canada,0,0,3,3,25/05/2021,0,0,0,0,3,0,6,9,0,0,0,0,0,0,0,0,0,1,0,1
164673,2021,Brazil,USA,0,0,0,0,25/06/2021,0,0,0,0,0,0,0,0,0,0,0,0,0,0,0,0,0,0,0,0
164673,2021,Brazil,Türkiye,0,0,1,1,20/06/2021,0,0,0,0,3,0,0,3,1,1,3,5,0,0,0,0,0,0,0,0
164673,2021,Brazil,Netherlands,0,0,2,2,19/06/2021,0,0,0,0,1,0,0,1,0,1,1,2,0,0,0,0,0,0,0,0
164673,2021,Korea,Brazil,0,0,0,0,18/06/2021,0,0,0,0,0,0,0,0,0,0,0,0,0,0,0,0,0,0,0,0
164673,2021,Brazil,Thailand,0,1,0,1,14/06/2021,0,0,0,0,0,0,1,1,0,0,0,0,0,0,0,0,0,0,0,0
164673,2021,Germany,Brazil,0,0,0,0,13/06/2021,0,0,0,0,0,0,0,0,0,0,0,0,0,0,0,0,0,0,0,0
164673,2021,Poland,Brazil,0,0,0,0,12/6/2021,0,0,0,0,0,0,0,0,0,0,0,0,0,0,0,0,0,0,0,0
164673,2021,Belgium,Brazil,0,0,0,0,7/6/2021,0,0,0,0,0,0,0,0,0,0,0,0,0,0,0,0,0,0,0,0
164673,2021,Brazil,Serbia,2,0,7,9,6/6/2021,0,0,0,0,2,0,4,6,0,1,3,4,0,0,0,0,1,0,0,1
164673,2021,Brazil,Russia,0,0,0,0,1/6/2021,0,0,0,0,0,0,0,0,0,0,0,0,0,0,0,0,0,0,0,0
164673,2021,Brazil,USA,0,1,6,7,27/05/2021,0,0,2,2,8,0,3,11,1,1,1,3,1,0,2,3,1,0,1,2
164673,2021,Brazil,Dominican Republic,0,3,10,13,26/05/2021,0,0,0,0,2,2,2,6,1,2,0,3,0,0,0,0,0,0,0,0
174677,2021,Belgium,Canada,0,0,0,0,20/06/2021,0,0,6,6,0,0,0,0,0,0,0,0,2,1,6,9,9,2,0,11
174677,2021,Thailand,Canada,0,0,0,0,19/06/2021,0,0,4,4,0,0,0,0,0,0,0,0,2,1,16,19,8,3,1,12
174677,2021,Canada,Italy,0,0,0,0,18/06/2021,0,0,8,8,0,0,0,0,0,0,0,0,2,1,13,16,10,4,1,15
174677,2021,Korea,Canada,0,0,0,0,14/06/2021,1,0,14,15,0,0,0,0,0,0,0,0,1,1,14,16,12,7,2,21
174677,2021,Russia,Canada,0,0,0,0,13/06/2021,0,1,4,5,0,0,0,0,0,0,0,0,0,2,3,5,4,0,1,5
174677,2021,Canada,Serbia,0,0,0,0,12/6/2021,0,0,9,9,0,0,0,0,0,0,0,0,3,0,8,11,13,5,1,19
174677,2021,Canada,Netherlands,0,0,0,0,8/6/2021,0,0,3,3,0,0,0,0,0,0,0,0,1,2,15,18,8,4,0,12
174677,2021,Canada,Japan,0,0,0,0,7/6/2021,0,0,7,7,0,0,0,0,0,0,0,0,4,1,8,13,6,4,1,11
174677,2021,Canada,Poland,0,0,0,0,6/6/2021,0,0,9,9,0,0,0,0,0,0,0,0,6,1,6,13,11,6,1,18
174677,2021,Germany,Canada,0,0,0,0,2/6/2021,0,0,5,5,0,0,0,0,0,0,0,0,9,1,12,22,6,3,2,11
174677,2021,China,Canada,0,0,0,0,1/6/2021,0,0,11,11,0,0,0,0,0,0,0,0,8,2,15,25,12,10,3,25
174677,2021,Canada,Türkiye,0,0,0,0,31/05/2021,0,0,12,12,0,0,0,0,0,0,0,0,5,0,12,17,21,4,5,30
174677,2021,Canada,Dominican Republic,0,0,0,0,27/05/2021,0,0,0,0,0,0,0,0,0,0,0,0,0,0,0,0,0,0,0,0
174677,2021,USA,Canada,0,0,0,0,26/05/2021,0,0,0,0,0,0,0,0,0,0,0,0,0,0,1,1,0,0,0,0
174677,2021,Brazil,Canada,0,0,0,0,25/05/2021,0,1,10,11,0,0,0,0,0,0,0,0,2,1,14,17,3,3,0,6
168355,2021,Belgium,Canada,3,5,4,12,20/06/2021,0,0,2,2,15,2,10,27,0,5,1,6,5,0,8,13,9,2,0,11
168355,2021,Thailand,Canada,0,2,5,7,19/06/2021,0,0,3,3,8,1,14,23,0,2,3,5,2,1,5,8,5,1,1,7
168355,2021,Canada,Italy,0,1,11,12,18/06/2021,0,0,2,2,12,8,16,36,2,1,3,6,1,0,9,10,4,4,6,14
168355,2021,Korea,Canada,2,5,12,19,14/06/2021,0,0,7,7,21,7,19,47,1,7,2,10,3,0,5,8,19,5,5,29
168355,2021,Canada,Serbia,3,6,8,17,12/6/2021,0,0,2,2,17,5,17,39,1,3,5,9,0,0,0,0,9,3,2,14
168355,2021,Canada,Netherlands,0,2,5,7,8/6/2021,0,0,0,0,6,4,7,17,0,1,0,1,1,0,0,1,2,2,0,4
168355,2021,Canada,Japan,1,1,2,4,7/6/2021,0,0,2,2,6,1,7,14,2,3,2,7,0,1,5,6,1,0,2,3
168355,2021,Canada,Poland,2,6,6,14,6/6/2021,0,1,2,3,23,8,21,52,3,4,2,9,0,0,0,0,6,7,0,13
168355,2021,Germany,Canada,2,3,7,12,2/6/2021,0,0,3,3,16,8,11,35,0,2,1,3,0,0,1,1,2,0,1,3
168355,2021,China,Canada,2,4,11,17,1/6/2021,1,0,1,2,18,10,25,53,5,3,4,12,0,0,0,0,7,0,0,7
168355,2021,Canada,Türkiye,2,3,11,16,31/05/2021,0,0,4,4,24,12,24,60,1,2,6,9,4,0,12,16,13,3,3,19
168355,2021,Canada,Dominican Republic,1,2,10,13,27/05/2021,0,0,0,0,20,6,21,47,4,1,1,6,6,3,14,23,12,3,0,15
168355,2021,USA,Canada,0,1,3,4,26/05/2021,0,0,2,2,13,6,7,26,0,1,0,1,0,0,1,1,0,0,0,0
168355,2021,Brazil,Canada,0,3,6,9,25/05/2021,0,0,3,3,12,12,14,38,1,1,0,2,4,0,3,7,3,5,0,8
139517,2021,Belgium,Canada,0,0,0,0,20/06/2021,4,0,8,12,0,0,0,0,0,2,0,2,0,0,0,0,4,0,0,4
139517,2021,Canada,Italy,0,0,0,0,18/06/2021,0,0,0,0,0,0,0,0,0,0,0,0,0,0,0,0,0,0,0,0
139517,2021,Russia,Canada,0,1,1,2,13/06/2021,7,0,28,35,0,0,2,2,0,2,0,2,0,0,0,0,4,0,0,4
139517,2021,Canada,Serbia,0,0,0,0,12/6/2021,0,0,0,0,0,0,0,0,0,0,0,0,0,0,0,0,0,0,0,0
139517,2021,Canada,Poland,0,0,0,0,6/6/2021,1,0,2,3,0,0,0,0,0,0,0,0,0,0,0,0,0,1,0,1
139517,2021,Germany,Canada,0,0,0,0,2/6/2021,0,0,0,0,0,0,0,0,0,0,0,0,0,0,0,0,0,0,0,0
139517,2021,China,Canada,0,0,0,0,1/6/2021,1,0,9,10,0,0,0,0,0,0,0,0,0,0,0,0,0,0,0,0
139517,2021,Canada,Dominican Republic,0,0,0,0,27/05/2021,0,0,0,0,0,0,0,0,0,0,0,0,0,0,0,0,0,0,0,0
139517,2021,USA,Canada,0,0,2,2,26/05/2021,1,1,29,31,0,0,0,0,0,1,1,2,0,0,0,0,1,0,0,1
139517,2021,Brazil,Canada,0,1,0,1,25/05/2021,0,0,0,0,0,0,0,0,0,0,0,0,0,0,0,0,0,0,0,0
153629,2021,Canada,Italy,0,0,0,0,18/06/2021,0,0,0,0,0,0,0,0,0,0,0,0,0,0,0,0,0,0,0,0
153629,2021,Russia,Canada,0,0,4,4,13/06/2021,0,0,1,1,1,0,2,3,0,3,6,9,0,0,0,0,0,0,0,0
153629,2021,Canada,Serbia,0,0,0,0,12/6/2021,0,0,0,0,0,0,0,0,0,0,0,0,0,0,0,0,0,0,0,0
153629,2021,Canada,Netherlands,0,0,0,0,8/6/2021,0,0,0,0,0,0,0,0,0,0,0,0,0,0,0,0,0,0,0,0
153629,2021,Canada,Poland,0,0,0,0,6/6/2021,0,0,0,0,0,0,0,0,0,0,0,0,0,0,0,0,0,0,0,0
153629,2021,Germany,Canada,0,0,0,0,2/6/2021,0,0,0,0,0,0,0,0,0,0,0,0,0,0,0,0,0,0,0,0
153629,2021,Canada,Türkiye,0,0,0,0,31/05/2021,0,0,0,0,0,0,0,0,0,0,0,0,0,0,0,0,0,0,0,0
153629,2021,Canada,Dominican Republic,0,0,0,0,27/05/2021,0,0,0,0,0,0,0,0,0,0,0,0,0,0,0,0,0,0,0,0
153629,2021,USA,Canada,0,0,1,1,26/05/2021,0,0,0,0,0,1,2,3,0,0,0,0,0,0,0,0,0,0,0,0
153629,2021,Brazil,Canada,0,0,1,1,25/05/2021,0,0,0,0,0,0,1,1,0,0,0,0,0,0,0,0,0,0,0,0
163360,2021,Belgium,Canada,0,0,0,0,20/06/2021,0,0,0,0,0,0,0,0,0,0,0,0,0,0,0,0,0,0,0,0
163360,2021,Thailand,Canada,0,0,0,0,19/06/2021,0,0,0,0,0,0,0,0,0,0,0,0,0,0,0,0,0,0,0,0
163360,2021,Korea,Canada,0,0,0,0,14/06/2021,0,0,0,0,0,0,0,0,0,0,0,0,0,0,0,0,0,0,0,0
163360,2021,Russia,Canada,0,1,4,5,13/06/2021,0,0,0,0,3,0,4,7,1,3,6,10,0,0,1,1,1,1,0,2
163360,2021,Canada,Netherlands,0,0,0,0,8/6/2021,0,0,0,0,0,0,0,0,0,0,0,0,0,0,0,0,0,0,0,0
163360,2021,Canada,Japan,0,1,1,2,7/6/2021,0,0,0,0,0,0,2,2,0,0,0,0,0,0,0,0,1,0,0,1
163360,2021,China,Canada,0,0,0,0,1/6/2021,0,0,0,0,0,0,0,0,0,0,0,0,0,0,0,0,0,0,0,0
163360,2021,Brazil,Canada,0,0,0,0,25/05/2021,0,0,0,0,0,0,0,0,0,0,0,0,0,0,0,0,0,0,0,0
142777,2021,Belgium,Canada,0,0,0,0,20/06/2021,0,0,0,0,0,0,0,0,0,0,0,0,0,0,0,0,0,0,0,0
142777,2021,Thailand,Canada,0,0,0,0,19/06/2021,0,0,0,0,0,0,0,0,0,0,0,0,0,0,0,0,0,0,0,0
142777,2021,Canada,Italy,0,0,6,6,18/06/2021,0,0,0,0,1,0,0,1,1,2,4,7,0,0,1,1,2,2,0,4
142777,2021,Korea,Canada,0,0,0,0,14/06/2021,0,0,0,0,0,0,0,0,0,0,0,0,0,0,0,0,0,0,0,0
142777,2021,Russia,Canada,0,1,5,6,13/06/2021,0,0,0,0,4,1,1,6,2,1,0,3,0,0,0,0,1,1,0,2
142777,2021,Canada,Serbia,0,0,0,0,12/6/2021,0,0,0,0,0,0,0,0,0,0,0,0,0,0,0,0,0,0,0,0
142777,2021,Canada,Netherlands,0,0,10,10,8/6/2021,0,0,0,0,2,0,0,2,0,0,0,0,0,0,0,0,1,1,0,2
142777,2021,Canada,Japan,0,0,3,3,7/6/2021,0,0,0,0,2,0,0,2,1,2,0,3,0,0,0,0,0,0,0,0
142777,2021,Canada,Poland,0,0,0,0,6/6/2021,0,0,0,0,0,0,0,0,0,0,0,0,0,0,0,0,0,0,0,0
142777,2021,Germany,Canada,0,0,0,0,2/6/2021,0,0,0,0,0,0,0,0,0,0,0,0,0,0,0,0,0,0,0,0
142777,2021,China,Canada,0,0,0,0,1/6/2021,0,0,0,0,0,0,0,0,0,0,0,0,0,0,0,0,0,0,0,0
142777,2021,Canada,Türkiye,0,0,0,0,31/05/2021,0,0,0,0,0,0,0,0,0,0,0,0,0,0,0,0,0,0,0,0
132236,2021,Belgium,Canada,0,0,0,0,20/06/2021,0,0,0,0,0,0,0,0,0,0,0,0,0,0,1,1,2,0,0,2
132236,2021,Thailand,Canada,0,0,0,0,19/06/2021,0,0,0,0,0,0,0,0,0,0,0,0,1,0,0,1,0,0,0,0
132236,2021,Canada,Italy,0,0,0,0,18/06/2021,0,0,0,0,0,0,0,0,0,0,0,0,0,0,0,0,0,0,0,0
132236,2021,Russia,Canada,0,0,0,0,13/06/2021,0,0,0,0,0,0,0,0,0,0,0,0,0,0,2,2,0,0,0,0
132236,2021,Canada,Serbia,0,0,0,0,12/6/2021,0,0,0,0,0,0,0,0,0,0,0,0,1,2,3,6,0,0,0,0
132236,2021,Germany,Canada,0,0,0,0,2/6/2021,0,0,0,0,0,0,0,0,0,0,0,0,1,0,1,2,1,1,0,2
132236,2021,China,Canada,0,0,0,0,1/6/2021,0,0,0,0,0,0,0,0,0,0,0,0,0,0,2,2,0,1,0,1
132236,2021,Canada,Türkiye,0,0,0,0,31/05/2021,0,0,1,1,0,0,0,0,0,0,0,0,1,0,5,6,2,0,1,3
132236,2021,Canada,Dominican Republic,0,0,0,0,27/05/2021,0,0,16,16,0,0,0,0,0,0,0,0,7,6,16,29,12,4,0,16
132236,2021,USA,Canada,0,0,0,0,26/05/2021,0,0,8,8,0,0,0,0,0,0,0,0,1,1,16,18,3,1,0,4
132236,2021,Brazil,Canada,0,0,0,0,25/05/2021,0,0,0,0,0,0,0,0,0,0,0,0,0,0,0,0,0,0,0,0
173581,2021,Belgium,Canada,0,0,7,7,20/06/2021,0,0,4,4,7,3,13,23,1,1,3,5,5,3,16,24,4,0,0,4
173581,2021,Thailand,Canada,0,0,8,8,19/06/2021,0,0,1,1,2,2,8,12,0,1,0,1,1,1,7,9,2,1,0,3
173581,2021,Canada,Italy,0,0,10,10,18/06/2021,0,0,4,4,12,0,11,23,0,5,1,6,1,1,15,17,4,2,2,8
173581,2021,Korea,Canada,2,1,12,15,14/06/2021,0,0,1,1,16,3,22,41,1,2,4,7,8,4,25,37,7,5,2,14
173581,2021,Russia,Canada,0,0,3,3,13/06/2021,0,0,0,0,3,2,3,8,0,0,1,1,0,3,7,10,2,0,0,2
173581,2021,Canada,Serbia,2,3,14,19,12/6/2021,0,0,1,1,13,2,18,33,0,3,2,5,4,1,21,26,5,1,1,7
173581,2021,Canada,Netherlands,0,1,6,7,8/6/2021,0,1,3,4,8,5,11,24,0,1,0,1,4,1,16,21,2,2,0,4
173581,2021,Canada,Japan,1,2,5,8,7/6/2021,0,0,1,1,3,3,11,17,0,2,3,5,10,2,18,30,5,1,1,7
173581,2021,Canada,Poland,0,2,13,15,6/6/2021,0,0,0,0,13,6,14,33,0,5,0,5,7,2,36,45,1,3,0,4
173581,2021,Germany,Canada,2,1,12,15,2/6/2021,0,0,2,2,7,6,9,22,0,0,2,2,5,1,9,15,6,0,0,6
173581,2021,China,Canada,0,2,10,12,1/6/2021,0,0,1,1,17,4,24,45,0,3,2,5,12,2,20,34,4,3,2,9
173581,2021,Canada,Türkiye,1,2,11,14,31/05/2021,0,0,2,2,12,1,13,26,2,4,5,11,4,0,20,24,3,1,0,4
173581,2021,Canada,Dominican Republic,0,0,4,4,27/05/2021,0,0,1,1,3,3,2,8,1,0,0,1,0,0,5,5,1,1,0,2
173581,2021,USA,Canada,0,0,6,6,26/05/2021,0,0,2,2,3,2,16,21,0,0,2,2,4,1,16,21,2,0,0,2
173581,2021,Brazil,Canada,0,0,5,5,25/05/2021,0,0,0,0,8,6,13,27,0,3,2,5,9,2,24,35,2,0,0,2
139522,2021,Belgium,Canada,0,0,11,11,20/06/2021,0,0,2,2,3,1,4,8,2,4,4,10,0,0,0,0,3,1,1,5
139522,2021,Thailand,Canada,0,0,8,8,19/06/2021,0,0,0,0,6,1,0,7,0,1,9,10,0,0,0,0,2,1,0,3
139522,2021,Canada,Italy,0,0,11,11,18/06/2021,0,0,2,2,5,0,6,11,1,9,8,18,0,0,2,2,2,1,1,4
139522,2021,Korea,Canada,2,1,24,27,14/06/2021,0,0,1,1,4,0,4,8,2,3,2,7,0,0,0,0,2,0,1,3
139522,2021,Russia,Canada,0,0,0,0,13/06/2021,0,0,0,0,0,0,0,0,0,0,0,0,0,0,0,0,0,0,0,0
139522,2021,Canada,Serbia,1,0,19,20,12/6/2021,0,0,1,1,1,0,6,7,4,2,3,9,0,1,3,4,10,2,1,13
139522,2021,Canada,Netherlands,0,0,4,4,8/6/2021,0,0,0,0,1,1,5,7,0,0,1,1,0,0,0,0,0,1,0,1
139522,2021,Canada,Japan,0,1,5,6,7/6/2021,0,0,1,1,1,2,3,6,2,1,3,6,0,0,0,0,4,1,0,5
139522,2021,Canada,Poland,1,1,16,18,6/6/2021,0,0,2,2,4,4,6,14,4,3,4,11,1,1,0,2,5,0,1,6
139522,2021,Germany,Canada,1,0,12,13,2/6/2021,0,0,4,4,7,1,1,9,4,3,4,11,0,0,1,1,5,0,0,5
139522,2021,China,Canada,2,2,14,18,1/6/2021,0,0,0,0,7,3,4,14,4,3,5,12,0,0,1,1,0,0,0,0
139522,2021,Canada,Türkiye,1,1,20,22,31/05/2021,0,0,1,1,4,3,6,13,2,7,9,18,0,2,2,4,3,0,2,5
139522,2021,Canada,Dominican Republic,0,3,14,17,27/05/2021,0,0,1,1,6,2,6,14,1,4,2,7,0,0,0,0,4,0,0,4
139522,2021,USA,Canada,0,1,9,10,26/05/2021,0,0,1,1,1,0,3,4,0,1,0,1,0,0,1,1,0,0,0,0
139522,2021,Brazil,Canada,1,1,14,16,25/05/2021,0,0,1,1,6,2,5,13,1,4,2,7,0,0,0,0,2,2,0,4
173585,2021,Belgium,Canada,1,0,6,7,20/06/2021,19,1,48,68,1,0,3,4,1,1,1,3,0,0,0,0,8,1,1,10
173585,2021,Thailand,Canada,0,1,2,3,19/06/2021,12,0,52,64,0,1,0,1,0,2,2,4,0,0,0,0,2,0,2,4
173585,2021,Canada,Italy,0,0,8,8,18/06/2021,16,0,63,79,1,0,1,2,1,4,1,6,0,0,1,1,4,0,5,9
173585,2021,Korea,Canada,0,0,15,15,14/06/2021,37,1,83,121,1,0,4,5,2,5,2,9,0,0,1,1,7,1,3,11
173585,2021,Canada,Serbia,0,2,6,8,12/6/2021,24,0,86,110,1,0,2,3,2,2,0,4,0,1,0,1,12,6,2,20
173585,2021,Canada,Netherlands,1,0,4,5,8/6/2021,5,0,40,45,0,1,1,2,0,0,1,1,0,0,0,0,0,4,1,5
173585,2021,Canada,Japan,0,0,6,6,7/6/2021,3,1,35,39,0,0,1,1,0,2,0,2,0,0,0,0,3,1,2,6
173585,2021,Canada,Poland,1,1,12,14,6/6/2021,21,3,98,122,1,0,0,1,2,2,1,5,0,1,0,1,7,4,3,14
173585,2021,Germany,Canada,1,0,14,15,2/6/2021,10,2,62,74,3,0,1,4,0,5,1,6,0,0,0,0,12,2,2,16
173585,2021,China,Canada,3,1,13,17,1/6/2021,12,0,116,128,2,1,3,6,1,0,3,4,0,1,0,1,10,6,0,16
173585,2021,Canada,Türkiye,0,1,20,21,31/05/2021,28,0,101,129,3,0,1,4,1,3,3,7,0,0,0,0,15,6,2,23
173585,2021,Canada,Dominican Republic,2,4,11,17,27/05/2021,16,3,101,120,0,0,3,3,1,3,3,7,0,0,0,0,13,2,0,15
173585,2021,USA,Canada,0,1,2,3,26/05/2021,2,1,48,51,0,1,2,3,1,1,1,3,0,0,0,0,4,1,0,5
173585,2021,Brazil,Canada,0,1,5,6,25/05/2021,0,1,44,45,0,0,4,4,1,1,0,2,0,0,0,0,9,3,1,13
174676,2021,Belgium,Canada,0,2,7,9,20/06/2021,0,0,2,2,5,3,15,23,1,3,3,7,2,6,10,18,7,1,1,9
174676,2021,Thailand,Canada,0,3,5,8,19/06/2021,0,0,1,1,8,6,9,23,1,1,1,3,1,1,19,21,4,5,2,11
174676,2021,Canada,Italy,1,1,3,5,18/06/2021,0,0,0,0,1,6,4,11,0,1,0,1,3,2,12,17,3,1,1,5
174676,2021,Korea,Canada,0,3,7,10,14/06/2021,0,0,2,2,15,6,12,33,3,2,1,6,4,2,24,30,13,3,0,16
174676,2021,Russia,Canada,0,1,0,1,13/06/2021,0,0,0,0,4,2,4,10,0,0,0,0,1,1,10,12,1,1,1,3
174676,2021,Canada,Serbia,1,1,9,11,12/6/2021,0,0,1,1,15,5,11,31,1,1,1,3,2,1,26,29,6,3,2,11
174676,2021,Canada,Netherlands,0,2,5,7,8/6/2021,0,0,0,0,8,5,10,23,1,3,0,4,5,1,21,27,4,2,1,7
174676,2021,Canada,Japan,0,2,2,4,7/6/2021,0,0,2,2,4,5,10,19,2,1,0,3,2,2,13,17,7,2,0,9
174676,2021,Canada,Poland,1,3,15,19,6/6/2021,0,0,1,1,9,5,10,24,1,4,0,5,7,3,25,35,3,6,0,9
174676,2021,Germany,Canada,0,2,7,9,2/6/2021,0,0,3,3,4,1,5,10,2,1,3,6,1,1,13,15,1,3,1,5
174676,2021,China,Canada,1,0,20,21,1/6/2021,0,0,3,3,11,2,18,31,2,3,0,5,15,3,15,33,6,3,2,11
174676,2021,Canada,Türkiye,2,1,13,16,31/05/2021,0,0,5,5,11,3,16,30,2,0,4,6,1,1,28,30,10,4,5,19
174676,2021,Canada,Dominican Republic,0,3,10,13,27/05/2021,0,1,2,3,9,3,13,25,1,0,1,2,6,4,23,33,10,5,0,15
174676,2021,USA,Canada,0,0,8,8,26/05/2021,0,0,4,4,4,3,10,17,0,3,0,3,3,2,17,22,0,0,1,1
174676,2021,Brazil,Canada,0,3,6,9,25/05/2021,0,0,0,0,9,7,11,27,0,3,0,3,7,0,22,29,0,5,0,5
166581,2021,Belgium,Canada,0,0,2,2,20/06/2021,0,0,0,0,2,0,2,4,0,1,0,1,0,0,0,0,1,0,0,1
166581,2021,Thailand,Canada,0,1,5,6,19/06/2021,0,0,0,0,1,1,6,8,1,1,1,3,0,0,0,0,2,0,0,2
166581,2021,Canada,Italy,0,0,2,2,18/06/2021,0,0,0,0,6,0,3,9,0,2,1,3,0,0,0,0,2,2,1,5
166581,2021,Korea,Canada,0,0,0,0,14/06/2021,0,0,0,0,0,0,0,0,0,0,0,0,0,0,0,0,0,0,0,0
166581,2021,Russia,Canada,2,1,7,10,13/06/2021,0,1,1,2,8,2,7,17,0,2,2,4,0,0,0,0,4,1,1,6
166581,2021,Canada,Serbia,0,0,0,0,12/6/2021,0,0,0,0,0,0,0,0,0,0,0,0,0,0,0,0,0,0,0,0
166581,2021,Canada,Netherlands,0,0,2,2,8/6/2021,0,0,0,0,4,2,9,15,0,0,2,2,0,0,0,0,3,1,0,4
166581,2021,Canada,Japan,0,1,4,5,7/6/2021,0,0,0,0,6,3,9,18,1,3,4,8,0,0,0,0,3,0,0,3
166581,2021,Canada,Poland,0,0,0,0,6/6/2021,0,0,0,0,0,0,0,0,0,0,0,0,0,0,0,0,0,0,0,0
166581,2021,Germany,Canada,0,0,0,0,2/6/2021,0,0,0,0,0,0,0,0,0,0,0,0,0,0,0,0,0,0,0,0
166581,2021,China,Canada,0,0,0,0,1/6/2021,0,0,0,0,0,0,0,0,0,0,0,0,0,0,0,0,0,0,0,0
166581,2021,Canada,Türkiye,0,2,2,4,31/05/2021,0,0,0,0,2,1,3,6,0,2,0,2,0,0,0,0,1,1,0,2
166581,2021,Canada,Dominican Republic,1,1,8,10,27/05/2021,0,1,1,2,4,2,15,21,1,6,2,9,0,0,0,0,10,1,1,12
166581,2021,USA,Canada,0,0,3,3,26/05/2021,0,0,1,1,4,1,3,8,0,0,0,0,0,0,0,0,1,0,0,1
166581,2021,Brazil,Canada,0,0,4,4,25/05/2021,0,0,0,0,1,2,6,9,0,1,0,1,0,0,0,0,6,2,0,8
174680,2021,Belgium,Canada,0,1,0,1,20/06/2021,0,0,1,1,0,0,0,0,0,0,0,0,0,1,2,3,1,1,0,2
174680,2021,Thailand,Canada,1,1,2,4,19/06/2021,0,0,0,0,0,0,0,0,0,0,0,0,2,0,3,5,1,1,0,2
174680,2021,Canada,Italy,0,0,2,2,18/06/2021,0,0,0,0,0,0,0,0,0,0,0,0,0,0,4,4,1,1,0,2
174680,2021,Korea,Canada,1,0,9,10,14/06/2021,0,0,0,0,0,0,0,0,0,0,0,0,2,0,2,4,0,1,0,1
174680,2021,Russia,Canada,0,3,5,8,13/06/2021,0,0,0,0,6,4,7,17,0,4,0,4,5,2,14,21,2,3,3,8
174680,2021,Canada,Serbia,0,0,2,2,12/6/2021,0,0,0,0,0,0,0,0,0,0,0,0,2,0,1,3,0,0,0,0
174680,2021,Canada,Japan,0,0,0,0,7/6/2021,0,0,0,0,0,0,0,0,0,0,0,0,2,0,3,5,1,0,0,1
174680,2021,Canada,Poland,0,0,0,0,6/6/2021,0,0,0,0,0,0,1,1,0,0,0,0,1,0,0,1,0,0,0,0
174680,2021,Germany,Canada,0,0,0,0,2/6/2021,0,0,0,0,0,0,0,0,0,0,0,0,0,0,0,0,0,0,0,0
174680,2021,China,Canada,0,0,0,0,1/6/2021,0,0,0,0,0,0,0,0,0,0,0,0,0,0,0,0,0,0,0,0
174680,2021,Canada,Türkiye,0,0,0,0,31/05/2021,0,0,0,0,0,0,0,0,0,0,0,0,0,0,0,0,0,0,0,0
174680,2021,Canada,Dominican Republic,0,0,0,0,27/05/2021,0,0,0,0,0,0,0,0,0,0,0,0,0,0,0,0,0,0,0,0
174680,2021,USA,Canada,0,0,4,4,26/05/2021,0,0,0,0,1,2,2,5,0,2,0,2,0,0,1,1,0,0,0,0
174680,2021,Brazil,Canada,0,0,1,1,25/05/2021,0,0,0,0,0,2,2,4,0,0,0,0,2,0,2,4,1,0,0,1
156485,2021,Thailand,Canada,0,1,0,1,19/06/2021,2,0,11,13,0,0,0,0,1,0,0,1,0,0,0,0,0,1,0,1
156485,2021,Korea,Canada,0,0,0,0,14/06/2021,0,0,0,0,0,0,0,0,0,0,0,0,0,0,0,0,0,0,0,0
156485,2021,Russia,Canada,0,0,2,2,13/06/2021,7,1,16,24,0,0,1,1,0,0,0,0,0,0,2,2,1,1,0,2
156485,2021,Canada,Netherlands,0,1,1,2,8/6/2021,3,0,42,45,0,0,1,1,1,0,0,1,0,0,0,0,2,1,0,3
156485,2021,Canada,Japan,0,0,2,2,7/6/2021,4,1,36,41,0,0,0,0,0,1,4,5,0,0,0,0,1,2,1,4
156485,2021,Canada,Türkiye,0,0,0,0,31/05/2021,0,0,0,0,0,0,0,0,0,0,0,0,0,0,0,0,0,0,0,0
156485,2021,Canada,Dominican Republic,0,0,0,0,27/05/2021,0,0,0,0,0,0,0,0,0,0,0,0,0,0,0,0,0,0,0,0
156485,2021,USA,Canada,0,0,0,0,26/05/2021,0,0,0,0,0,0,0,0,0,0,0,0,0,0,0,0,0,0,0,0
168354,2021,Belgium,Canada,0,0,10,10,20/06/2021,0,0,4,4,5,2,7,14,3,5,4,12,0,0,0,0,7,1,0,8
168354,2021,Thailand,Canada,0,0,6,6,19/06/2021,0,0,1,1,11,0,7,18,2,11,6,19,0,0,1,1,4,2,3,9
168354,2021,Canada,Italy,0,1,2,3,18/06/2021,0,0,0,0,3,3,0,6,0,2,4,6,0,0,0,0,0,0,0,0
168354,2021,Korea,Canada,2,3,10,15,14/06/2021,0,0,1,1,8,2,11,21,2,9,6,17,0,0,1,1,5,1,0,6
168354,2021,Canada,Serbia,1,4,14,19,12/6/2021,0,0,3,3,12,1,5,18,4,6,4,14,0,0,0,0,7,3,0,10
168354,2021,Canada,Netherlands,1,0,8,9,8/6/2021,0,0,2,2,4,1,7,12,2,1,2,5,0,0,1,1,2,2,0,4
168354,2021,Canada,Japan,0,2,5,7,7/6/2021,0,0,2,2,3,0,7,10,1,6,3,10,0,0,0,0,0,0,1,1
168354,2021,Canada,Poland,0,1,14,15,6/6/2021,0,0,2,2,9,2,3,14,4,0,2,6,0,0,0,0,3,2,1,6
168354,2021,Germany,Canada,0,0,16,16,2/6/2021,0,0,2,2,7,0,4,11,1,6,4,11,0,0,0,0,4,1,1,6
168354,2021,China,Canada,1,3,11,15,1/6/2021,0,0,2,2,4,2,6,12,2,6,4,12,0,0,1,1,1,1,0,2
168354,2021,Canada,Türkiye,0,2,13,15,31/05/2021,0,0,4,4,8,2,10,20,5,6,10,21,1,0,1,2,3,2,1,6
168354,2021,Canada,Dominican Republic,1,2,11,14,27/05/2021,0,0,0,0,9,1,9,19,2,4,3,9,0,0,1,1,9,2,0,11
168354,2021,USA,Canada,0,0,8,8,26/05/2021,0,0,0,0,3,2,7,12,1,2,4,7,1,0,0,1,1,0,0,1
168354,2021,Brazil,Canada,0,0,8,8,25/05/2021,0,0,0,0,8,4,9,21,2,1,2,5,2,0,2,4,0,1,0,1
181178,2021,Belgium,Canada,0,0,0,0,20/06/2021,0,0,5,5,0,0,0,0,0,0,0,0,0,0,0,0,1,3,1,5
181178,2021,Thailand,Canada,0,0,0,0,19/06/2021,0,0,2,2,0,0,0,0,0,0,0,0,1,1,3,5,2,0,1,3
181178,2021,Canada,Italy,0,0,0,0,18/06/2021,0,0,0,0,0,0,0,0,0,0,0,0,0,0,0,0,0,0,0,0
181178,2021,Korea,Canada,0,0,0,0,14/06/2021,0,0,0,0,0,0,0,0,0,0,0,0,0,0,0,0,0,0,0,0
181178,2021,Russia,Canada,0,0,0,0,13/06/2021,0,0,2,2,0,0,0,0,0,0,0,0,2,1,8,11,2,1,2,5
181178,2021,Canada,Serbia,0,0,0,0,12/6/2021,0,0,0,0,0,0,0,0,0,0,0,0,0,0,0,0,0,0,0,0
181178,2021,Canada,Netherlands,0,0,0,0,8/6/2021,0,0,0,0,0,0,0,0,0,0,0,0,0,0,0,0,0,0,0,0
181178,2021,Canada,Japan,0,0,0,0,7/6/2021,0,0,0,0,0,0,0,0,0,0,0,0,0,0,0,0,0,1,0,1
181178,2021,Canada,Poland,0,0,0,0,6/6/2021,0,0,0,0,0,0,0,0,0,0,0,0,0,0,0,0,0,0,0,0
181178,2021,Germany,Canada,0,0,0,0,2/6/2021,0,0,0,0,0,0,0,0,0,0,0,0,0,0,0,0,0,0,0,0
181178,2021,China,Canada,0,0,0,0,1/6/2021,0,0,0,0,0,0,0,0,0,0,0,0,0,0,0,0,0,0,0,0
181178,2021,Canada,Türkiye,0,0,0,0,31/05/2021,0,0,0,0,0,0,0,0,0,0,0,0,0,0,0,0,0,0,0,0
181177,2021,Korea,Canada,0,0,0,0,14/06/2021,0,0,0,0,0,0,0,0,0,0,0,0,0,0,0,0,0,0,0,0
181177,2021,Russia,Canada,0,0,1,1,13/06/2021,0,0,0,0,0,2,1,3,0,0,1,1,0,1,2,3,1,0,0,1
181177,2021,Canada,Netherlands,0,0,0,0,8/6/2021,0,0,0,0,0,0,0,0,0,0,0,0,0,0,0,0,0,0,0,0
181177,2021,Canada,Japan,0,0,0,0,7/6/2021,0,0,0,0,0,0,0,0,0,0,0,0,0,0,0,0,0,0,0,0
181177,2021,Canada,Poland,0,0,0,0,6/6/2021,0,0,0,0,0,0,0,0,0,0,0,0,0,0,1,1,0,0,0,0
181177,2021,Canada,Dominican Republic,0,0,0,0,27/05/2021,0,0,0,0,0,0,0,0,0,0,0,0,0,0,0,0,0,0,0,0
181177,2021,USA,Canada,0,1,0,1,26/05/2021,0,0,0,0,0,0,0,0,0,0,0,0,0,0,1,1,0,0,0,0
181177,2021,Brazil,Canada,0,0,0,0,25/05/2021,0,0,0,0,0,0,0,0,0,0,0,0,0,0,0,0,0,0,0,0
135746,2021,China,USA,0,2,6,8,20/06/2021,0,0,0,0,5,0,6,11,2,2,5,9,0,0,0,0,2,1,0,3
135746,2021,China,Poland,2,1,6,9,19/06/2021,0,0,0,0,8,0,3,11,2,5,7,14,0,0,0,0,2,2,1,5
135746,2021,China,Russia,0,0,17,17,18/06/2021,0,0,7,7,4,0,6,10,2,6,3,11,3,0,5,8,2,2,0,4
135746,2021,China,Italy,3,1,13,17,14/06/2021,0,0,1,1,7,0,6,13,1,2,3,6,0,0,0,0,0,0,0,0
135746,2021,Dominican Republic,China,1,0,24,25,13/06/2021,0,0,1,1,6,1,9,16,4,11,4,19,0,0,0,0,2,0,0,2
135746,2021,China,Netherlands,1,2,13,16,12/6/2021,0,0,4,4,11,1,7,19,2,2,3,7,0,0,0,0,3,1,0,4
133588,2021,China,USA,2,0,13,15,20/06/2021,0,0,2,2,13,1,4,18,1,1,1,3,1,0,3,4,2,4,0,6
133588,2021,China,Poland,0,0,0,0,19/06/2021,0,0,0,0,0,0,0,0,0,0,0,0,0,0,0,0,0,0,0,0
133588,2021,China,Russia,0,0,10,10,18/06/2021,0,1,6,7,14,0,15,29,1,2,1,4,3,1,6,10,4,2,1,7
133588,2021,China,Italy,0,0,0,0,14/06/2021,0,0,0,0,0,0,0,0,0,0,0,0,0,0,0,0,0,0,0,0
133588,2021,Dominican Republic,China,0,0,14,14,13/06/2021,0,0,2,2,14,1,14,29,2,5,2,9,3,0,6,9,7,1,1,9
133588,2021,China,Netherlands,0,0,5,5,12/6/2021,0,0,8,8,10,1,7,18,0,1,1,2,0,0,2,2,9,2,0,11
152337,2021,China,USA,0,0,0,0,20/06/2021,0,0,0,0,0,0,0,0,0,0,0,0,0,0,0,0,0,0,0,0
152337,2021,China,Poland,0,0,0,0,19/06/2021,0,0,0,0,0,0,0,0,0,0,0,0,0,0,0,0,0,0,0,0
152337,2021,China,Russia,0,0,0,0,18/06/2021,0,0,0,0,0,0,0,0,0,0,0,0,0,0,0,0,0,0,0,0
152337,2021,Dominican Republic,China,0,0,1,1,13/06/2021,0,0,0,0,0,0,1,1,0,2,1,3,0,0,0,0,0,1,0,1
152337,2021,China,Netherlands,0,0,0,0,12/6/2021,0,0,0,0,0,0,0,0,0,0,0,0,0,0,0,0,0,0,0,0
152337,2021,China,Brazil,0,0,15,15,8/6/2021,0,0,3,3,13,1,7,21,1,5,9,15,0,0,0,0,0,2,0,2
152337,2021,China,Serbia,0,1,14,15,7/6/2021,0,0,0,0,7,0,4,11,5,1,0,6,0,0,0,0,0,1,0,1
152337,2021,China,Belgium,0,1,9,10,6/6/2021,0,1,2,3,12,7,5,24,3,8,5,16,1,0,0,1,2,0,0,2
152337,2021,China,Türkiye,0,0,6,6,2/6/2021,0,0,1,1,1,2,0,3,0,2,1,3,0,0,0,0,1,0,0,1
152337,2021,China,Canada,1,2,8,11,1/6/2021,1,0,1,2,3,1,8,12,1,5,2,8,0,0,0,0,0,0,0,0
152337,2021,China,Germany,0,2,14,16,31/05/2021,0,0,0,0,10,2,5,17,4,7,1,12,1,0,1,2,1,1,0,2
152337,2021,China,Thailand,0,2,7,9,27/05/2021,0,0,1,1,5,0,2,7,3,3,4,10,0,0,0,0,1,1,0,2
152337,2021,China,Japan,0,0,5,5,26/05/2021,0,0,0,0,2,0,5,7,3,4,0,7,0,0,0,0,0,0,0,0
152337,2021,China,Korea,1,3,7,11,25/05/2021,0,0,2,2,5,2,10,17,2,3,3,8,1,0,0,1,1,0,0,1
143206,2021,China,USA,1,1,13,15,20/06/2021,0,0,4,4,11,1,5,17,0,2,1,3,10,0,7,17,4,4,0,8
143206,2021,China,Poland,0,1,14,15,19/06/2021,0,0,1,1,10,2,7,19,1,3,1,5,2,1,5,8,9,2,0,11
143206,2021,China,Russia,0,0,10,10,18/06/2021,0,1,2,3,11,0,6,17,2,2,3,7,1,0,6,7,12,2,4,18
143206,2021,China,Italy,1,1,7,9,14/06/2021,0,0,1,1,9,1,5,15,0,0,0,0,3,1,8,12,12,3,1,16
143206,2021,Dominican Republic,China,0,2,11,13,13/06/2021,0,0,1,1,9,6,13,28,1,1,4,6,4,1,6,11,9,4,2,15
143206,2021,China,Netherlands,1,0,19,20,12/6/2021,0,0,2,2,15,6,16,37,1,3,1,5,5,0,8,13,12,4,1,17
143201,2021,China,USA,0,0,0,0,20/06/2021,0,0,0,0,0,0,0,0,0,0,0,0,0,0,0,0,0,0,0,0
143201,2021,China,Poland,1,0,12,13,19/06/2021,0,0,2,2,3,0,3,6,2,2,8,12,0,0,0,0,0,1,1,2
143201,2021,China,Russia,0,0,0,0,18/06/2021,0,0,0,0,0,0,0,0,0,0,0,0,0,0,0,0,0,0,0,0
143201,2021,China,Italy,0,0,0,0,14/06/2021,0,0,0,0,0,0,0,0,0,0,0,0,0,0,0,0,0,0,0,0
143201,2021,Dominican Republic,China,0,0,0,0,13/06/2021,0,0,0,0,0,0,0,0,0,0,0,0,0,0,0,0,0,0,0,0
143201,2021,China,Netherlands,0,0,0,0,12/6/2021,0,0,0,0,0,0,0,0,0,0,0,0,0,0,0,0,0,0,0,0
143201,2021,China,Brazil,0,1,15,16,8/6/2021,0,0,3,3,8,1,10,19,3,5,8,16,0,0,0,0,3,2,0,5
143201,2021,China,Serbia,0,0,8,8,7/6/2021,0,0,1,1,7,2,3,12,2,2,1,5,0,0,0,0,0,0,0,0
143201,2021,China,Belgium,0,1,17,18,6/6/2021,0,0,5,5,14,1,5,20,1,8,3,12,0,1,0,1,4,0,0,4
143201,2021,China,Türkiye,1,1,4,6,2/6/2021,0,0,1,1,2,2,6,10,0,2,4,6,0,0,0,0,1,0,0,1
143201,2021,China,Canada,1,0,11,12,1/6/2021,0,0,0,0,8,1,8,17,0,4,0,4,0,0,0,0,1,1,0,2
143201,2021,China,Germany,0,1,6,7,31/05/2021,0,0,0,0,2,0,2,4,0,1,0,1,0,0,0,0,0,2,0,2
143201,2021,China,Thailand,1,0,10,11,27/05/2021,0,0,0,0,10,2,5,17,3,5,8,16,0,0,1,1,3,0,1,4
143201,2021,China,Japan,0,1,6,7,26/05/2021,0,0,1,1,6,0,8,14,1,0,0,1,0,1,0,1,1,0,0,1
143201,2021,China,Korea,0,2,6,8,25/05/2021,0,0,0,0,2,0,5,7,1,4,2,7,0,0,0,0,1,0,0,1
152486,2021,China,USA,0,0,0,0,20/06/2021,0,0,0,0,0,0,0,0,0,0,0,0,0,0,0,0,0,0,0,0
152486,2021,China,Poland,0,1,0,1,19/06/2021,0,0,0,0,1,0,2,3,0,0,0,0,0,0,2,2,0,0,0,0
152486,2021,China,Italy,0,0,0,0,14/06/2021,0,0,0,0,0,0,0,0,0,0,0,0,0,0,0,0,0,0,0,0
152486,2021,Dominican Republic,China,0,0,0,0,13/06/2021,0,0,0,0,0,0,0,0,0,0,0,0,0,0,0,0,0,0,0,0
152486,2021,China,Netherlands,0,0,0,0,12/6/2021,0,0,0,0,0,0,1,1,0,0,0,0,0,0,0,0,0,0,0,0
152486,2021,China,Brazil,0,0,16,16,8/6/2021,0,0,4,4,4,3,15,22,0,6,3,9,5,0,14,19,9,8,7,24
152486,2021,China,Serbia,1,0,11,12,7/6/2021,0,0,1,1,8,4,15,27,4,2,2,8,3,2,12,17,2,2,1,5
152486,2021,China,Belgium,0,3,9,12,6/6/2021,0,0,6,6,12,7,22,41,0,5,2,7,5,3,6,14,16,1,2,19
152486,2021,China,Türkiye,0,1,6,7,2/6/2021,0,0,2,2,6,5,15,26,1,2,3,6,4,0,5,9,9,2,0,11
152486,2021,China,Canada,0,0,10,10,1/6/2021,0,0,3,3,9,4,15,28,0,2,3,5,0,0,1,1,6,2,0,8
152486,2021,China,Germany,0,3,10,13,31/05/2021,0,0,0,0,9,4,20,33,2,1,0,3,1,0,0,1,3,2,0,5
152486,2021,China,Thailand,2,0,15,17,27/05/2021,0,0,1,1,9,1,11,21,1,3,1,5,2,0,0,2,9,4,2,15
152486,2021,China,Japan,0,0,7,7,26/05/2021,0,1,0,1,5,2,9,16,1,3,0,4,0,0,1,1,2,0,0,2
152486,2021,China,Korea,2,2,17,21,25/05/2021,0,0,1,1,10,1,10,21,2,6,3,11,0,0,1,1,8,2,0,10
131973,2021,China,USA,1,1,8,10,20/06/2021,0,0,0,0,10,2,11,23,2,0,0,2,4,1,5,10,3,2,0,5
131973,2021,China,Poland,0,0,14,14,19/06/2021,0,0,2,2,18,2,4,24,3,3,4,10,6,0,9,15,5,2,0,7
131973,2021,China,Russia,0,0,0,0,18/06/2021,0,0,0,0,0,0,0,0,0,0,0,0,0,0,0,0,0,0,0,0
131973,2021,China,Italy,0,2,14,16,14/06/2021,0,0,2,2,9,0,17,26,2,1,1,4,10,0,7,17,4,2,0,6
131973,2021,Dominican Republic,China,2,0,6,8,13/06/2021,0,0,3,3,11,2,7,20,1,0,3,4,5,0,6,11,9,1,0,10
131973,2021,China,Netherlands,0,0,5,5,12/6/2021,0,0,1,1,7,1,5,13,0,0,1,1,8,1,5,14,5,4,1,10
131973,2021,China,Brazil,2,0,15,17,8/6/2021,0,0,4,4,32,4,24,60,2,4,3,9,5,1,10,16,10,2,5,17
131973,2021,China,Serbia,0,0,0,0,7/6/2021,0,0,0,0,0,0,0,0,0,0,0,0,0,0,0,0,0,0,0,0
131973,2021,China,Belgium,0,1,21,22,6/6/2021,0,0,6,6,35,9,33,77,2,6,5,13,1,1,12,14,9,1,3,13
131973,2021,China,Türkiye,0,0,0,0,2/6/2021,0,0,0,0,0,0,0,0,0,0,0,0,0,0,0,0,0,0,0,0
131973,2021,China,Canada,2,1,15,18,1/6/2021,0,0,1,1,18,10,21,49,2,2,0,4,9,1,12,22,8,2,2,12
131973,2021,China,Germany,2,1,16,19,31/05/2021,0,0,0,0,16,8,22,46,5,2,3,10,6,1,17,24,11,4,1,16
131973,2021,China,Thailand,1,2,6,9,27/05/2021,0,0,0,0,15,3,7,25,2,2,0,4,9,1,7,17,3,1,2,6
131973,2021,China,Japan,0,0,0,0,26/05/2021,0,0,0,0,0,2,4,6,0,0,0,0,0,0,0,0,0,0,0,0
131973,2021,China,Korea,1,2,11,14,25/05/2021,0,0,1,1,16,8,19,43,6,3,3,12,9,0,8,17,14,0,1,15
124132,2021,China,Poland,0,0,0,0,19/06/2021,0,0,0,0,0,0,0,0,0,0,0,0,0,0,0,0,0,0,0,0
124132,2021,China,Russia,0,0,0,0,18/06/2021,0,0,0,0,0,0,0,0,0,0,0,0,0,0,0,0,0,0,0,0
124132,2021,China,Italy,0,0,0,0,14/06/2021,0,0,0,0,0,0,0,0,0,0,0,0,0,0,0,0,0,0,0,0
124132,2021,China,Netherlands,0,0,0,0,12/6/2021,0,0,0,0,0,0,0,0,0,0,0,0,0,0,0,0,0,0,0,0
124132,2021,China,Brazil,0,0,12,12,8/6/2021,0,0,6,6,8,6,21,35,1,6,1,8,7,1,29,37,15,2,2,19
124132,2021,China,Serbia,0,1,11,12,7/6/2021,0,0,2,2,12,4,17,33,0,0,3,3,15,1,19,35,4,1,0,5
124132,2021,China,Belgium,0,1,3,4,6/6/2021,0,0,2,2,1,2,6,9,0,1,0,1,3,1,11,15,6,0,0,6
124132,2021,China,Türkiye,0,0,0,0,2/6/2021,0,0,0,0,0,0,0,0,0,0,0,0,1,0,3,4,0,1,0,1
124132,2021,China,Canada,1,0,8,9,1/6/2021,0,0,0,0,3,4,11,18,0,3,1,4,2,3,11,16,2,7,0,9
124132,2021,China,Germany,0,2,15,17,31/05/2021,0,0,0,0,9,2,24,35,0,4,0,4,12,2,17,31,4,3,0,7
124132,2021,China,Thailand,0,0,0,0,27/05/2021,0,0,0,0,0,0,0,0,0,0,0,0,0,0,0,0,0,0,0,0
124132,2021,China,Japan,0,1,3,4,26/05/2021,0,0,1,1,4,1,5,10,0,2,0,2,7,2,8,17,1,3,0,4
124132,2021,China,Korea,0,1,1,2,25/05/2021,0,0,0,0,0,1,1,2,0,2,0,2,2,0,6,8,4,0,0,4
123841,2021,China,USA,0,0,0,0,20/06/2021,0,0,0,0,0,0,0,0,0,0,0,0,0,0,0,0,0,0,0,0
123841,2021,China,Poland,0,0,8,8,19/06/2021,18,1,39,58,0,0,0,0,0,2,4,6,0,0,0,0,4,1,0,5
123841,2021,China,Russia,0,0,0,0,18/06/2021,8,0,6,14,0,0,0,0,0,0,0,0,0,0,0,0,3,0,0,3
123841,2021,China,Italy,0,0,0,0,14/06/2021,0,0,0,0,0,0,0,0,0,0,0,0,0,0,0,0,0,0,0,0
123841,2021,Dominican Republic,China,0,0,5,5,13/06/2021,10,0,36,46,0,0,1,1,1,2,1,4,0,0,0,0,8,0,3,11
123841,2021,China,Netherlands,0,0,0,0,12/6/2021,0,0,9,9,0,0,0,0,0,0,0,0,0,0,0,0,1,0,0,1
123841,2021,China,Brazil,0,1,14,15,8/6/2021,52,2,64,118,0,0,0,0,2,1,6,9,0,0,0,0,13,2,1,16
123841,2021,China,Serbia,0,0,0,0,7/6/2021,0,0,5,5,0,0,0,0,0,1,0,1,0,0,0,0,0,0,0,0
123841,2021,China,Belgium,0,1,23,24,6/6/2021,50,1,90,141,0,0,1,1,0,3,4,7,0,0,0,0,16,2,1,19
123841,2021,China,Türkiye,0,0,10,10,2/6/2021,13,1,84,98,0,0,0,0,0,1,2,3,0,0,0,0,13,3,2,18
123841,2021,China,Canada,1,2,10,13,1/6/2021,11,0,105,116,1,0,1,2,0,4,1,5,0,0,0,0,10,3,0,13
123841,2021,China,Germany,1,1,12,14,31/05/2021,13,1,1,15,0,1,2,3,2,2,0,4,0,0,0,0,2,2,0,4
123841,2021,China,Thailand,0,1,12,13,27/05/2021,37,0,44,81,0,0,1,1,0,1,0,1,0,0,0,0,0,1,1,2
123841,2021,China,Japan,0,0,0,0,26/05/2021,0,0,9,9,0,0,0,0,0,0,0,0,0,0,0,0,1,1,0,2
123841,2021,China,Korea,0,0,9,9,25/05/2021,10,1,104,115,0,0,3,3,0,3,2,5,0,0,0,0,7,1,0,8
152318,2021,China,USA,0,0,0,0,20/06/2021,0,0,0,0,0,0,0,0,0,0,0,0,0,0,0,0,0,0,0,0
152318,2021,China,Poland,1,1,10,12,19/06/2021,0,0,4,4,17,1,5,23,0,0,1,1,7,1,14,22,4,2,1,7
152318,2021,China,Russia,1,1,15,17,18/06/2021,0,0,3,3,18,5,8,31,0,1,4,5,2,2,7,11,7,1,2,10
152318,2021,China,Italy,2,2,8,12,14/06/2021,0,0,1,1,15,1,10,26,2,1,0,3,4,0,4,8,5,1,0,6
152318,2021,Dominican Republic,China,0,1,6,7,13/06/2021,0,0,1,1,12,0,1,13,1,0,0,1,5,0,6,11,4,1,0,5
152318,2021,China,Netherlands,2,1,8,11,12/6/2021,0,0,0,0,17,5,15,37,0,2,1,3,9,1,13,23,6,0,1,7
133146,2021,China,USA,0,0,0,0,20/06/2021,0,0,0,0,0,0,0,0,0,0,0,0,0,0,0,0,0,0,0,0
133146,2021,China,Poland,0,0,0,0,19/06/2021,0,0,5,5,0,0,0,0,0,0,0,0,1,1,6,8,3,2,0,5
133146,2021,China,Russia,0,0,0,0,18/06/2021,0,0,0,0,0,0,0,0,0,0,0,0,0,0,0,0,0,0,0,0
133146,2021,China,Italy,0,0,0,0,14/06/2021,0,0,3,3,0,0,0,0,0,0,0,0,1,2,3,6,8,1,1,10
133146,2021,Dominican Republic,China,0,0,0,0,13/06/2021,0,0,0,0,0,0,0,0,0,0,0,0,2,0,4,6,1,0,0,1
133146,2021,China,Netherlands,0,0,0,0,12/6/2021,0,0,0,0,0,0,0,0,0,0,0,0,0,0,0,0,0,0,0,0
133146,2021,China,Brazil,0,0,0,0,8/6/2021,0,0,0,0,0,0,0,0,0,0,0,0,0,0,0,0,0,0,0,0
133146,2021,China,Serbia,0,0,0,0,7/6/2021,0,0,8,8,0,0,0,0,0,0,0,0,8,1,6,15,9,5,2,16
133146,2021,China,Belgium,0,0,0,0,6/6/2021,0,0,4,4,0,0,0,0,0,0,0,0,0,2,6,8,3,1,0,4
133146,2021,China,Türkiye,0,0,0,0,2/6/2021,0,0,6,6,0,0,0,0,0,0,0,0,5,3,5,13,6,3,1,10
133146,2021,China,Canada,0,0,0,0,1/6/2021,0,0,0,0,0,0,0,0,0,0,0,0,0,0,0,0,0,0,0,0
133146,2021,China,Germany,0,0,0,0,31/05/2021,1,0,1,2,0,0,0,0,0,0,0,0,9,1,8,18,9,4,0,13
133146,2021,China,Thailand,0,0,0,0,27/05/2021,0,0,0,0,0,0,0,0,0,0,0,0,0,0,0,0,1,0,0,1
133146,2021,China,Japan,0,0,0,0,26/05/2021,0,0,0,0,0,0,0,0,0,0,0,0,0,0,0,0,0,0,0,0
133146,2021,China,Korea,0,0,0,0,25/05/2021,0,0,3,3,0,0,0,0,0,0,0,0,3,2,3,8,9,2,2,13
124130,2021,China,USA,0,1,11,12,20/06/2021,5,0,60,65,0,1,1,2,1,0,1,2,0,0,0,0,4,5,0,9
124130,2021,China,Poland,0,0,2,2,19/06/2021,1,0,10,11,0,0,0,0,0,0,0,0,0,0,0,0,1,0,0,1
124130,2021,China,Russia,0,1,4,5,18/06/2021,22,1,40,63,0,2,1,3,1,4,3,8,0,0,0,0,3,1,1,5
124130,2021,China,Italy,0,1,6,7,14/06/2021,12,0,64,76,0,0,2,2,0,1,0,1,0,0,0,0,3,4,0,7
124130,2021,Dominican Republic,China,0,0,6,6,13/06/2021,22,1,23,46,2,0,0,2,1,3,2,6,0,0,0,0,5,0,1,6
124130,2021,China,Netherlands,0,2,8,10,12/6/2021,12,0,87,99,0,1,0,1,1,0,0,1,0,0,0,0,12,2,1,15
138748,2021,China,USA,3,0,11,14,20/06/2021,0,0,0,0,6,0,3,9,3,1,0,4,0,0,0,0,0,1,1,2
138748,2021,China,Russia,0,0,12,12,18/06/2021,0,0,3,3,4,1,4,9,4,4,6,14,2,0,2,4,4,0,0,4
138748,2021,China,Italy,0,0,13,13,14/06/2021,0,0,1,1,7,0,2,9,1,2,0,3,0,0,0,0,1,2,0,3
138748,2021,Dominican Republic,China,0,1,13,14,13/06/2021,1,0,5,6,2,1,5,8,6,6,7,19,1,0,1,2,1,0,0,1
138748,2021,China,Netherlands,0,0,15,15,12/6/2021,0,0,3,3,3,1,6,10,4,1,2,7,0,0,0,0,8,0,0,8
135745,2021,China,USA,0,0,0,0,20/06/2021,0,0,3,3,0,0,0,0,0,0,0,0,6,0,6,12,10,4,1,15
135745,2021,China,Poland,0,0,0,0,19/06/2021,0,0,5,5,0,0,0,0,0,0,0,0,1,0,3,4,5,2,1,8
135745,2021,China,Russia,0,0,0,0,18/06/2021,0,0,0,0,0,0,0,0,0,0,0,0,6,1,7,14,12,1,1,14
135745,2021,China,Italy,0,0,0,0,14/06/2021,0,0,0,0,0,0,0,0,0,0,0,0,0,0,0,0,0,0,0,0
135745,2021,Dominican Republic,China,0,0,0,0,13/06/2021,0,0,7,7,0,0,0,0,0,0,0,0,6,2,12,20,4,3,0,7
135745,2021,China,Netherlands,0,0,0,0,12/6/2021,1,0,7,8,0,0,0,0,0,0,0,0,3,0,5,8,8,3,0,11
135745,2021,China,Brazil,0,0,0,0,8/6/2021,0,0,10,10,0,0,0,0,0,0,0,0,12,0,10,22,21,5,3,29
135745,2021,China,Serbia,0,0,0,0,7/6/2021,0,0,0,0,0,0,0,0,0,0,0,0,0,0,0,0,0,0,0,0
135745,2021,China,Belgium,0,0,0,0,6/6/2021,0,0,13,13,0,0,0,0,0,0,0,0,8,0,16,24,28,4,4,36
135745,2021,China,Türkiye,0,0,0,0,2/6/2021,0,0,1,1,0,0,0,0,0,0,0,0,2,0,6,8,4,1,0,5
135745,2021,China,Canada,0,0,0,0,1/6/2021,0,1,11,12,0,0,0,0,0,0,0,0,10,0,12,22,15,4,0,19
135745,2021,China,Germany,0,0,0,0,31/05/2021,1,0,0,1,0,0,0,0,0,0,0,0,5,2,7,14,6,5,0,11
135745,2021,China,Thailand,0,0,0,0,27/05/2021,0,0,3,3,0,0,0,0,0,0,0,0,10,1,6,17,13,2,1,16
135745,2021,China,Japan,0,0,0,0,26/05/2021,0,0,3,3,0,0,0,0,0,0,0,0,10,1,8,19,7,2,0,9
135745,2021,China,Korea,0,0,0,0,25/05/2021,0,0,0,0,0,0,0,0,0,0,0,0,3,0,5,8,7,0,1,8
133141,2021,China,USA,0,0,0,0,20/06/2021,0,0,0,0,0,0,0,0,0,0,0,0,0,0,0,0,0,0,0,0
133141,2021,China,Poland,0,0,1,1,19/06/2021,0,0,0,0,0,0,0,0,0,0,0,0,0,0,0,0,0,0,0,0
133141,2021,China,Russia,0,0,2,2,18/06/2021,0,0,0,0,0,0,3,3,1,1,3,5,0,0,0,0,0,0,0,0
133141,2021,China,Italy,0,0,0,0,14/06/2021,0,0,0,0,0,0,0,0,0,0,0,0,0,0,0,0,0,0,0,0
133141,2021,Dominican Republic,China,0,0,0,0,13/06/2021,0,0,0,0,0,0,0,0,0,0,0,0,0,0,0,0,0,0,0,0
133141,2021,China,Brazil,0,0,2,2,8/6/2021,0,0,0,0,2,1,9,12,0,1,1,2,0,0,0,0,6,1,1,8
133141,2021,China,Serbia,0,0,9,9,7/6/2021,0,0,1,1,5,2,13,20,0,3,0,3,0,1,3,4,1,3,0,4
133141,2021,China,Belgium,0,1,0,1,6/6/2021,0,0,0,0,2,0,4,6,0,0,0,0,0,0,0,0,1,1,0,2
133141,2021,China,Türkiye,1,0,10,11,2/6/2021,0,0,2,2,8,3,21,32,0,1,0,1,1,1,5,7,7,1,0,8
133141,2021,China,Canada,0,0,4,4,1/6/2021,0,1,0,1,4,1,14,19,0,2,2,4,0,0,0,0,1,0,0,1
133141,2021,China,Germany,0,0,8,8,31/05/2021,0,0,0,0,5,1,7,13,0,2,0,2,1,1,0,2,0,1,0,1
133141,2021,China,Thailand,0,0,0,0,27/05/2021,0,0,0,0,0,0,0,0,0,0,0,0,0,0,0,0,0,0,0,0
133141,2021,China,Japan,0,1,8,9,26/05/2021,0,0,0,0,6,3,14,23,3,1,0,4,5,2,16,23,7,1,0,8
133141,2021,China,Korea,0,0,13,13,25/05/2021,0,0,1,1,14,0,24,38,1,1,2,4,6,1,19,26,5,1,0,6
113454,2021,Netherlands,Dominican Republic,0,0,0,0,14/06/2021,0,0,0,0,0,0,0,0,0,0,0,0,0,0,0,0,0,0,0,0
113454,2021,Dominican Republic,China,0,0,0,0,13/06/2021,0,0,0,0,0,0,0,0,0,0,0,0,0,0,0,0,0,0,0,0
113454,2021,Dominican Republic,Italy,2,4,4,10,12/6/2021,0,0,1,1,5,1,3,9,1,8,0,9,0,0,0,0,1,0,0,1
113454,2021,Thailand,Dominican Republic,0,1,14,15,8/6/2021,0,0,0,0,2,0,9,11,5,6,1,12,1,0,0,1,0,2,0,2
113454,2021,Türkiye,Dominican Republic,0,1,7,8,7/6/2021,0,0,0,0,3,2,6,11,1,5,1,7,0,0,1,1,0,0,0,0
113454,2021,Dominican Republic,Russia,0,1,5,6,6/6/2021,0,0,1,1,7,3,6,16,4,9,4,17,0,0,0,0,3,0,0,3
113454,2021,Poland,Dominican Republic,0,2,6,8,2/6/2021,0,0,1,1,5,0,6,11,4,5,3,12,0,0,0,0,4,2,0,6
113454,2021,Dominican Republic,Korea,0,2,7,9,1/6/2021,0,0,0,0,5,1,1,7,1,5,2,8,0,0,0,0,3,0,0,3
113454,2021,Belgium,Dominican Republic,0,0,0,0,31/05/2021,0,0,0,0,0,0,0,0,0,2,0,2,0,0,0,0,0,0,0,0
113454,2021,Canada,Dominican Republic,0,0,0,0,27/05/2021,0,0,0,0,0,0,0,0,0,2,0,2,0,0,0,0,0,0,0,0
113454,2021,Brazil,Dominican Republic,0,1,3,4,26/05/2021,0,0,0,0,2,2,6,10,0,1,2,3,0,0,0,0,1,0,0,1
113454,2021,Dominican Republic,USA,0,1,1,2,25/05/2021,0,0,0,0,1,1,0,2,0,0,1,1,0,1,0,1,0,0,0,0
119591,2021,Dominican Republic,Germany,1,3,8,12,20/06/2021,0,0,1,1,7,1,4,12,2,4,6,12,0,0,0,0,3,1,3,7
119591,2021,Dominican Republic,Serbia,0,0,0,0,19/06/2021,0,0,0,0,0,0,0,0,0,0,0,0,0,0,0,0,0,0,0,0
119591,2021,Japan,Dominican Republic,0,1,14,15,18/06/2021,0,0,0,0,1,1,5,7,1,5,6,12,0,1,4,5,4,2,3,9
119591,2021,Netherlands,Dominican Republic,0,1,13,14,14/06/2021,0,0,2,2,7,0,2,9,0,5,6,11,1,2,6,9,5,1,1,7
119591,2021,Dominican Republic,China,0,0,4,4,13/06/2021,0,0,1,1,0,0,0,0,0,0,0,0,0,0,2,2,0,1,0,1
119591,2021,Dominican Republic,Italy,0,0,4,4,12/6/2021,0,0,0,0,0,0,0,0,0,0,0,0,1,1,3,5,0,0,0,0
119591,2021,Thailand,Dominican Republic,0,0,0,0,8/6/2021,0,0,0,0,0,0,0,0,0,0,0,0,0,0,0,0,0,0,0,0
119591,2021,Türkiye,Dominican Republic,0,0,0,0,7/6/2021,0,0,0,0,0,0,0,0,0,0,0,0,0,0,1,1,0,0,0,0
119591,2021,Poland,Dominican Republic,0,0,0,0,2/6/2021,0,0,0,0,0,0,0,0,0,0,0,0,0,0,0,0,0,0,0,0
119591,2021,Dominican Republic,Korea,0,0,0,0,1/6/2021,0,0,0,0,0,0,0,0,0,0,0,0,0,0,0,0,0,0,0,0
119591,2021,Belgium,Dominican Republic,0,2,19,21,31/05/2021,0,0,0,0,3,2,1,6,2,6,7,15,9,6,7,22,15,3,1,19
119591,2021,Canada,Dominican Republic,1,2,9,12,27/05/2021,0,0,0,0,4,0,7,11,3,3,2,8,3,1,7,11,8,1,0,9
119591,2021,Brazil,Dominican Republic,0,1,3,4,26/05/2021,0,0,0,0,2,2,0,4,2,0,1,3,3,0,4,7,0,2,0,2
119591,2021,Dominican Republic,USA,0,1,8,9,25/05/2021,0,0,0,0,1,2,1,4,1,7,0,8,0,0,4,4,4,3,0,7
119039,2021,Dominican Republic,Germany,0,0,0,0,20/06/2021,1,0,25,26,0,0,0,0,0,0,0,0,9,3,22,34,25,4,3,32
119039,2021,Dominican Republic,Serbia,0,0,0,0,19/06/2021,0,0,5,5,0,0,0,0,0,0,0,0,3,0,9,12,14,5,1,20
119039,2021,Japan,Dominican Republic,0,0,0,0,18/06/2021,0,0,40,40,0,0,0,0,0,0,0,0,6,1,9,16,19,5,6,30
119039,2021,Netherlands,Dominican Republic,0,0,0,0,14/06/2021,0,0,26,26,0,0,0,0,0,0,0,0,10,1,15,26,21,7,5,33
119039,2021,Dominican Republic,China,0,0,0,0,13/06/2021,1,0,23,24,0,0,0,0,0,0,0,0,7,0,12,19,15,4,2,21
119039,2021,Dominican Republic,Italy,0,0,0,0,12/6/2021,0,0,9,9,0,0,0,0,0,0,0,0,11,0,15,26,22,3,0,25
119039,2021,Thailand,Dominican Republic,0,0,0,0,8/6/2021,0,0,11,11,0,0,0,0,0,0,0,0,12,0,6,18,16,1,1,18
119039,2021,Türkiye,Dominican Republic,0,0,0,0,7/6/2021,0,0,21,21,0,0,0,0,0,0,0,0,7,1,9,17,5,5,0,10
119039,2021,Dominican Republic,Russia,0,0,0,0,6/6/2021,0,0,12,12,0,0,0,0,0,0,0,0,7,1,18,26,18,4,3,25
119039,2021,Poland,Dominican Republic,0,0,0,0,2/6/2021,0,0,21,21,0,0,0,0,0,0,0,0,6,1,7,14,26,8,4,38
119039,2021,Dominican Republic,Korea,0,0,0,0,1/6/2021,0,0,10,10,0,0,0,0,0,0,0,0,6,0,5,11,5,3,1,9
119039,2021,Belgium,Dominican Republic,0,0,0,0,31/05/2021,0,0,0,0,0,0,0,0,0,0,0,0,8,0,22,30,23,5,2,30
119039,2021,Canada,Dominican Republic,0,0,0,0,27/05/2021,0,0,12,12,0,0,0,0,0,0,0,0,5,3,17,25,27,3,0,30
119039,2021,Brazil,Dominican Republic,0,0,0,0,26/05/2021,0,0,10,10,0,0,0,0,0,0,0,0,10,0,5,15,5,0,1,6
119039,2021,Dominican Republic,USA,0,0,0,0,25/05/2021,1,0,3,4,0,0,0,0,0,0,0,0,8,0,8,16,9,5,0,14
119545,2021,Dominican Republic,Germany,0,0,0,0,20/06/2021,1,0,15,16,0,0,0,0,0,0,2,2,0,0,0,0,2,0,0,2
119545,2021,Dominican Republic,Serbia,0,0,0,0,19/06/2021,1,0,6,7,0,0,0,0,0,0,0,0,0,0,0,0,0,0,0,0
119545,2021,Japan,Dominican Republic,0,0,2,2,18/06/2021,0,0,6,6,0,0,0,0,0,1,0,1,0,0,0,0,3,0,0,3
119545,2021,Netherlands,Dominican Republic,0,0,10,10,14/06/2021,3,1,56,60,0,0,0,0,0,3,2,5,0,0,0,0,5,1,3,9
119545,2021,Dominican Republic,China,1,1,7,9,13/06/2021,13,1,77,91,1,1,1,3,0,0,2,2,0,0,0,0,3,3,0,6
119545,2021,Dominican Republic,Italy,0,0,6,6,12/6/2021,3,1,35,39,0,0,0,0,0,1,0,1,0,0,0,0,3,1,0,4
119545,2021,Thailand,Dominican Republic,0,0,0,0,8/6/2021,0,0,11,11,0,0,0,0,0,0,0,0,0,0,0,0,0,0,0,0
119545,2021,Türkiye,Dominican Republic,0,0,0,0,7/6/2021,0,0,0,0,0,0,0,0,0,0,0,0,0,0,0,0,0,0,0,0
119545,2021,Dominican Republic,Russia,0,0,2,2,6/6/2021,0,0,5,5,0,0,0,0,0,0,0,0,0,0,0,0,0,0,0,0
119545,2021,Poland,Dominican Republic,0,0,0,0,2/6/2021,0,0,0,0,0,0,0,0,0,0,0,0,0,0,0,0,0,0,0,0
119545,2021,Belgium,Dominican Republic,0,0,0,0,31/05/2021,0,0,0,0,0,0,0,0,0,0,0,0,0,0,0,0,1,0,0,1
119545,2021,Canada,Dominican Republic,0,0,0,0,27/05/2021,0,0,0,0,0,0,0,0,0,0,0,0,0,0,0,0,0,0,0,0
119545,2021,Dominican Republic,USA,0,0,0,0,25/05/2021,0,0,0,0,0,0,0,0,0,0,0,0,0,0,0,0,1,1,0,2
119585,2021,Dominican Republic,Germany,0,1,14,15,20/06/2021,10,0,88,98,1,1,1,3,0,1,2,3,0,0,0,0,14,6,1,21
119585,2021,Dominican Republic,Serbia,0,0,6,6,19/06/2021,14,0,46,60,2,0,1,3,0,2,4,6,0,0,0,0,2,0,1,3
119585,2021,Japan,Dominican Republic,0,0,13,13,18/06/2021,20,0,102,122,0,0,0,0,0,6,2,8,0,0,0,0,15,2,1,18
119585,2021,Netherlands,Dominican Republic,0,1,4,5,14/06/2021,11,0,42,53,0,1,1,2,0,0,2,2,0,0,0,0,8,2,4,14
119585,2021,Dominican Republic,China,0,0,0,0,13/06/2021,0,0,0,0,0,0,0,0,0,0,0,0,0,0,0,0,0,0,0,0
119585,2021,Dominican Republic,Italy,0,1,8,9,12/6/2021,8,2,84,94,2,0,5,7,1,0,1,2,0,0,0,0,4,1,0,5
119585,2021,Thailand,Dominican Republic,1,1,10,12,8/6/2021,21,4,75,100,0,0,2,2,1,1,3,5,0,0,0,0,4,1,0,5
119585,2021,Türkiye,Dominican Republic,0,2,13,15,7/6/2021,4,2,96,102,2,0,1,3,0,2,2,4,0,0,0,0,3,3,0,6
119585,2021,Dominican Republic,Russia,1,0,10,11,6/6/2021,47,2,93,142,1,0,2,3,0,2,9,11,0,0,0,0,3,3,0,6
119585,2021,Poland,Dominican Republic,0,2,14,16,2/6/2021,13,1,97,111,1,0,4,5,0,3,0,3,0,0,0,0,12,3,1,16
119585,2021,Dominican Republic,Korea,1,1,13,15,1/6/2021,16,1,56,73,1,0,0,1,0,4,4,8,0,0,0,0,5,2,2,9
119585,2021,Belgium,Dominican Republic,0,1,14,15,31/05/2021,15,2,1,18,0,0,4,4,0,2,2,4,0,0,0,0,6,3,1,10
119585,2021,Canada,Dominican Republic,3,3,11,17,27/05/2021,12,1,116,129,0,0,2,2,0,3,0,3,0,0,0,0,9,5,0,14
119585,2021,Brazil,Dominican Republic,0,0,9,9,26/05/2021,2,0,82,84,1,0,0,1,0,0,1,1,0,0,0,0,2,0,0,2
119585,2021,Dominican Republic,USA,0,0,10,10,25/05/2021,0,0,0,0,0,1,1,2,0,1,0,1,0,0,0,0,3,4,0,7
115386,2021,Dominican Republic,Germany,0,0,0,0,20/06/2021,0,0,0,0,0,0,0,0,0,0,0,0,0,0,0,0,0,0,0,0
115386,2021,Dominican Republic,Serbia,0,0,8,8,19/06/2021,0,0,0,0,3,2,1,6,1,3,1,5,0,0,0,0,2,2,0,4
115386,2021,Japan,Dominican Republic,0,1,6,7,18/06/2021,0,0,1,1,0,0,2,2,0,1,1,2,0,0,0,0,3,0,0,3
115386,2021,Netherlands,Dominican Republic,0,0,0,0,14/06/2021,0,0,0,0,0,0,0,0,0,0,0,0,0,0,0,0,0,0,0,0
115386,2021,Dominican Republic,China,0,3,9,12,13/06/2021,0,0,0,0,3,0,5,8,0,1,0,1,1,0,1,2,1,0,0,1
115386,2021,Dominican Republic,Italy,0,0,0,0,12/6/2021,0,0,0,0,0,0,0,0,0,0,0,0,0,0,0,0,0,0,0,0
115386,2021,Thailand,Dominican Republic,0,0,3,3,8/6/2021,0,0,0,0,1,1,5,7,0,0,4,4,0,0,0,0,1,1,0,2
115386,2021,Türkiye,Dominican Republic,0,0,0,0,7/6/2021,0,0,0,0,0,0,0,0,0,0,0,0,0,0,0,0,0,0,0,0
115386,2021,Dominican Republic,Russia,0,0,1,1,6/6/2021,0,0,1,1,0,0,0,0,0,0,1,1,0,0,0,0,0,0,0,0
115386,2021,Poland,Dominican Republic,0,0,0,0,2/6/2021,0,0,0,0,0,0,1,1,0,0,0,0,0,0,0,0,0,0,0,0
115386,2021,Dominican Republic,Korea,0,0,0,0,1/6/2021,0,0,1,1,0,0,0,0,0,0,0,0,0,0,0,0,0,0,0,0
115386,2021,Belgium,Dominican Republic,0,0,0,0,31/05/2021,0,0,0,0,0,0,0,0,0,0,0,0,0,0,0,0,0,0,0,0
115386,2021,Canada,Dominican Republic,0,0,0,0,27/05/2021,0,0,0,0,0,0,0,0,0,0,0,0,0,0,0,0,0,0,0,0
115386,2021,Brazil,Dominican Republic,0,0,0,0,26/05/2021,0,0,0,0,0,0,0,0,0,0,0,0,0,0,0,0,0,0,0,0
115386,2021,Dominican Republic,USA,0,0,0,0,25/05/2021,0,0,0,0,0,0,0,0,0,0,0,0,0,0,0,0,0,0,0,0
139912,2021,Dominican Republic,Germany,0,0,0,0,20/06/2021,0,0,0,0,0,0,0,0,0,0,0,0,0,0,0,0,0,0,0,0
139912,2021,Dominican Republic,Serbia,0,0,0,0,19/06/2021,0,0,0,0,0,0,0,0,0,0,0,0,0,0,0,0,0,0,0,0
139912,2021,Japan,Dominican Republic,0,0,0,0,18/06/2021,0,0,0,0,0,0,0,0,0,0,0,0,0,0,0,0,0,0,0,0
139912,2021,Dominican Republic,China,0,0,0,0,13/06/2021,0,0,10,10,0,0,0,0,0,0,0,0,0,0,0,0,1,0,0,1
139912,2021,Thailand,Dominican Republic,0,0,0,0,8/6/2021,0,0,0,0,0,0,0,0,0,0,0,0,0,0,0,0,0,0,0,0
139912,2021,Türkiye,Dominican Republic,0,0,0,0,7/6/2021,0,0,0,0,0,0,0,0,0,0,0,0,0,0,0,0,0,0,0,0
139912,2021,Dominican Republic,Korea,0,0,0,0,1/6/2021,0,0,0,0,0,0,0,0,0,0,0,0,0,0,0,0,0,0,0,0
139912,2021,Brazil,Dominican Republic,0,0,0,0,26/05/2021,0,0,0,0,0,0,0,0,0,0,0,0,0,0,0,0,0,0,0,0
112468,2021,Dominican Republic,Germany,2,1,17,20,20/06/2021,0,0,2,2,11,5,17,33,0,1,2,3,2,1,19,22,12,6,3,21
112468,2021,Dominican Republic,Serbia,0,0,17,17,19/06/2021,0,0,2,2,11,1,5,17,1,1,0,2,0,0,8,8,7,2,1,10
112468,2021,Japan,Dominican Republic,0,1,12,13,18/06/2021,0,0,3,3,12,3,14,29,1,6,3,10,2,2,26,30,12,1,1,14
112468,2021,Netherlands,Dominican Republic,1,0,13,14,14/06/2021,0,0,1,1,3,1,10,14,1,1,1,3,1,0,12,13,4,1,1,6
112468,2021,Dominican Republic,China,2,3,8,13,13/06/2021,0,0,1,1,17,6,11,34,1,2,1,4,4,2,17,23,9,1,4,14
112468,2021,Dominican Republic,Italy,2,2,10,14,12/6/2021,0,0,1,1,9,3,10,22,1,1,0,2,7,0,18,25,2,3,0,5
112468,2021,Thailand,Dominican Republic,0,1,10,11,8/6/2021,0,0,0,0,10,3,13,26,1,3,2,6,2,0,8,10,6,4,0,10
112468,2021,Türkiye,Dominican Republic,0,0,7,7,7/6/2021,0,0,0,0,0,0,1,1,0,0,0,0,0,0,2,2,0,1,0,1
112468,2021,Dominican Republic,Russia,0,1,7,8,6/6/2021,0,0,3,3,6,2,20,28,2,3,3,8,4,0,22,26,5,1,1,7
112468,2021,Poland,Dominican Republic,0,2,16,18,2/6/2021,0,0,1,1,11,4,9,24,1,1,1,3,2,3,33,38,12,7,1,20
112468,2021,Dominican Republic,Korea,0,0,3,3,1/6/2021,0,0,0,0,0,0,1,1,0,0,0,0,0,0,1,1,2,1,0,3
112468,2021,Belgium,Dominican Republic,1,4,8,13,31/05/2021,0,0,0,0,16,7,15,38,1,3,3,7,0,3,15,18,5,3,1,9
112468,2021,Canada,Dominican Republic,3,3,15,21,27/05/2021,0,0,0,0,18,3,12,33,0,3,0,3,5,1,16,22,5,1,0,6
112468,2021,Brazil,Dominican Republic,0,0,4,4,26/05/2021,0,0,0,0,4,1,7,12,0,1,1,2,0,1,13,14,0,1,0,1
112468,2021,Dominican Republic,USA,0,1,8,9,25/05/2021,0,0,1,1,8,3,17,28,0,0,0,0,7,1,26,34,2,5,1,8
123978,2021,Dominican Republic,Germany,0,1,14,15,20/06/2021,0,0,2,2,8,7,11,26,0,2,3,5,4,4,10,18,5,2,1,8
123978,2021,Dominican Republic,Serbia,0,0,8,8,19/06/2021,0,0,3,3,11,7,6,24,1,0,0,1,12,0,9,21,3,2,2,7
123978,2021,Japan,Dominican Republic,0,1,2,3,18/06/2021,0,0,1,1,2,0,3,5,0,0,0,0,1,0,12,13,2,1,1,4
123978,2021,Netherlands,Dominican Republic,0,0,10,10,14/06/2021,0,0,1,1,7,3,8,18,1,0,0,1,1,0,6,7,12,1,0,13
123978,2021,Dominican Republic,China,0,2,16,18,13/06/2021,0,0,0,0,16,7,15,38,1,0,1,2,9,1,33,43,10,3,1,14
123978,2021,Dominican Republic,Italy,0,2,7,9,12/6/2021,0,0,0,0,9,2,14,25,0,2,0,2,2,0,12,14,5,1,0,6
123978,2021,Thailand,Dominican Republic,2,1,15,18,8/6/2021,0,0,0,0,16,1,18,35,0,2,4,6,12,1,12,25,12,2,0,14
123978,2021,Türkiye,Dominican Republic,1,2,18,21,7/6/2021,0,0,2,2,18,7,12,37,1,0,2,3,8,0,16,24,9,5,0,14
123978,2021,Dominican Republic,Russia,0,0,10,10,6/6/2021,0,0,0,0,9,2,13,24,3,0,1,4,6,0,14,20,13,2,2,17
123978,2021,Poland,Dominican Republic,0,0,6,6,2/6/2021,0,0,2,2,0,0,1,1,0,0,0,0,2,0,6,8,1,0,2,3
123978,2021,Dominican Republic,Korea,0,1,12,13,1/6/2021,0,0,2,2,15,6,7,28,1,0,4,5,12,3,13,28,6,2,1,9
123978,2021,Belgium,Dominican Republic,0,0,0,0,31/05/2021,0,0,0,0,0,0,2,2,0,0,0,0,1,1,5,7,1,1,0,2
123978,2021,Canada,Dominican Republic,0,0,1,1,27/05/2021,0,0,0,0,0,0,0,0,0,0,0,0,0,0,1,1,1,0,0,1
123978,2021,Brazil,Dominican Republic,0,1,3,4,26/05/2021,0,0,0,0,5,3,3,11,0,0,1,1,3,0,7,10,2,0,0,2
123978,2021,Dominican Republic,USA,0,0,2,2,25/05/2021,0,0,0,0,1,2,7,10,0,0,0,0,2,0,1,3,1,0,0,1
115391,2021,Dominican Republic,Germany,0,0,0,0,20/06/2021,0,0,0,0,0,0,0,0,0,0,0,0,0,0,0,0,0,0,0,0
115391,2021,Dominican Republic,Serbia,0,0,2,2,19/06/2021,0,0,0,0,2,1,1,4,0,0,0,0,0,0,0,0,0,0,0,0
115391,2021,Japan,Dominican Republic,0,0,0,0,18/06/2021,0,0,0,0,0,0,0,0,0,0,0,0,0,0,0,0,0,0,0,0
115391,2021,Netherlands,Dominican Republic,0,0,1,1,14/06/2021,0,0,0,0,0,0,0,0,0,0,0,0,0,0,0,0,0,0,0,0
115391,2021,Dominican Republic,China,0,0,13,13,13/06/2021,0,0,3,3,10,5,12,27,0,4,0,4,0,0,0,0,7,2,1,10
115391,2021,Dominican Republic,Italy,1,0,1,2,12/6/2021,0,0,0,0,0,0,0,0,0,1,0,1,0,0,0,0,0,0,0,0
115391,2021,Thailand,Dominican Republic,0,0,3,3,8/6/2021,0,0,0,0,2,2,4,8,1,0,1,2,0,0,0,0,0,1,0,1
115391,2021,Türkiye,Dominican Republic,0,2,6,8,7/6/2021,0,0,1,1,2,5,4,11,0,0,0,0,0,0,0,0,2,1,0,3
115391,2021,Dominican Republic,Russia,0,0,1,1,6/6/2021,0,0,0,0,0,1,0,1,0,0,1,1,0,0,0,0,1,0,0,1
115391,2021,Poland,Dominican Republic,0,0,2,2,2/6/2021,0,0,0,0,0,0,0,0,0,0,0,0,0,0,0,0,0,0,0,0
115391,2021,Dominican Republic,Korea,0,0,2,2,1/6/2021,0,0,0,0,0,0,0,0,0,0,0,0,0,0,0,0,0,0,0,0
115391,2021,Belgium,Dominican Republic,0,0,0,0,31/05/2021,0,0,0,0,0,0,0,0,0,0,0,0,0,0,0,0,0,0,0,0
115391,2021,Canada,Dominican Republic,0,0,0,0,27/05/2021,0,0,0,0,0,0,0,0,0,0,0,0,0,0,0,0,0,0,0,0
115391,2021,Brazil,Dominican Republic,0,0,2,2,26/05/2021,0,0,0,0,2,0,0,2,0,0,0,0,0,0,0,0,0,0,0,0
115391,2021,Dominican Republic,USA,0,0,2,2,25/05/2021,0,0,0,0,2,2,0,4,0,1,0,1,0,0,0,0,0,0,0,0
114294,2021,Dominican Republic,Germany,0,2,14,16,20/06/2021,0,0,4,4,20,4,17,41,2,2,1,5,2,2,10,14,15,3,0,18
114294,2021,Dominican Republic,Serbia,0,0,0,0,19/06/2021,0,0,0,0,0,0,0,0,0,0,0,0,0,0,0,0,0,0,0,0
114294,2021,Japan,Dominican Republic,0,1,16,17,18/06/2021,0,0,6,6,26,2,22,50,0,2,2,4,3,2,29,34,18,3,1,22
114294,2021,Netherlands,Dominican Republic,0,2,12,14,14/06/2021,0,0,4,4,12,4,15,31,1,0,3,4,4,1,19,24,9,6,2,17
114294,2021,Dominican Republic,China,0,1,1,2,13/06/2021,0,0,0,0,2,0,2,4,0,0,0,0,0,0,0,0,2,0,0,2
114294,2021,Dominican Republic,Italy,3,2,14,19,12/6/2021,0,0,0,0,15,5,26,46,1,1,0,2,1,0,2,3,10,2,1,13
114294,2021,Thailand,Dominican Republic,0,0,0,0,8/6/2021,0,0,0,0,0,0,0,0,0,0,0,0,0,0,0,0,0,0,0,0
114294,2021,Türkiye,Dominican Republic,2,2,3,7,7/6/2021,0,0,0,0,11,1,9,21,0,3,3,6,7,3,4,14,1,1,0,2
114294,2021,Dominican Republic,Russia,1,3,17,21,6/6/2021,0,0,1,1,8,5,20,33,0,1,3,4,2,0,16,18,14,4,2,20
114294,2021,Poland,Dominican Republic,3,1,16,20,2/6/2021,0,0,3,3,21,9,24,54,2,3,2,7,4,1,20,25,11,3,0,14
114294,2021,Dominican Republic,Korea,0,0,0,0,1/6/2021,0,0,0,0,0,0,0,0,0,0,0,0,0,0,0,0,0,0,0,0
114294,2021,Belgium,Dominican Republic,1,2,13,16,31/05/2021,0,0,0,0,16,3,23,42,0,3,3,6,5,1,20,26,9,4,2,15
114294,2021,Canada,Dominican Republic,2,1,13,16,27/05/2021,0,0,2,2,17,8,25,50,0,0,0,0,3,0,11,14,14,4,0,18
114294,2021,Brazil,Dominican Republic,0,1,8,9,26/05/2021,0,0,3,3,5,7,14,26,0,1,0,1,2,1,14,17,1,0,0,1
114294,2021,Dominican Republic,USA,1,2,4,7,25/05/2021,0,0,0,0,9,1,14,24,0,1,0,1,2,0,4,6,1,2,0,3
123982,2021,Dominican Republic,Germany,0,0,0,0,20/06/2021,0,0,1,1,0,0,2,2,0,1,1,2,0,0,0,0,0,0,0,0
123982,2021,Dominican Republic,Serbia,0,0,0,0,19/06/2021,0,0,0,0,0,0,0,0,0,0,0,0,0,0,0,0,0,0,0,0
123982,2021,Japan,Dominican Republic,0,1,10,11,18/06/2021,0,0,1,1,29,7,32,68,2,6,6,14,0,0,4,4,18,3,3,24
123982,2021,Netherlands,Dominican Republic,0,4,11,15,14/06/2021,0,0,1,1,18,5,28,51,0,6,5,11,1,1,2,4,13,3,3,19
123982,2021,Dominican Republic,China,0,0,0,0,13/06/2021,0,0,0,0,0,1,1,2,0,0,0,0,0,0,0,0,0,0,0,0
123982,2021,Dominican Republic,Italy,0,0,6,6,12/6/2021,0,1,0,1,8,2,15,25,1,0,0,1,1,1,2,4,3,1,0,4
123982,2021,Thailand,Dominican Republic,0,1,6,7,8/6/2021,0,0,0,0,9,1,13,23,3,0,0,3,0,0,0,0,6,1,2,9
123982,2021,Türkiye,Dominican Republic,0,2,10,12,7/6/2021,0,0,2,2,15,4,21,40,1,1,2,4,5,0,11,16,4,1,2,7
123982,2021,Dominican Republic,Russia,1,1,13,15,6/6/2021,0,0,1,1,22,6,19,47,0,5,1,6,1,0,0,1,16,5,5,26
123982,2021,Poland,Dominican Republic,2,2,8,12,2/6/2021,0,0,7,7,18,5,23,46,1,0,4,5,0,0,1,1,7,2,1,10
123982,2021,Dominican Republic,Korea,1,3,4,8,1/6/2021,0,0,1,1,14,2,11,27,1,1,2,4,3,2,14,19,15,2,0,17
123982,2021,Belgium,Dominican Republic,0,0,1,1,31/05/2021,0,0,0,0,3,1,5,9,0,0,0,0,0,0,3,3,2,0,0,2
123982,2021,Canada,Dominican Republic,0,0,0,0,27/05/2021,0,0,0,0,0,0,0,0,0,0,0,0,0,0,0,0,0,0,0,0
123982,2021,Brazil,Dominican Republic,0,0,0,0,26/05/2021,0,0,0,0,0,0,0,0,0,0,0,0,0,0,0,0,0,0,0,0
123982,2021,Dominican Republic,USA,0,0,0,0,25/05/2021,0,0,0,0,0,0,0,0,0,0,0,0,0,0,0,0,0,0,0,0
139910,2021,Dominican Republic,Germany,0,1,13,14,20/06/2021,0,0,1,1,7,1,9,17,2,4,8,14,0,0,0,0,3,0,0,3
139910,2021,Dominican Republic,Serbia,0,0,15,15,19/06/2021,0,0,2,2,8,0,2,10,2,7,6,15,0,0,1,1,6,1,0,7
139910,2021,Japan,Dominican Republic,1,4,12,17,18/06/2021,0,0,5,5,5,1,8,14,3,3,6,12,0,0,0,0,7,0,0,7
139910,2021,Netherlands,Dominican Republic,1,2,14,17,14/06/2021,0,0,1,1,11,1,8,20,3,12,12,27,0,0,0,0,1,0,0,1
139910,2021,Dominican Republic,China,0,2,9,11,13/06/2021,0,0,2,2,12,2,8,22,1,3,3,7,0,0,0,0,6,2,0,8
139910,2021,Dominican Republic,Italy,2,1,14,17,12/6/2021,0,0,0,0,5,1,8,14,3,4,0,7,0,0,1,1,1,1,0,2
139910,2021,Thailand,Dominican Republic,0,0,5,5,8/6/2021,0,0,1,1,5,0,3,8,0,1,0,1,0,0,0,0,1,0,0,1
139910,2021,Türkiye,Dominican Republic,1,2,16,19,7/6/2021,0,0,1,1,3,0,3,6,6,2,0,8,0,1,0,1,3,1,0,4
139910,2021,Dominican Republic,Russia,0,0,19,19,6/6/2021,0,0,3,3,8,4,7,19,1,11,11,23,0,0,0,0,2,2,1,5
139910,2021,Poland,Dominican Republic,1,2,14,17,2/6/2021,0,0,3,3,5,2,3,10,2,6,11,19,0,0,0,0,3,2,0,5
139910,2021,Dominican Republic,Korea,1,2,13,16,1/6/2021,0,0,1,1,3,2,3,8,0,1,3,4,0,0,0,0,2,0,0,2
139910,2021,Belgium,Dominican Republic,0,3,14,17,31/05/2021,0,0,0,0,11,3,8,22,4,6,11,21,0,0,1,1,5,0,1,6
139910,2021,Canada,Dominican Republic,0,1,14,15,27/05/2021,0,0,2,2,8,2,10,20,3,5,1,9,0,0,0,0,8,2,0,10
139910,2021,Brazil,Dominican Republic,0,1,9,10,26/05/2021,0,0,1,1,4,0,5,9,2,3,0,5,0,0,0,0,2,0,0,2
139910,2021,Dominican Republic,USA,0,0,6,6,25/05/2021,0,0,0,0,3,0,6,9,1,0,0,1,0,0,2,2,1,1,0,2
139927,2021,Dominican Republic,Germany,1,3,7,11,20/06/2021,0,0,1,1,7,1,10,18,0,0,0,0,0,0,1,1,4,0,1,5
139927,2021,Dominican Republic,Serbia,4,1,12,17,19/06/2021,0,0,0,0,8,4,8,20,0,0,1,1,0,0,0,0,7,2,1,10
139927,2021,Japan,Dominican Republic,0,0,1,1,18/06/2021,0,0,3,3,2,2,6,10,0,2,2,4,0,0,0,0,1,1,0,2
139927,2021,Netherlands,Dominican Republic,0,1,0,1,14/06/2021,0,0,0,0,3,1,2,6,0,1,1,2,0,0,0,0,1,0,0,1
139927,2021,Dominican Republic,Italy,0,0,0,0,12/6/2021,0,0,0,0,0,0,0,0,0,0,0,0,0,0,0,0,0,0,0,0
139927,2021,Poland,Dominican Republic,0,0,0,0,2/6/2021,0,0,0,0,0,0,0,0,0,0,0,0,0,0,0,0,0,0,0,0
139927,2021,Dominican Republic,Korea,1,2,7,10,1/6/2021,0,0,3,3,11,3,9,23,3,3,6,12,0,0,0,0,7,2,0,9
139927,2021,Belgium,Dominican Republic,1,4,17,22,31/05/2021,0,0,0,0,25,3,20,48,2,4,1,7,0,0,0,0,14,4,0,18
139927,2021,Canada,Dominican Republic,4,2,15,21,27/05/2021,0,0,1,1,6,5,20,31,0,3,1,4,0,0,0,0,10,2,0,12
139927,2021,Brazil,Dominican Republic,1,0,5,6,26/05/2021,0,0,0,0,5,4,12,21,0,4,0,4,0,0,0,0,5,1,0,6
139927,2021,Dominican Republic,USA,0,1,7,8,25/05/2021,0,0,0,0,9,4,12,25,1,4,1,6,0,0,0,0,1,2,0,3
139913,2021,Dominican Republic,Germany,0,0,0,0,20/06/2021,0,0,0,0,0,0,0,0,0,0,0,0,0,0,0,0,0,0,0,0
139913,2021,Dominican Republic,Serbia,0,0,0,0,19/06/2021,0,0,0,0,0,0,0,0,0,0,0,0,0,0,0,0,0,0,0,0
139913,2021,Japan,Dominican Republic,0,0,0,0,18/06/2021,0,0,0,0,0,0,0,0,0,0,0,0,0,0,0,0,0,0,0,0
139913,2021,Netherlands,Dominican Republic,0,0,0,0,14/06/2021,0,0,0,0,0,0,0,0,0,0,0,0,0,0,0,0,0,0,0,0
139913,2021,Dominican Republic,China,0,0,0,0,13/06/2021,0,0,0,0,0,0,0,0,0,0,0,0,0,0,0,0,0,0,0,0
139913,2021,Dominican Republic,Italy,0,0,0,0,12/6/2021,0,0,0,0,0,0,0,0,0,0,0,0,0,0,0,0,0,0,0,0
139913,2021,Thailand,Dominican Republic,0,0,0,0,8/6/2021,0,0,0,0,0,0,0,0,0,0,0,0,0,0,0,0,0,0,0,0
139913,2021,Türkiye,Dominican Republic,0,0,0,0,7/6/2021,0,0,0,0,0,0,0,0,0,0,0,0,0,0,0,0,0,0,0,0
139913,2021,Dominican Republic,Russia,0,0,3,3,6/6/2021,0,0,0,0,0,0,0,0,0,0,0,0,1,0,7,8,0,0,1,1
139913,2021,Poland,Dominican Republic,0,0,0,0,2/6/2021,0,0,0,0,0,0,0,0,0,0,0,0,0,0,0,0,0,0,0,0
139913,2021,Dominican Republic,Korea,0,0,0,0,1/6/2021,0,0,0,0,0,0,0,0,0,0,0,0,0,0,0,0,0,0,0,0
139913,2021,Belgium,Dominican Republic,0,0,0,0,31/05/2021,0,0,0,0,0,0,0,0,0,0,0,0,0,0,0,0,0,0,0,0
139913,2021,Canada,Dominican Republic,0,0,0,0,27/05/2021,0,0,0,0,0,0,0,0,0,0,0,0,0,0,0,0,0,0,0,0
139913,2021,Brazil,Dominican Republic,0,0,0,0,26/05/2021,0,0,0,0,0,0,0,0,0,0,0,0,0,0,0,0,0,0,0,0
139913,2021,Dominican Republic,USA,0,0,0,0,25/05/2021,0,0,0,0,0,0,0,0,0,0,0,0,0,0,0,0,0,0,0,0
152140,2021,Dominican Republic,Germany,0,1,5,6,20/06/2021,0,0,1,1,0,0,0,0,0,0,0,0,0,0,0,0,0,0,1,1
152140,2021,Japan,Germany,0,1,0,1,19/06/2021,0,0,0,0,0,0,0,0,0,0,0,0,3,0,1,4,0,0,0,0
152140,2021,Germany,Serbia,1,0,1,2,18/06/2021,0,0,0,0,0,0,0,0,0,0,0,0,0,0,0,0,0,1,0,1
152140,2021,Germany,Poland,0,0,0,0,14/06/2021,0,0,0,0,0,0,0,0,0,0,0,0,1,0,1,2,0,0,0,0
152140,2021,Germany,Brazil,0,0,1,1,13/06/2021,0,0,0,0,0,0,0,0,0,0,0,0,0,0,0,0,0,0,0,0
152140,2021,Thailand,Germany,0,0,0,0,12/6/2021,0,0,0,0,0,0,0,0,0,0,0,0,0,0,0,0,0,0,0,0
152140,2021,Germany,Korea,0,0,0,0,8/6/2021,0,0,6,6,0,0,0,0,0,0,0,0,5,0,2,7,7,1,0,8
152140,2021,Germany,Italy,0,0,0,0,7/6/2021,0,0,0,0,0,0,0,0,0,0,0,0,5,0,3,8,3,1,0,4
152140,2021,Germany,USA,0,0,0,0,6/6/2021,0,0,0,0,0,0,0,0,0,0,0,0,0,0,0,0,0,0,0,0
152140,2021,Germany,Canada,0,0,0,0,2/6/2021,0,0,0,0,0,0,0,0,0,0,0,0,0,0,0,0,0,0,0,0
152140,2021,Türkiye,Germany,0,0,0,0,1/6/2021,0,0,0,0,0,0,0,0,0,0,0,0,0,0,0,0,0,0,0,0
152140,2021,China,Germany,0,0,0,0,31/05/2021,0,0,0,0,0,0,0,0,0,0,0,0,0,0,0,0,0,0,0,0
152140,2021,Germany,Belgium,0,0,0,0,27/05/2021,0,0,0,0,0,0,0,0,0,0,0,0,0,0,0,0,0,0,1,1
152140,2021,Netherlands,Germany,0,0,0,0,26/05/2021,0,0,0,0,0,0,0,0,0,0,0,0,0,0,0,0,0,0,0,0
152140,2021,Germany,Russia,0,0,0,0,25/05/2021,0,0,0,0,0,0,0,0,0,0,0,0,1,0,0,1,0,0,0,0
150973,2021,Dominican Republic,Germany,0,0,2,2,20/06/2021,2,0,11,13,0,0,0,0,0,0,0,0,0,0,0,0,0,0,0,0
150973,2021,Japan,Germany,0,0,1,1,19/06/2021,3,0,9,12,0,0,1,1,0,2,1,3,0,0,0,0,1,0,0,1
150973,2021,Germany,Serbia,0,0,3,3,18/06/2021,5,0,24,29,1,0,0,1,0,1,0,1,0,0,0,0,2,2,0,4
150973,2021,Germany,Poland,0,0,2,2,14/06/2021,0,0,1,1,1,0,0,1,0,0,0,0,0,0,0,0,0,0,0,0
150973,2021,Germany,Brazil,0,0,8,8,13/06/2021,0,0,8,8,0,0,0,0,0,0,0,0,0,0,0,0,2,0,0,2
150973,2021,Thailand,Germany,0,1,5,6,12/6/2021,6,0,39,45,1,0,0,1,2,1,0,3,0,0,0,0,4,0,1,5
150973,2021,Germany,Korea,0,0,0,0,8/6/2021,0,0,0,0,0,0,0,0,0,0,0,0,0,0,0,0,0,0,0,0
150973,2021,Germany,Italy,0,0,9,9,7/6/2021,16,0,39,55,1,0,0,1,2,1,1,4,0,0,0,0,6,2,1,9
150973,2021,Germany,USA,0,0,6,6,6/6/2021,1,2,24,27,2,0,0,2,0,0,0,0,0,0,1,1,1,0,0,1
150973,2021,Germany,Canada,1,0,9,10,2/6/2021,3,1,41,45,0,0,0,0,0,0,0,0,0,1,0,1,2,1,0,3
150973,2021,Türkiye,Germany,0,0,2,2,1/6/2021,3,0,1,4,0,0,0,0,0,0,0,0,0,0,0,0,0,1,0,1
150973,2021,China,Germany,0,0,4,4,31/05/2021,4,0,0,4,0,0,0,0,0,0,0,0,0,0,0,0,0,2,0,2
150973,2021,Germany,Belgium,2,0,1,3,27/05/2021,0,0,9,9,0,0,0,0,0,1,0,1,0,0,0,0,0,0,0,0
150973,2021,Netherlands,Germany,0,0,5,5,26/05/2021,11,0,41,52,0,1,2,3,0,0,1,1,0,0,0,0,2,0,0,2
150973,2021,Germany,Russia,1,0,2,3,25/05/2021,2,1,15,18,0,0,0,0,0,0,1,1,0,0,0,0,1,0,0,1
136668,2021,Dominican Republic,Germany,1,2,10,13,20/06/2021,22,1,88,111,2,0,4,6,2,5,3,10,0,1,0,1,16,4,2,22
136668,2021,Japan,Germany,0,2,9,11,19/06/2021,39,0,66,105,2,1,0,3,2,4,5,11,0,0,0,0,11,1,1,13
136668,2021,Germany,Serbia,0,0,7,7,18/06/2021,13,0,43,56,1,0,0,1,1,0,0,1,0,0,0,0,2,1,0,3
136668,2021,Germany,Poland,0,2,9,11,14/06/2021,16,0,69,85,2,0,1,3,0,1,1,2,0,0,0,0,7,2,3,12
136668,2021,Germany,Brazil,0,3,9,12,13/06/2021,27,2,72,101,3,0,3,6,2,4,1,7,0,0,0,0,8,1,1,10
136668,2021,Thailand,Germany,1,2,5,8,12/6/2021,14,0,57,71,0,0,1,1,0,1,2,3,0,0,0,0,3,3,2,8
136668,2021,Germany,Korea,1,3,10,14,8/6/2021,14,0,58,72,2,0,1,3,0,2,2,4,0,0,0,0,10,0,1,11
136668,2021,Germany,Italy,0,1,1,2,7/6/2021,9,0,15,24,0,0,0,0,0,0,0,0,0,0,0,0,0,0,0,0
136668,2021,Germany,USA,0,0,4,4,6/6/2021,1,1,31,33,0,0,1,1,0,1,1,2,0,0,0,0,1,1,0,2
136668,2021,Germany,Canada,0,0,2,2,2/6/2021,3,2,37,42,1,0,2,3,1,0,0,1,0,0,0,0,2,2,1,5
136668,2021,Türkiye,Germany,1,2,6,9,1/6/2021,15,0,61,76,1,1,2,4,0,2,5,7,0,0,0,0,7,1,4,12
136668,2021,China,Germany,0,2,13,15,31/05/2021,10,1,0,11,3,0,3,6,0,2,2,4,0,0,0,0,8,2,0,10
136668,2021,Germany,Belgium,0,1,7,8,27/05/2021,7,1,63,71,2,1,1,4,0,0,0,0,0,0,0,0,4,0,0,4
136668,2021,Netherlands,Germany,0,2,8,10,26/05/2021,23,1,58,82,4,0,2,6,0,0,0,0,0,0,0,0,3,3,0,6
136668,2021,Germany,Russia,1,0,5,6,25/05/2021,15,3,58,76,1,0,0,1,0,1,2,3,0,0,0,0,11,0,0,11
141676,2021,Dominican Republic,Germany,0,0,0,0,20/06/2021,0,0,0,0,0,0,0,0,0,0,0,0,2,0,3,5,2,0,1,3
141676,2021,Japan,Germany,3,1,20,24,19/06/2021,0,0,2,2,7,2,13,22,1,3,4,8,10,1,15,26,12,0,0,12
141676,2021,Germany,Serbia,1,0,4,5,18/06/2021,0,0,1,1,3,2,2,7,1,1,2,4,4,0,6,10,1,2,0,3
141676,2021,Germany,Poland,0,0,0,0,14/06/2021,0,0,0,0,0,0,0,0,0,0,0,0,0,0,0,0,0,0,0,0
141676,2021,Germany,Brazil,0,0,3,3,13/06/2021,0,0,0,0,0,0,0,0,0,0,0,0,0,0,0,0,1,0,0,1
141676,2021,Thailand,Germany,0,0,3,3,12/6/2021,0,0,0,0,2,0,1,3,0,0,0,0,0,0,2,2,0,1,0,1
141676,2021,Germany,Korea,0,0,0,0,8/6/2021,0,0,0,0,0,0,0,0,0,0,0,0,0,0,0,0,0,0,0,0
141676,2021,Germany,Italy,0,0,1,1,7/6/2021,0,0,0,0,0,2,1,3,0,1,0,1,2,0,2,4,1,1,1,3
141676,2021,Germany,USA,1,0,2,3,6/6/2021,0,0,0,0,1,0,1,2,0,0,0,0,1,0,4,5,0,1,0,1
141676,2021,Germany,Canada,0,0,5,5,2/6/2021,0,0,0,0,3,1,6,10,0,0,1,1,11,3,8,22,3,2,1,6
141676,2021,Türkiye,Germany,0,0,2,2,1/6/2021,0,0,1,1,3,3,3,9,1,1,2,4,0,0,6,6,2,0,0,2
141676,2021,Germany,Belgium,0,0,0,0,27/05/2021,0,0,0,0,1,0,0,1,0,0,0,0,0,0,0,0,0,0,0,0
141676,2021,Netherlands,Germany,0,0,7,7,26/05/2021,0,0,0,0,0,0,0,0,0,0,0,0,1,0,1,2,1,0,0,1
141676,2021,Germany,Russia,0,0,1,1,25/05/2021,0,0,1,1,0,0,0,0,0,0,0,0,1,0,1,2,1,0,0,1
168102,2021,Thailand,Germany,0,0,0,0,12/6/2021,0,0,0,0,0,0,0,0,0,0,0,0,0,0,0,0,0,0,0,0
168102,2021,Germany,Korea,0,0,0,0,8/6/2021,0,0,0,0,0,0,0,0,0,0,0,0,0,0,0,0,0,0,0,0
168102,2021,Germany,Italy,0,1,1,2,7/6/2021,0,0,1,1,3,3,4,10,0,0,0,0,0,1,0,1,2,0,1,3
168102,2021,Germany,USA,0,1,2,3,6/6/2021,0,0,0,0,3,1,3,7,0,2,0,2,0,0,0,0,0,0,0,0
168102,2021,Germany,Canada,1,2,11,14,2/6/2021,0,0,0,0,12,4,12,28,3,1,1,5,0,0,0,0,5,0,1,6
168102,2021,Türkiye,Germany,1,1,1,3,1/6/2021,0,0,1,1,5,3,3,11,0,1,3,4,0,0,1,1,2,0,0,2
168102,2021,China,Germany,0,0,0,0,31/05/2021,0,0,0,0,1,3,0,4,0,1,0,1,0,0,0,0,0,0,0,0
168102,2021,Germany,Belgium,0,0,2,2,27/05/2021,0,0,0,0,0,0,1,1,0,0,0,0,0,0,0,0,0,0,0,0
168102,2021,Netherlands,Germany,1,1,9,11,26/05/2021,0,0,0,0,9,1,9,19,1,0,0,1,1,0,0,1,1,0,0,1
168102,2021,Germany,Russia,0,0,1,1,25/05/2021,0,0,0,0,5,3,3,11,0,1,1,2,0,0,0,0,0,2,0,2
156295,2021,Dominican Republic,Germany,1,2,10,13,20/06/2021,0,0,1,1,23,8,18,49,1,3,4,8,0,0,0,0,7,5,1,13
156295,2021,Japan,Germany,0,0,1,1,19/06/2021,0,0,0,0,1,0,4,5,0,2,0,2,0,0,0,0,2,0,0,2
156295,2021,Germany,Serbia,0,0,0,0,18/06/2021,0,0,0,0,0,0,0,0,0,0,0,0,0,0,0,0,0,0,0,0
156295,2021,Germany,Poland,2,3,7,12,14/06/2021,0,0,1,1,13,2,9,24,0,3,3,6,0,0,0,0,4,1,0,5
156295,2021,Germany,Brazil,3,0,10,13,13/06/2021,0,0,1,1,13,5,16,34,1,4,2,7,0,0,0,0,9,3,1,13
156295,2021,Thailand,Germany,0,2,12,14,12/6/2021,0,0,4,4,9,5,12,26,1,1,1,3,0,0,0,0,8,3,4,15
156295,2021,Germany,Korea,0,1,10,11,8/6/2021,0,0,2,2,10,5,12,27,4,2,9,15,0,0,0,0,7,7,1,15
156295,2021,Germany,Italy,0,1,4,5,7/6/2021,0,0,1,1,7,2,13,22,1,1,2,4,0,0,0,0,5,1,0,6
156295,2021,Germany,USA,0,0,5,5,6/6/2021,0,0,0,0,4,2,7,13,0,0,1,1,0,0,0,0,3,1,0,4
156295,2021,Germany,Canada,0,0,0,0,2/6/2021,0,0,0,0,1,1,1,3,0,0,0,0,0,0,0,0,0,0,0,0
156295,2021,Türkiye,Germany,0,0,1,1,1/6/2021,0,0,0,0,2,0,5,7,0,0,0,0,0,0,0,0,2,1,0,3
156295,2021,China,Germany,0,3,7,10,31/05/2021,1,0,0,1,10,7,11,28,0,2,2,4,0,0,0,0,6,2,0,8
156295,2021,Germany,Belgium,0,2,12,14,27/05/2021,0,0,2,2,8,2,9,19,0,0,0,0,0,0,0,0,2,0,0,2
156295,2021,Netherlands,Germany,0,1,11,12,26/05/2021,0,0,0,0,9,7,12,28,0,0,0,0,0,0,0,0,5,0,0,5
156295,2021,Germany,Russia,0,1,6,7,25/05/2021,0,0,0,0,9,4,11,24,0,3,2,5,0,0,0,0,4,1,0,5
163658,2021,Dominican Republic,Germany,0,2,12,14,20/06/2021,0,0,2,2,12,2,18,32,0,2,2,4,10,0,13,23,11,3,2,16
163658,2021,Japan,Germany,0,3,9,12,19/06/2021,0,0,1,1,11,1,18,30,0,1,3,4,19,4,22,45,8,2,2,12
163658,2021,Germany,Serbia,0,2,3,5,18/06/2021,0,0,2,2,11,3,8,22,0,0,1,1,7,0,9,16,4,2,0,6
163658,2021,Germany,Poland,0,2,11,13,14/06/2021,0,0,2,2,10,1,14,25,1,1,1,3,8,1,10,19,6,0,1,7
163658,2021,Germany,Brazil,0,3,13,16,13/06/2021,0,0,2,2,9,4,7,20,0,1,0,1,15,1,21,37,6,3,0,9
163658,2021,Thailand,Germany,2,2,16,20,12/6/2021,0,0,2,2,13,5,17,35,3,0,1,4,13,3,21,37,4,1,0,5
163658,2021,Germany,Korea,0,2,9,11,8/6/2021,0,1,2,3,14,1,3,18,1,0,1,2,6,1,9,16,11,0,0,11
163658,2021,Germany,Italy,0,2,4,6,7/6/2021,0,0,3,3,11,5,7,23,2,3,2,7,6,1,10,17,1,2,0,3
163658,2021,Germany,USA,0,1,5,6,6/6/2021,0,0,1,1,6,2,11,19,1,3,1,5,4,1,7,12,1,1,0,2
163658,2021,Germany,Canada,0,2,3,5,2/6/2021,0,0,0,0,2,1,4,7,0,0,1,1,3,1,4,8,2,1,0,3
163658,2021,Türkiye,Germany,0,3,6,9,1/6/2021,0,0,1,1,6,1,4,11,1,5,0,6,7,4,22,33,4,2,0,6
163658,2021,China,Germany,1,1,19,21,31/05/2021,1,0,0,1,13,7,14,34,2,3,0,5,21,1,13,35,7,3,0,10
163658,2021,Germany,Belgium,3,1,9,13,27/05/2021,0,0,1,1,11,1,12,24,0,0,0,0,11,1,6,18,1,0,1,2
163658,2021,Netherlands,Germany,2,5,7,14,26/05/2021,0,0,1,1,14,3,25,42,2,0,0,2,8,2,19,29,7,2,0,9
163658,2021,Germany,Russia,0,0,0,0,25/05/2021,0,0,0,0,0,0,2,2,0,0,0,0,0,0,0,0,0,0,0,0
144980,2021,Dominican Republic,Germany,0,0,2,2,20/06/2021,0,0,0,0,1,0,2,3,0,1,1,2,0,0,0,0,0,0,0,0
144980,2021,Japan,Germany,0,0,1,1,19/06/2021,0,0,3,3,1,2,3,6,0,2,0,2,0,0,3,3,4,1,0,5
144980,2021,Germany,Serbia,2,0,15,17,18/06/2021,0,0,2,2,7,2,9,18,0,1,1,2,7,2,10,19,8,0,2,10
144980,2021,Germany,Poland,0,0,0,0,14/06/2021,0,0,0,0,1,0,0,1,0,0,0,0,0,0,0,0,0,0,0,0
144980,2021,Germany,Brazil,0,0,0,0,13/06/2021,0,0,0,0,2,1,2,5,0,0,1,1,0,0,0,0,0,0,0,0
144980,2021,Thailand,Germany,0,0,5,5,12/6/2021,0,1,1,2,8,4,6,18,1,1,0,2,2,0,5,7,3,2,1,6
144980,2021,Germany,Korea,0,0,0,0,8/6/2021,0,0,0,0,0,0,0,0,0,0,0,0,0,0,0,0,0,0,0,0
144980,2021,Germany,Italy,0,0,4,4,7/6/2021,0,0,1,1,2,1,6,9,0,2,0,2,6,3,12,21,1,2,2,5
144980,2021,Germany,USA,1,0,1,2,6/6/2021,0,0,1,1,1,2,4,7,0,1,1,2,1,1,5,7,1,0,0,1
144980,2021,Germany,Canada,0,1,3,4,2/6/2021,0,0,0,0,5,2,0,7,0,1,1,2,5,0,6,11,0,0,1,1
144980,2021,Türkiye,Germany,0,0,1,1,1/6/2021,0,0,0,0,0,0,2,2,0,3,0,3,1,1,1,3,1,0,1,2
144980,2021,China,Germany,0,0,6,6,31/05/2021,0,0,0,0,9,3,9,21,1,0,1,2,6,1,6,13,2,1,0,3
151016,2021,Dominican Republic,Germany,5,5,12,22,20/06/2021,0,0,3,3,11,6,16,33,1,0,5,6,11,1,19,31,11,1,2,14
151016,2021,Japan,Germany,1,3,9,13,19/06/2021,0,0,1,1,17,6,19,42,2,5,3,10,0,0,0,0,4,2,3,9
151016,2021,Germany,Serbia,1,4,5,10,18/06/2021,0,0,1,1,14,5,12,31,0,0,1,1,0,0,0,0,8,3,0,11
151016,2021,Germany,Poland,4,2,8,14,14/06/2021,0,1,0,1,7,5,11,23,2,1,0,3,7,2,25,34,6,4,2,12
151016,2021,Germany,Brazil,2,3,5,10,13/06/2021,0,0,1,1,16,7,22,45,3,3,1,7,11,0,21,32,6,0,1,7
151016,2021,Thailand,Germany,0,4,1,5,12/6/2021,0,0,0,0,8,4,9,21,1,0,1,2,3,0,13,16,7,1,0,8
151016,2021,Germany,Korea,3,1,11,15,8/6/2021,0,1,2,3,13,4,8,25,3,0,2,5,10,1,15,26,5,1,3,9
151016,2021,Germany,Italy,0,0,2,2,7/6/2021,0,0,0,0,6,3,2,11,0,0,1,1,1,1,6,8,2,0,0,2
151016,2021,Germany,USA,0,2,4,6,6/6/2021,0,0,1,1,7,2,5,14,0,3,0,3,7,4,15,26,2,1,1,4
151016,2021,Germany,Canada,0,4,2,6,2/6/2021,0,0,0,0,8,1,6,15,0,2,0,2,3,1,10,14,4,1,0,5
151016,2021,Türkiye,Germany,1,4,7,12,1/6/2021,0,0,0,0,12,4,8,24,1,2,1,4,3,1,10,14,6,1,2,9
151016,2021,China,Germany,3,3,7,13,31/05/2021,0,0,0,0,18,5,12,35,2,1,3,6,6,1,14,21,4,5,0,9
151016,2021,Germany,Belgium,0,0,1,1,27/05/2021,0,0,0,0,0,1,2,3,0,0,0,0,1,0,0,1,0,0,0,0
151016,2021,Netherlands,Germany,0,0,2,2,26/05/2021,0,0,0,0,1,1,4,6,0,0,1,1,2,1,0,3,0,0,0,0
151016,2021,Germany,Russia,1,1,6,8,25/05/2021,0,0,0,0,8,6,12,26,1,1,2,4,5,0,7,12,2,2,0,4
150812,2021,Dominican Republic,Germany,3,1,14,18,20/06/2021,0,0,1,1,4,1,11,16,0,8,3,11,0,0,0,0,3,0,0,3
150812,2021,Japan,Germany,1,0,9,10,19/06/2021,0,0,0,0,9,1,9,19,5,6,4,15,0,0,0,0,1,1,0,2
150812,2021,Germany,Serbia,0,1,6,7,18/06/2021,0,0,2,2,9,3,2,14,1,0,0,1,0,0,0,0,0,1,0,1
150812,2021,Germany,Poland,0,0,10,10,14/06/2021,0,0,0,0,5,2,4,11,2,5,1,8,0,0,0,0,3,0,1,4
150812,2021,Germany,Brazil,0,0,9,9,13/06/2021,0,0,1,1,8,2,6,16,1,1,5,7,0,0,0,0,2,2,1,5
150812,2021,Thailand,Germany,0,1,10,11,12/6/2021,0,0,0,0,7,0,8,15,1,8,4,13,0,0,1,1,2,2,0,4
150812,2021,Germany,Korea,0,1,6,7,8/6/2021,0,0,0,0,5,1,5,11,1,3,4,8,1,0,2,3,2,0,0,2
150812,2021,Germany,Italy,0,1,12,13,7/6/2021,0,0,1,1,1,1,3,5,1,2,0,3,0,1,0,1,1,0,0,1
150812,2021,Germany,USA,0,0,4,4,6/6/2021,0,0,1,1,1,1,2,4,0,2,1,3,0,0,0,0,1,1,0,2
150812,2021,Germany,Canada,0,1,6,7,2/6/2021,0,0,1,1,3,3,4,10,2,3,2,7,0,0,0,0,2,1,1,4
150812,2021,Türkiye,Germany,0,1,9,10,1/6/2021,0,0,1,1,6,2,5,13,1,4,3,8,0,0,0,0,4,0,2,6
150812,2021,China,Germany,1,1,10,12,31/05/2021,0,0,0,0,5,3,7,15,3,0,4,7,3,1,0,4,2,0,1,3
150812,2021,Germany,Belgium,0,1,7,8,27/05/2021,0,0,1,1,5,0,6,11,3,1,1,5,0,0,0,0,0,0,0,0
150812,2021,Netherlands,Germany,0,1,6,7,26/05/2021,0,0,0,0,7,3,4,14,2,3,0,5,0,0,0,0,2,0,0,2
150812,2021,Germany,Russia,1,0,6,7,25/05/2021,0,1,1,2,3,1,7,11,0,6,2,8,0,0,0,0,0,1,1,2
163989,2021,Germany,Italy,0,0,0,0,7/6/2021,0,0,0,0,0,0,0,0,0,0,0,0,0,0,0,0,0,0,0,0
163989,2021,Germany,USA,0,1,1,2,6/6/2021,0,0,1,1,2,0,1,3,0,2,0,2,1,0,0,1,0,0,0,0
163989,2021,Germany,Belgium,0,0,0,0,27/05/2021,0,0,0,0,0,0,0,0,0,0,0,0,0,0,0,0,0,0,0,0
163989,2021,Netherlands,Germany,0,0,0,0,26/05/2021,0,0,0,0,0,0,0,0,0,0,0,0,0,0,0,0,0,0,0,0
163989,2021,Germany,Russia,0,0,0,0,25/05/2021,0,0,0,0,0,0,0,0,0,0,0,0,0,0,0,0,0,0,0,0
136671,2021,Dominican Republic,Germany,0,0,0,0,20/06/2021,0,0,21,21,0,0,0,0,0,0,0,0,15,2,13,30,17,5,3,25
136671,2021,Japan,Germany,0,0,0,0,19/06/2021,0,0,14,14,0,0,0,0,0,0,0,0,6,1,5,12,18,3,2,23
136671,2021,Germany,Serbia,0,0,0,0,18/06/2021,0,0,7,7,0,0,0,0,0,0,0,0,3,1,7,11,11,7,2,20
136671,2021,Germany,Poland,0,0,0,0,14/06/2021,0,0,4,4,0,0,0,0,0,0,0,0,3,0,4,7,11,1,1,13
136671,2021,Germany,Brazil,0,0,0,0,13/06/2021,0,0,13,13,0,0,0,0,0,0,0,0,10,0,10,20,12,7,1,20
136671,2021,Thailand,Germany,0,0,0,0,12/6/2021,0,1,10,11,0,0,0,0,0,0,0,0,9,0,13,22,24,6,4,34
136671,2021,Germany,Korea,0,0,0,0,8/6/2021,0,0,0,0,0,0,0,0,0,0,0,0,0,0,0,0,0,0,0,0
136671,2021,Germany,Italy,0,0,0,0,7/6/2021,0,0,6,6,0,0,0,0,0,0,0,0,6,1,1,8,5,2,0,7
136671,2021,Germany,USA,0,0,0,0,6/6/2021,0,0,7,7,0,0,0,0,0,0,0,0,1,2,8,11,0,6,1,7
136671,2021,Germany,Canada,0,0,0,0,2/6/2021,0,0,5,5,0,0,0,0,0,0,0,0,10,0,8,18,6,6,1,13
136671,2021,Türkiye,Germany,0,0,0,0,1/6/2021,0,0,6,6,0,0,0,0,0,0,0,0,1,0,9,10,8,1,0,9
136671,2021,China,Germany,0,0,0,0,31/05/2021,0,1,3,4,0,0,0,0,0,0,0,0,9,0,9,18,20,9,1,30
136671,2021,Germany,Belgium,0,0,0,0,27/05/2021,0,0,3,3,0,0,0,0,0,0,0,0,4,1,5,10,1,0,0,1
136671,2021,Netherlands,Germany,0,0,0,0,26/05/2021,0,0,8,8,0,0,0,0,0,0,0,0,11,2,10,23,20,3,1,24
136671,2021,Germany,Russia,0,0,0,0,25/05/2021,1,0,6,7,0,0,0,0,0,0,0,0,13,3,12,28,12,4,0,16
163674,2021,Dominican Republic,Germany,0,0,0,0,20/06/2021,0,0,0,0,0,0,0,0,0,0,0,0,0,0,0,0,0,0,0,0
163674,2021,Japan,Germany,0,0,0,0,19/06/2021,0,0,0,0,1,0,0,1,1,0,0,1,0,0,0,0,0,0,0,0
163674,2021,Germany,Serbia,0,0,0,0,18/06/2021,0,0,0,0,0,0,0,0,0,0,0,0,0,0,0,0,0,0,0,0
163674,2021,Germany,Poland,0,0,0,0,14/06/2021,0,0,0,0,0,0,0,0,0,0,0,0,0,0,0,0,0,0,0,0
163674,2021,Germany,Brazil,0,0,0,0,13/06/2021,0,0,0,0,0,0,0,0,0,0,0,0,0,0,0,0,0,0,0,0
163674,2021,Thailand,Germany,0,0,0,0,12/6/2021,0,0,0,0,0,0,0,0,0,0,0,0,0,0,0,0,0,0,0,0
163674,2021,Germany,Korea,0,0,0,0,8/6/2021,0,0,0,0,0,0,0,0,0,0,0,0,0,0,0,0,0,0,0,0
163674,2021,Germany,Canada,0,0,1,1,2/6/2021,0,0,0,0,0,1,0,1,0,0,0,0,0,0,0,0,0,0,0,0
163674,2021,Türkiye,Germany,0,0,1,1,1/6/2021,0,0,0,0,0,0,0,0,0,0,0,0,0,0,0,0,0,0,0,0
163674,2021,China,Germany,0,0,0,0,31/05/2021,0,0,0,0,0,0,0,0,0,0,0,0,0,0,0,0,0,0,0,0
163674,2021,Germany,Belgium,0,0,1,1,27/05/2021,0,0,0,0,0,0,0,0,0,0,0,0,0,0,0,0,0,0,0,0
163674,2021,Netherlands,Germany,0,0,0,0,26/05/2021,0,0,0,0,0,0,0,0,0,0,0,0,0,0,0,0,0,0,0,0
163674,2021,Germany,Russia,0,0,0,0,25/05/2021,0,0,0,0,0,0,0,0,0,0,0,0,0,0,0,0,0,0,0,0
153929,2021,Dominican Republic,Germany,0,3,12,15,20/06/2021,0,0,0,0,7,0,11,18,5,3,9,17,1,0,0,1,3,2,0,5
153929,2021,Japan,Germany,2,3,9,14,19/06/2021,0,0,0,0,7,1,5,13,2,5,3,10,0,0,1,1,0,0,0,0
153929,2021,Germany,Serbia,1,4,13,18,18/06/2021,0,0,1,1,2,0,5,7,2,1,2,5,0,0,0,0,4,1,0,5
153929,2021,Germany,Poland,2,1,9,12,14/06/2021,0,0,0,0,7,0,2,9,3,7,4,14,0,0,0,0,0,1,0,1
153929,2021,Germany,Brazil,0,4,10,14,13/06/2021,0,0,2,2,7,2,3,12,1,6,5,12,0,0,1,1,0,0,0,0
153929,2021,Thailand,Germany,1,2,10,13,12/6/2021,0,0,3,3,6,1,11,18,1,9,13,23,0,0,5,5,3,1,0,4
153929,2021,Germany,Korea,0,1,14,15,8/6/2021,0,0,4,4,6,1,4,11,1,6,1,8,0,0,1,1,3,1,0,4
153929,2021,Germany,Italy,1,2,5,8,7/6/2021,0,0,0,0,3,0,8,11,1,7,6,14,0,0,0,0,4,0,0,4
153929,2021,Germany,USA,1,2,7,10,6/6/2021,0,0,2,2,0,0,2,2,3,2,1,6,0,0,0,0,1,0,0,1
153929,2021,Germany,Canada,1,3,11,15,2/6/2021,0,0,1,1,5,1,5,11,1,8,3,12,0,0,0,0,2,0,0,2
153929,2021,Türkiye,Germany,4,3,7,14,1/6/2021,0,0,0,0,3,0,6,9,0,5,4,9,0,0,0,0,2,0,0,2
153929,2021,China,Germany,2,3,17,22,31/05/2021,0,0,0,0,7,2,2,11,4,4,4,12,0,0,0,0,0,2,0,2
153929,2021,Germany,Belgium,2,2,10,14,27/05/2021,0,0,0,0,6,0,1,7,1,1,0,2,0,0,0,0,2,0,0,2
153929,2021,Netherlands,Germany,2,4,16,22,26/05/2021,0,0,2,2,8,2,2,12,1,6,1,8,0,0,0,0,4,0,0,4
153929,2021,Germany,Russia,2,2,12,16,25/05/2021,2,0,0,2,4,0,4,8,1,2,2,5,0,0,0,0,1,0,0,1
177765,2021,Germany,Korea,0,0,0,0,8/6/2021,0,0,0,0,0,0,0,0,0,0,0,0,0,0,0,0,0,0,0,0
177765,2021,Germany,Italy,0,0,0,0,7/6/2021,0,0,0,0,0,0,0,0,0,0,0,0,0,0,0,0,0,0,0,0
177765,2021,Germany,USA,0,0,0,0,6/6/2021,0,0,0,0,0,0,0,0,0,0,0,0,0,0,0,0,0,0,0,0
177765,2021,Germany,Canada,0,0,0,0,2/6/2021,0,0,0,0,0,0,0,0,0,0,0,0,0,0,0,0,0,0,0,0
177765,2021,Türkiye,Germany,0,0,0,0,1/6/2021,0,0,0,0,0,0,0,0,0,0,0,0,0,0,0,0,0,0,0,0
177765,2021,China,Germany,0,0,0,0,31/05/2021,0,0,0,0,0,0,0,0,0,0,0,0,0,0,0,0,0,0,0,0
151986,2021,Thailand,Italy,0,0,0,0,20/06/2021,0,0,0,0,0,0,0,0,0,0,0,0,0,0,0,0,0,0,0,0
151986,2021,Belgium,Italy,1,0,14,15,19/06/2021,10,1,96,107,0,0,1,1,1,2,1,4,0,0,0,0,9,5,0,14
151986,2021,Canada,Italy,0,0,18,18,18/06/2021,23,0,58,81,1,0,0,1,1,3,2,6,0,0,0,0,6,0,0,6
151986,2021,China,Italy,0,0,7,7,14/06/2021,9,1,62,72,0,0,0,0,0,0,0,0,0,0,0,0,1,1,0,2
151986,2021,Italy,Netherlands,1,0,19,20,13/06/2021,9,0,120,129,0,0,0,0,0,3,4,7,0,0,0,0,7,5,0,12
151986,2021,Dominican Republic,Italy,2,0,17,19,12/6/2021,19,0,117,136,0,0,0,0,0,5,1,6,0,1,0,1,3,2,0,5
151986,2021,Italy,USA,1,0,16,17,8/6/2021,12,0,82,94,0,0,1,1,0,0,4,4,0,0,0,0,6,2,0,8
151986,2021,Germany,Italy,2,0,16,18,7/6/2021,15,1,52,68,1,0,0,1,0,1,1,2,0,0,0,0,8,1,0,9
151986,2021,Italy,Korea,4,0,24,28,6/6/2021,18,1,104,123,0,0,2,2,1,3,12,16,0,0,0,0,9,3,1,13
151986,2021,Brazil,Italy,2,1,11,14,2/6/2021,24,0,75,99,1,0,1,2,0,5,2,7,0,0,0,0,5,3,2,10
151986,2021,Italy,Japan,1,1,19,21,1/6/2021,14,0,124,138,1,0,2,3,2,2,4,8,0,0,0,0,7,1,0,8
151986,2021,Russia,Italy,1,0,8,9,31/05/2021,23,1,62,86,0,0,1,1,0,5,1,6,0,0,0,0,3,2,0,5
151986,2021,Serbia,Italy,0,0,8,8,27/05/2021,8,0,37,45,0,0,0,0,0,1,1,2,0,0,0,0,2,0,0,2
151986,2021,Türkiye,Italy,1,0,5,6,26/05/2021,6,0,40,46,1,0,0,1,0,0,0,0,0,0,0,0,1,2,0,3
151986,2021,Italy,Poland,0,0,15,15,25/05/2021,35,1,111,147,0,0,0,0,0,1,1,2,0,0,0,0,8,1,0,9
142391,2021,Thailand,Italy,0,0,0,0,20/06/2021,0,0,0,0,0,0,0,0,0,0,0,0,0,0,0,0,0,0,0,0
142391,2021,Belgium,Italy,1,2,11,14,19/06/2021,0,0,0,0,5,1,5,11,1,4,0,5,0,0,0,0,0,1,0,1
142391,2021,Canada,Italy,1,1,12,14,18/06/2021,0,0,0,0,5,1,6,12,1,5,6,12,0,0,0,0,3,1,0,4
142391,2021,China,Italy,0,0,0,0,14/06/2021,0,0,0,0,0,0,0,0,0,0,0,0,0,0,0,0,0,0,0,0
142391,2021,Italy,Netherlands,2,1,17,20,13/06/2021,0,0,2,2,5,0,12,17,1,7,1,9,0,0,0,0,3,3,0,6
142391,2021,Dominican Republic,Italy,0,2,2,4,12/6/2021,0,0,0,0,3,0,2,5,0,1,1,2,0,0,0,0,1,1,0,2
142391,2021,Italy,USA,0,0,0,0,8/6/2021,0,0,0,0,0,0,0,0,0,0,0,0,0,0,0,0,0,0,0,0
142391,2021,Germany,Italy,1,0,7,8,7/6/2021,0,0,2,2,4,0,2,6,0,2,1,3,0,0,0,0,1,0,0,1
142391,2021,Italy,Korea,1,1,14,16,6/6/2021,0,1,1,2,5,0,8,13,1,4,5,10,0,0,1,1,4,1,0,5
142391,2021,Brazil,Italy,0,2,9,11,2/6/2021,0,0,2,2,6,2,1,9,2,4,6,12,0,0,0,0,5,0,0,5
142391,2021,Italy,Japan,0,0,20,20,1/6/2021,0,0,2,2,7,1,6,14,2,4,2,8,0,0,0,0,2,2,0,4
142391,2021,Russia,Italy,1,1,7,9,31/05/2021,0,0,1,1,5,0,1,6,1,2,2,5,0,0,0,0,2,0,0,2
142391,2021,Serbia,Italy,0,0,0,0,27/05/2021,0,0,0,0,0,0,0,0,0,0,0,0,0,0,0,0,0,0,0,0
142391,2021,Türkiye,Italy,0,0,0,0,26/05/2021,0,0,0,0,0,0,0,0,0,0,0,0,0,0,0,0,0,0,0,0
142391,2021,Italy,Poland,0,0,0,0,25/05/2021,0,0,0,0,0,0,0,0,0,0,0,0,0,0,0,0,0,0,0,0
143393,2021,Thailand,Italy,0,0,0,0,20/06/2021,0,0,0,0,0,0,0,0,0,0,0,0,0,0,0,0,0,0,0,0
143393,2021,Belgium,Italy,0,2,11,13,19/06/2021,0,0,0,0,7,2,12,21,0,2,0,2,2,3,23,28,7,4,1,12
143393,2021,Canada,Italy,0,0,0,0,18/06/2021,0,0,0,0,0,1,0,1,0,0,0,0,2,0,0,2,1,0,0,1
143393,2021,China,Italy,0,0,0,0,14/06/2021,0,0,0,0,0,0,0,0,0,0,0,0,0,0,0,0,0,0,0,0
143393,2021,Italy,Netherlands,0,0,0,0,13/06/2021,1,0,0,1,0,0,0,0,0,0,0,0,0,0,0,0,0,0,0,0
143393,2021,Italy,USA,0,0,0,0,8/6/2021,0,0,0,0,0,0,0,0,0,0,0,0,0,0,0,0,0,0,0,0
143393,2021,Germany,Italy,1,1,13,15,7/6/2021,0,0,0,0,8,4,6,18,1,3,0,4,2,1,7,10,6,2,0,8
143393,2021,Italy,Korea,0,3,11,14,6/6/2021,0,0,2,2,8,3,17,28,1,0,0,1,9,3,24,36,12,1,2,15
143393,2021,Brazil,Italy,0,0,0,0,2/6/2021,0,0,0,0,0,0,1,1,0,0,0,0,0,0,1,1,1,0,0,1
143393,2021,Italy,Japan,1,1,8,10,1/6/2021,0,0,1,1,20,5,25,50,5,1,0,6,3,2,12,17,9,3,0,12
143393,2021,Russia,Italy,0,1,8,9,31/05/2021,0,0,4,4,9,6,6,21,0,0,1,1,11,1,25,37,11,3,1,15
143393,2021,Serbia,Italy,0,0,0,0,27/05/2021,0,0,0,0,0,0,0,0,0,0,0,0,0,0,0,0,0,0,0,0
143393,2021,Türkiye,Italy,0,1,3,4,26/05/2021,0,0,0,0,5,2,3,10,0,2,0,2,6,3,10,19,3,0,0,3
143393,2021,Italy,Poland,2,1,17,20,25/05/2021,0,0,1,1,12,9,16,37,2,0,1,3,11,4,33,48,11,3,0,14
151664,2021,Thailand,Italy,0,0,0,0,20/06/2021,0,0,0,0,0,0,0,0,0,0,0,0,0,0,0,0,0,0,0,0
151664,2021,Belgium,Italy,0,4,3,7,19/06/2021,0,0,2,2,19,9,13,41,3,4,0,7,0,0,0,0,6,3,0,9
151664,2021,Canada,Italy,0,3,3,6,18/06/2021,0,0,0,0,18,3,10,31,0,3,3,6,0,0,0,0,5,2,1,8
151664,2021,China,Italy,0,0,0,0,14/06/2021,0,0,0,0,0,0,1,1,0,1,0,1,0,0,0,0,0,0,0,0
151664,2021,Italy,Netherlands,1,4,11,16,13/06/2021,0,0,1,1,25,8,25,58,1,1,1,3,0,0,0,0,15,6,0,21
151664,2021,Dominican Republic,Italy,0,0,0,0,12/6/2021,0,0,0,0,0,0,0,0,0,0,0,0,0,0,0,0,0,0,0,0
151664,2021,Italy,USA,0,4,2,6,8/6/2021,0,0,2,2,6,7,6,19,2,5,2,9,0,0,0,0,8,1,0,9
151664,2021,Germany,Italy,0,0,0,0,7/6/2021,0,0,0,0,0,0,0,0,0,0,0,0,0,0,0,0,0,0,0,0
151664,2021,Italy,Korea,0,2,5,7,6/6/2021,0,0,2,2,15,7,9,31,1,4,0,5,0,1,0,1,7,2,1,10
151664,2021,Brazil,Italy,0,0,0,0,2/6/2021,0,0,0,0,0,0,0,0,0,0,0,0,0,0,0,0,0,0,0,0
151664,2021,Italy,Japan,1,2,11,14,1/6/2021,0,0,4,4,22,11,20,53,1,6,1,8,0,0,0,0,6,6,2,14
151664,2021,Russia,Italy,2,6,7,15,31/05/2021,0,0,1,1,18,6,9,33,2,3,2,7,0,0,0,0,2,3,1,6
151664,2021,Serbia,Italy,0,3,8,11,27/05/2021,0,0,1,1,21,6,17,44,3,2,0,5,0,0,0,0,5,1,1,7
151664,2021,Türkiye,Italy,0,2,2,4,26/05/2021,0,0,2,2,9,3,7,19,0,1,0,1,0,0,0,0,3,5,0,8
151664,2021,Italy,Poland,1,2,0,3,25/05/2021,0,0,0,0,2,1,1,4,0,1,1,2,0,0,0,0,4,0,0,4
143401,2021,Canada,Italy,0,1,0,1,18/06/2021,0,0,0,0,0,0,0,0,0,0,0,0,0,0,0,0,0,0,0,0
143401,2021,China,Italy,2,1,7,10,14/06/2021,0,0,1,1,9,5,12,26,1,0,1,2,0,0,0,0,11,2,0,13
143401,2021,Italy,Netherlands,0,1,1,2,13/06/2021,0,0,0,0,0,0,4,4,0,0,0,0,0,0,1,1,2,0,0,2
143401,2021,Dominican Republic,Italy,0,4,10,14,12/6/2021,0,0,0,0,25,6,29,60,1,3,1,5,0,0,0,0,11,3,0,14
143401,2021,Italy,USA,0,1,3,4,8/6/2021,0,0,0,0,9,1,10,20,0,2,2,4,0,0,0,0,5,3,2,10
143401,2021,Germany,Italy,1,1,8,10,7/6/2021,0,0,3,3,17,3,15,35,1,0,1,2,0,0,0,0,9,1,0,10
143401,2021,Italy,Korea,0,2,2,4,6/6/2021,0,0,0,0,11,1,14,26,0,4,1,5,0,0,0,0,5,0,0,5
143401,2021,Brazil,Italy,0,1,13,14,2/6/2021,0,0,3,3,11,10,20,41,2,2,3,7,0,0,0,0,14,5,4,23
143401,2021,Italy,Japan,0,0,1,1,1/6/2021,0,0,0,0,1,0,1,2,0,0,0,0,0,0,0,0,0,1,0,1
143401,2021,Russia,Italy,0,0,0,0,31/05/2021,0,0,0,0,0,0,0,0,0,0,0,0,0,0,0,0,0,0,0,0
143401,2021,Serbia,Italy,0,1,2,3,27/05/2021,0,0,1,1,4,2,5,11,1,1,0,2,0,0,0,0,2,0,0,2
143401,2021,Türkiye,Italy,0,2,4,6,26/05/2021,0,0,0,0,6,4,4,14,0,0,0,0,0,0,0,0,3,0,0,3
143401,2021,Italy,Poland,1,0,15,16,25/05/2021,0,0,1,1,13,8,21,42,2,2,4,8,0,0,0,0,12,4,0,16
151658,2021,Thailand,Italy,1,3,18,22,20/06/2021,0,0,1,1,7,2,7,16,2,4,11,17,0,0,0,0,3,1,0,4
151658,2021,Belgium,Italy,0,0,1,1,19/06/2021,0,0,0,0,0,2,1,3,0,0,0,0,0,0,0,0,0,0,0,0
151658,2021,Canada,Italy,0,0,0,0,18/06/2021,0,0,0,0,0,0,0,0,0,0,0,0,0,0,0,0,0,0,0,0
151658,2021,China,Italy,1,2,4,7,14/06/2021,0,0,1,1,7,1,4,12,0,2,1,3,0,0,0,0,0,1,1,2
151658,2021,Italy,Netherlands,0,0,1,1,13/06/2021,0,0,0,0,0,1,1,2,0,0,1,1,0,0,0,0,0,0,0,0
151658,2021,Dominican Republic,Italy,0,2,6,8,12/6/2021,0,0,1,1,2,2,4,8,1,1,1,3,0,0,1,1,2,0,0,2
151658,2021,Italy,USA,4,2,10,16,8/6/2021,0,0,2,2,7,0,4,11,1,4,2,7,0,0,0,0,2,0,0,2
151658,2021,Germany,Italy,0,0,0,0,7/6/2021,0,0,0,0,0,0,0,0,0,0,0,0,0,0,1,1,0,0,0,0
151658,2021,Italy,Korea,0,0,0,0,6/6/2021,0,0,0,0,0,0,0,0,0,0,0,0,0,0,0,0,0,0,0,0
151658,2021,Brazil,Italy,3,2,10,15,2/6/2021,0,0,3,3,7,1,7,15,0,6,7,13,0,0,0,0,2,0,0,2
151658,2021,Italy,Japan,0,0,0,0,1/6/2021,0,0,0,0,0,0,0,0,0,0,0,0,0,0,0,0,0,0,0,0
151658,2021,Russia,Italy,0,0,3,3,31/05/2021,0,0,0,0,2,1,2,5,2,0,2,4,0,0,0,0,1,0,0,1
151658,2021,Serbia,Italy,0,3,4,7,27/05/2021,0,0,1,1,1,2,3,6,2,3,2,7,0,0,0,0,1,0,0,1
151658,2021,Türkiye,Italy,0,4,5,9,26/05/2021,0,0,2,2,4,2,1,7,0,1,0,1,0,0,0,0,1,1,0,2
151658,2021,Italy,Poland,4,6,10,20,25/05/2021,0,0,2,2,6,4,6,16,1,8,9,18,0,0,0,0,0,1,0,1
156091,2021,Thailand,Italy,1,0,22,23,20/06/2021,24,4,108,136,0,0,3,3,1,3,5,9,0,0,0,0,9,2,0,11
156091,2021,Belgium,Italy,0,0,1,1,19/06/2021,0,0,13,13,0,0,0,0,0,0,0,0,0,0,0,0,0,0,0,0
156091,2021,China,Italy,0,0,0,0,14/06/2021,0,0,9,9,0,0,0,0,0,0,0,0,0,0,0,0,0,1,1,2
156091,2021,Italy,Netherlands,0,0,0,0,13/06/2021,0,0,8,8,0,0,0,0,0,0,0,0,0,0,0,0,0,0,0,0
156091,2021,Dominican Republic,Italy,0,0,0,0,12/6/2021,1,0,6,7,0,0,0,0,0,0,0,0,0,0,0,0,0,0,0,0
150445,2021,Thailand,Italy,0,0,0,0,20/06/2021,1,0,14,15,0,0,0,0,0,0,0,0,12,1,14,27,18,6,2,26
150445,2021,Belgium,Italy,0,0,0,0,19/06/2021,0,0,0,0,0,0,0,0,0,0,0,0,1,0,2,3,2,0,0,2
150445,2021,Canada,Italy,0,0,0,0,18/06/2021,0,0,0,0,0,0,0,0,0,0,0,0,0,0,0,0,0,0,0,0
150445,2021,China,Italy,0,0,0,0,14/06/2021,0,0,2,2,0,0,0,0,0,0,0,0,1,0,0,1,0,0,0,0
150445,2021,Italy,Netherlands,0,0,0,0,13/06/2021,0,0,24,24,0,0,0,0,0,0,0,0,6,2,15,23,22,5,0,27
150445,2021,Dominican Republic,Italy,0,0,0,0,12/6/2021,0,0,1,1,0,0,0,0,0,0,0,0,3,1,1,5,2,0,0,2
150445,2021,Italy,USA,0,0,0,0,8/6/2021,0,0,6,6,0,0,0,0,0,0,0,0,1,3,6,10,13,3,2,18
150445,2021,Germany,Italy,0,0,0,0,7/6/2021,0,0,0,0,0,0,0,0,0,0,0,0,0,0,2,2,0,1,0,1
150445,2021,Italy,Korea,0,0,0,0,6/6/2021,0,0,1,1,0,0,0,0,0,0,0,0,2,0,3,5,0,2,0,2
150445,2021,Brazil,Italy,0,0,0,0,2/6/2021,0,0,14,14,0,0,0,0,0,0,0,0,6,1,18,25,17,7,1,25
150445,2021,Italy,Japan,0,0,0,0,1/6/2021,0,0,4,4,0,0,0,0,0,0,0,0,4,0,3,7,2,2,0,4
150445,2021,Russia,Italy,0,0,0,0,31/05/2021,0,0,1,1,0,0,0,0,0,0,0,0,0,0,2,2,0,0,1,1
150445,2021,Serbia,Italy,0,0,0,0,27/05/2021,0,0,3,3,0,0,0,0,0,0,0,0,4,0,6,10,3,1,0,4
150445,2021,Türkiye,Italy,0,0,0,0,26/05/2021,0,0,0,0,0,0,0,0,0,0,0,0,0,1,2,3,0,1,0,1
150445,2021,Italy,Poland,0,0,0,0,25/05/2021,0,0,0,0,0,0,0,0,0,0,0,0,0,0,0,0,0,0,0,0
151661,2021,Thailand,Italy,0,0,3,3,20/06/2021,0,0,0,0,0,0,0,0,0,0,0,0,0,0,0,0,1,0,0,1
151661,2021,Belgium,Italy,1,0,25,26,19/06/2021,0,0,2,2,9,1,5,15,3,2,1,6,0,0,0,0,3,3,0,6
151661,2021,Canada,Italy,0,0,9,9,18/06/2021,0,0,0,0,4,1,5,10,2,2,5,9,0,0,0,0,2,1,1,4
151661,2021,China,Italy,0,0,0,0,14/06/2021,0,0,0,0,0,0,0,0,0,0,0,0,0,0,0,0,0,0,0,0
151661,2021,Italy,Netherlands,1,1,12,14,13/06/2021,0,0,0,0,6,1,4,11,4,4,1,9,0,0,0,0,0,2,0,2
151661,2021,Dominican Republic,Italy,0,0,13,13,12/6/2021,0,0,1,1,10,1,5,16,4,3,3,10,0,0,0,0,4,2,0,6
151661,2021,Italy,USA,0,0,7,7,8/6/2021,0,0,0,0,2,0,3,5,1,2,0,3,0,0,0,0,1,1,0,2
151661,2021,Germany,Italy,3,1,10,14,7/6/2021,0,0,3,3,3,1,4,8,2,0,2,4,0,0,0,0,3,2,0,5
151661,2021,Italy,Korea,1,1,15,17,6/6/2021,0,0,1,1,8,2,1,11,5,7,8,20,0,0,0,0,3,0,2,5
151661,2021,Brazil,Italy,0,0,0,0,2/6/2021,0,0,0,0,0,0,0,0,0,0,0,0,0,0,0,0,0,0,0,0
151661,2021,Italy,Japan,1,1,15,17,1/6/2021,0,0,0,0,8,2,6,16,0,1,1,2,0,0,1,1,1,4,0,5
151661,2021,Russia,Italy,1,0,17,18,31/05/2021,0,0,2,2,4,2,0,6,0,2,1,3,0,0,0,0,4,2,0,6
151661,2021,Serbia,Italy,1,1,18,20,27/05/2021,0,0,0,0,2,0,4,6,3,1,0,4,0,0,0,0,3,1,1,5
151661,2021,Türkiye,Italy,0,0,9,9,26/05/2021,0,0,0,0,1,1,3,5,0,4,1,5,0,0,0,0,1,0,1,2
151661,2021,Italy,Poland,0,0,16,16,25/05/2021,0,0,0,0,7,2,9,18,2,3,1,6,0,0,0,0,4,0,0,4
181258,2021,Thailand,Italy,2,3,10,15,20/06/2021,0,0,2,2,4,3,7,14,1,3,8,12,5,0,11,16,15,3,1,19
181258,2021,Belgium,Italy,0,0,4,4,19/06/2021,0,0,0,0,0,0,0,0,0,0,0,0,0,0,0,0,1,1,0,2
181258,2021,Canada,Italy,0,0,0,0,18/06/2021,0,0,0,0,0,0,0,0,0,0,0,0,1,0,2,3,0,0,0,0
181258,2021,China,Italy,0,1,3,4,14/06/2021,0,0,0,0,5,1,8,14,0,0,1,1,4,1,5,10,4,2,0,6
181258,2021,Italy,Netherlands,0,3,10,13,13/06/2021,0,0,1,1,8,5,6,19,2,1,0,3,6,1,17,24,7,4,0,11
181258,2021,Dominican Republic,Italy,0,1,1,2,12/6/2021,0,0,0,0,0,2,6,8,0,0,0,0,1,0,6,7,2,1,0,3
180478,2021,Canada,Italy,0,0,0,0,18/06/2021,0,0,0,0,0,0,0,0,0,0,0,0,0,0,0,0,0,0,0,0
180478,2021,Italy,USA,0,0,0,0,8/6/2021,0,0,6,6,0,0,0,0,0,0,0,0,0,0,0,0,0,0,0,0
180478,2021,Germany,Italy,0,0,0,0,7/6/2021,0,0,0,0,0,0,0,0,0,0,0,0,0,0,0,0,0,0,0,0
180478,2021,Italy,Korea,0,0,1,1,6/6/2021,0,0,4,4,0,0,0,0,0,0,0,0,0,0,0,0,0,0,1,1
180478,2021,Brazil,Italy,0,0,0,0,2/6/2021,1,0,7,8,0,0,0,0,0,0,0,0,0,0,0,0,0,0,0,0
180478,2021,Italy,Japan,0,0,0,0,1/6/2021,0,0,4,4,0,0,0,0,0,0,0,0,0,0,0,0,0,0,0,0
180478,2021,Russia,Italy,0,0,0,0,31/05/2021,0,0,0,0,0,0,0,0,0,0,0,0,0,0,0,0,0,0,0,0
180478,2021,Serbia,Italy,0,3,4,7,27/05/2021,16,2,63,81,0,0,0,0,1,3,2,6,0,0,0,0,7,3,0,10
180478,2021,Türkiye,Italy,0,0,1,1,26/05/2021,5,0,17,22,0,0,0,0,0,1,0,1,0,0,0,0,1,0,0,1
180478,2021,Italy,Poland,0,0,0,0,25/05/2021,1,0,2,3,0,0,0,0,0,0,0,0,0,0,0,0,0,0,0,0
136692,2021,Thailand,Italy,1,3,6,10,20/06/2021,0,0,2,2,11,1,6,18,8,10,10,28,0,0,0,0,6,2,0,8
136692,2021,Belgium,Italy,0,0,0,0,19/06/2021,0,0,0,0,0,0,0,0,0,0,0,0,0,0,0,0,0,0,0,0
136692,2021,China,Italy,0,3,8,11,14/06/2021,0,0,1,1,1,1,4,6,1,2,0,3,0,1,0,1,3,2,0,5
136692,2021,Italy,Netherlands,0,0,0,0,13/06/2021,0,0,0,0,0,0,0,0,0,0,0,0,0,0,0,0,0,0,0,0
136692,2021,Dominican Republic,Italy,0,0,0,0,12/6/2021,0,0,0,0,0,0,0,0,0,0,0,0,0,0,0,0,0,0,0,0
136692,2021,Italy,USA,0,1,7,8,8/6/2021,0,0,0,0,3,0,4,7,2,2,3,7,0,0,0,0,0,0,1,1
136692,2021,Germany,Italy,0,0,0,0,7/6/2021,0,0,0,0,0,0,0,0,0,0,0,0,0,0,0,0,0,0,0,0
136692,2021,Italy,Korea,0,0,0,0,6/6/2021,0,0,0,0,0,0,0,0,0,0,0,0,0,0,0,0,0,0,0,0
136692,2021,Brazil,Italy,0,0,1,1,2/6/2021,0,0,0,0,0,0,0,0,0,0,0,0,0,0,0,0,0,1,0,1
136692,2021,Italy,Japan,0,0,0,0,1/6/2021,0,0,0,0,0,0,0,0,0,0,0,0,0,0,0,0,0,0,0,0
136692,2021,Russia,Italy,0,0,0,0,31/05/2021,0,0,0,0,0,0,0,0,0,0,0,0,0,0,0,0,0,0,0,0
136692,2021,Serbia,Italy,0,0,6,6,27/05/2021,0,0,0,0,3,0,5,8,1,4,1,6,0,0,0,0,1,0,0,1
136692,2021,Türkiye,Italy,0,0,1,1,26/05/2021,0,0,0,0,0,0,0,0,0,0,0,0,0,0,0,0,0,0,0,0
136692,2021,Italy,Poland,0,0,0,0,25/05/2021,0,0,0,0,0,0,0,0,0,0,0,0,0,0,0,0,0,0,0,0
151663,2021,Thailand,Italy,1,1,17,19,20/06/2021,0,0,2,2,17,3,23,43,2,2,0,4,7,0,8,15,7,2,2,11
151663,2021,Belgium,Italy,0,0,2,2,19/06/2021,0,0,2,2,2,1,7,10,0,0,0,0,2,2,10,14,1,0,0,1
151663,2021,Canada,Italy,0,0,9,9,18/06/2021,0,0,1,1,9,1,8,18,2,0,0,2,4,1,20,25,7,2,1,10
151663,2021,China,Italy,0,0,8,8,14/06/2021,0,0,3,3,11,5,17,33,0,0,0,0,6,1,21,28,4,3,0,7
151663,2021,Italy,Netherlands,0,0,15,15,13/06/2021,0,0,3,3,19,2,26,47,2,1,0,3,8,3,24,35,6,7,1,14
151663,2021,Dominican Republic,Italy,0,1,12,13,12/6/2021,0,0,1,1,11,6,13,30,2,1,0,3,9,3,8,20,10,3,0,13
151663,2021,Italy,USA,0,2,7,9,8/6/2021,0,0,3,3,10,3,7,20,2,1,0,3,8,2,38,48,3,1,1,5
151663,2021,Germany,Italy,0,0,2,2,7/6/2021,0,0,0,0,1,0,0,1,1,0,1,2,0,0,0,0,0,0,0,0
151663,2021,Italy,Korea,0,0,0,0,6/6/2021,0,0,0,0,1,0,1,2,0,1,0,1,1,1,0,2,0,0,0,0
151663,2021,Brazil,Italy,0,2,8,10,2/6/2021,0,0,1,1,18,10,14,42,1,0,0,1,4,1,20,25,2,4,2,8
151663,2021,Italy,Japan,1,0,6,7,1/6/2021,0,0,0,0,3,1,4,8,1,0,0,1,4,0,5,9,3,1,0,4
151663,2021,Russia,Italy,0,0,1,1,31/05/2021,0,0,0,0,0,0,0,0,0,0,0,0,0,0,0,0,0,0,0,0
151663,2021,Serbia,Italy,0,0,5,5,27/05/2021,0,0,0,0,3,1,1,5,0,0,0,0,0,0,1,1,3,0,0,3
151663,2021,Türkiye,Italy,0,0,1,1,26/05/2021,0,0,0,0,1,0,0,1,0,0,0,0,0,0,2,2,0,0,0,0
151663,2021,Italy,Poland,0,0,0,0,25/05/2021,0,0,0,0,0,2,0,2,0,0,1,1,0,1,0,1,0,0,0,0
143391,2021,Thailand,Italy,0,1,0,1,20/06/2021,0,0,0,0,0,0,0,0,0,0,0,0,2,0,2,4,1,0,0,1
143391,2021,Belgium,Italy,1,3,6,10,19/06/2021,0,0,0,0,10,4,24,38,2,2,0,4,9,5,12,26,10,2,1,13
143391,2021,Canada,Italy,3,1,13,17,18/06/2021,0,0,3,3,10,2,9,21,0,4,3,7,4,0,8,12,9,1,2,12
143391,2021,Dominican Republic,Italy,0,2,11,13,12/6/2021,0,0,0,0,2,3,13,18,0,0,0,0,6,2,4,12,3,3,0,6
143391,2021,Italy,USA,1,3,9,13,8/6/2021,0,0,1,1,10,4,19,33,0,3,3,6,6,2,10,18,4,1,1,6
143391,2021,Germany,Italy,0,3,4,7,7/6/2021,0,0,1,1,7,0,10,17,0,3,3,6,6,0,8,14,7,1,0,8
143391,2021,Italy,Korea,1,2,8,11,6/6/2021,0,0,2,2,10,7,15,32,0,4,1,5,11,1,7,19,8,0,3,11
143391,2021,Brazil,Italy,0,3,10,13,2/6/2021,0,0,3,3,7,4,17,28,0,1,1,2,5,1,18,24,6,4,1,11
143391,2021,Italy,Japan,2,4,12,18,1/6/2021,0,0,0,0,7,1,9,17,0,1,0,1,15,4,17,36,8,5,0,13
143391,2021,Russia,Italy,0,2,3,5,31/05/2021,0,0,0,0,2,4,13,19,0,0,0,0,0,0,3,3,4,1,0,5
143391,2021,Serbia,Italy,0,1,8,9,27/05/2021,0,0,1,1,10,7,15,32,0,0,2,2,4,0,13,17,6,1,0,7
143391,2021,Türkiye,Italy,0,3,6,9,26/05/2021,0,0,1,1,6,3,7,16,0,0,0,0,5,1,7,13,1,0,0,1
143391,2021,Italy,Poland,2,2,16,20,25/05/2021,0,0,1,1,13,4,25,42,4,5,3,12,4,2,9,15,10,1,1,12
173917,2021,,,-,-,-,-,-,-,-,-,-,-,-,-,-,-,-,-,-,-,-,-,-,-,-,-,-
173402,2021,Thailand,Italy,0,0,0,0,20/06/2021,0,0,1,1,0,0,1,1,0,0,0,0,8,0,1,9,1,0,0,1
173402,2021,Belgium,Italy,0,0,0,0,19/06/2021,0,1,13,14,0,0,0,0,0,0,0,0,9,0,14,23,10,12,2,24
173402,2021,Canada,Italy,0,0,0,0,18/06/2021,0,0,7,7,0,0,0,0,0,0,0,0,4,0,10,14,11,0,3,14
173402,2021,China,Italy,0,0,0,0,14/06/2021,0,0,9,9,0,0,0,0,0,0,0,0,9,1,3,13,7,6,0,13
173402,2021,Italy,Netherlands,0,0,0,0,13/06/2021,0,0,0,0,0,0,0,0,0,0,0,0,1,0,5,6,0,0,0,0
173402,2021,Dominican Republic,Italy,0,0,0,0,12/6/2021,0,0,6,6,0,0,0,0,0,0,0,0,17,3,12,32,18,3,4,25
173402,2021,Italy,USA,0,0,0,0,8/6/2021,0,0,0,0,0,0,0,0,0,0,0,0,1,0,1,2,4,1,0,5
173402,2021,Germany,Italy,0,0,0,0,7/6/2021,0,0,10,10,0,0,0,0,0,0,0,0,9,0,8,17,13,2,3,18
173402,2021,Italy,Korea,0,0,0,0,6/6/2021,0,0,9,9,0,0,0,0,0,0,0,0,12,0,6,18,19,1,3,23
173402,2021,Brazil,Italy,0,0,0,0,2/6/2021,0,0,1,1,0,0,0,0,0,0,0,0,3,1,3,7,2,0,1,3
173402,2021,Italy,Japan,0,0,0,0,1/6/2021,0,0,9,9,0,0,0,0,0,0,0,0,11,0,15,26,18,7,1,26
173402,2021,Russia,Italy,0,0,0,0,31/05/2021,0,0,5,5,0,0,0,0,0,0,0,0,4,0,14,18,9,5,2,16
173402,2021,Serbia,Italy,0,0,0,0,27/05/2021,0,1,7,8,0,0,0,0,0,0,0,0,11,0,6,17,9,6,0,15
173402,2021,Türkiye,Italy,0,0,0,0,26/05/2021,0,0,4,4,0,0,0,0,0,0,0,0,2,0,7,9,8,5,0,13
173402,2021,Italy,Poland,0,0,0,0,25/05/2021,0,0,7,7,0,0,0,0,0,0,0,0,12,1,14,27,24,4,0,28
173730,2021,Thailand,Italy,1,0,15,16,20/06/2021,0,0,2,2,28,5,27,60,4,4,4,12,5,3,14,22,15,3,1,19
173730,2021,Belgium,Italy,0,0,1,1,19/06/2021,0,0,0,0,2,0,2,4,0,0,0,0,0,0,1,1,1,0,0,1
173730,2021,Canada,Italy,0,0,0,0,18/06/2021,0,0,0,0,0,0,0,0,0,0,0,0,0,0,0,0,0,0,0,0
173730,2021,China,Italy,0,0,3,3,14/06/2021,0,0,0,0,4,1,1,6,0,0,0,0,1,2,11,14,0,2,1,3
173730,2021,Italy,Netherlands,1,1,3,5,13/06/2021,0,0,0,0,3,3,7,13,0,1,0,1,2,0,4,6,3,2,0,5
173730,2021,Dominican Republic,Italy,0,0,4,4,12/6/2021,0,0,0,0,3,2,2,7,0,0,0,0,3,0,3,6,0,0,0,0
173730,2021,Italy,USA,0,0,1,1,8/6/2021,0,0,2,2,0,1,0,1,0,0,0,0,0,0,5,5,0,2,0,2
173730,2021,Germany,Italy,0,0,0,0,7/6/2021,0,0,0,0,0,0,0,0,0,0,0,0,0,0,0,0,0,0,0,0
173730,2021,Italy,Korea,0,0,0,0,6/6/2021,0,0,0,0,0,0,0,0,0,0,0,0,0,0,0,0,0,0,0,0
173730,2021,Brazil,Italy,0,0,1,1,2/6/2021,0,0,0,0,0,0,0,0,0,0,0,0,1,0,1,2,1,0,2,3
173730,2021,Italy,Japan,0,0,0,0,1/6/2021,0,0,0,0,0,0,0,0,0,0,0,0,0,0,0,0,0,0,0,0
173730,2021,Russia,Italy,0,0,4,4,31/05/2021,0,0,1,1,5,3,4,12,0,0,0,0,2,3,2,7,4,2,0,6
173730,2021,Serbia,Italy,0,1,11,12,27/05/2021,0,1,0,1,3,7,15,25,1,0,0,1,9,2,29,40,9,2,1,12
173730,2021,Türkiye,Italy,0,0,4,4,26/05/2021,0,0,2,2,2,0,3,5,1,1,0,2,6,0,9,15,4,0,0,4
173730,2021,Italy,Poland,0,0,0,0,25/05/2021,0,0,0,0,0,0,0,0,0,0,0,0,0,0,0,0,0,0,0,0
146401,2021,Japan,Türkiye,0,0,9,9,25/06/2021,0,0,3,3,8,6,14,28,0,2,1,3,1,0,5,6,9,2,0,11
146401,2021,Brazil,Japan,2,2,13,17,24/06/2021,0,0,6,6,15,6,22,43,0,3,3,6,2,0,6,8,19,3,3,25
146401,2021,Japan,Serbia,0,0,0,0,20/06/2021,0,0,0,0,0,0,0,0,0,0,0,0,0,0,0,0,0,0,0,0
146401,2021,Japan,Germany,0,1,14,15,19/06/2021,0,1,1,2,12,6,17,35,1,3,2,6,0,0,2,2,14,4,2,20
146401,2021,Japan,Dominican Republic,2,0,20,22,18/06/2021,0,0,6,6,16,3,24,43,1,2,1,4,1,0,1,2,27,1,1,29
146401,2021,Belgium,Japan,0,1,20,21,14/06/2021,0,0,7,7,9,8,15,32,0,3,1,4,0,0,0,0,20,3,1,24
146401,2021,USA,Japan,3,2,12,17,13/06/2021,0,0,1,1,12,4,14,30,0,2,3,5,0,0,2,2,14,5,0,19
146401,2021,Japan,Türkiye,2,1,10,13,12/6/2021,0,0,4,4,11,7,12,30,2,2,5,9,0,0,1,1,10,6,1,17
146401,2021,Japan,Poland,2,1,18,21,8/6/2021,1,0,2,3,19,7,22,48,0,4,2,6,0,0,0,0,13,5,2,20
146401,2021,Canada,Japan,1,0,22,23,7/6/2021,0,0,1,1,12,3,5,20,0,2,2,4,0,0,0,0,15,3,0,18
146401,2021,Japan,Netherlands,1,0,10,11,6/6/2021,0,0,2,2,18,2,16,36,0,1,1,2,0,0,1,1,9,3,2,14
146401,2021,Japan,Russia,2,2,7,11,2/6/2021,0,1,2,3,9,5,12,26,0,1,1,2,0,0,1,1,2,3,0,5
146401,2021,Italy,Japan,1,4,11,16,1/6/2021,0,0,0,0,14,6,19,39,0,0,0,0,10,0,11,21,11,4,1,16
146401,2021,Brazil,Japan,0,1,7,8,31/05/2021,0,0,0,0,8,4,20,32,0,2,1,3,4,1,7,12,6,3,2,11
146401,2021,Korea,Japan,0,1,9,10,27/05/2021,0,1,0,1,9,2,10,21,1,0,1,2,2,0,5,7,1,0,0,1
146401,2021,China,Japan,1,2,6,9,26/05/2021,0,0,0,0,16,3,16,35,0,0,0,0,1,0,3,4,9,0,0,9
146401,2021,Japan,Thailand,1,1,6,8,25/05/2021,0,0,0,0,9,0,15,24,3,5,2,10,0,0,0,0,9,1,1,11
143437,2021,Japan,Türkiye,1,0,7,8,25/06/2021,0,0,2,2,10,5,11,26,0,1,0,1,7,2,8,17,4,2,0,6
143437,2021,Brazil,Japan,2,0,15,17,24/06/2021,0,0,3,3,16,6,28,50,0,3,4,7,20,1,17,38,13,3,5,21
143437,2021,Japan,Serbia,0,0,1,1,20/06/2021,0,0,0,0,0,0,0,0,0,0,0,0,0,0,0,0,0,0,0,0
143437,2021,Japan,Germany,4,0,15,19,19/06/2021,0,0,2,2,11,2,19,32,1,3,3,7,4,2,15,21,9,2,1,12
143437,2021,Japan,Dominican Republic,2,1,20,23,18/06/2021,0,0,3,3,19,6,32,57,2,4,3,9,20,0,14,34,13,9,2,24
143437,2021,Belgium,Japan,0,1,11,12,14/06/2021,0,0,0,0,21,6,25,52,0,1,3,4,6,1,22,29,16,3,3,22
143437,2021,Japan,Türkiye,0,1,11,12,12/6/2021,0,0,4,4,18,5,17,40,0,0,4,4,11,2,13,26,14,3,0,17
143437,2021,Japan,Poland,0,2,16,18,8/6/2021,0,0,2,2,24,5,14,43,2,4,3,9,17,0,22,39,13,2,1,16
143437,2021,Canada,Japan,0,0,9,9,7/6/2021,0,0,2,2,9,3,13,25,0,1,5,6,9,0,8,17,11,1,0,12
143437,2021,Japan,Netherlands,0,2,9,11,6/6/2021,0,0,1,1,10,5,14,29,0,1,3,4,2,0,6,8,10,1,2,13
143437,2021,Japan,Russia,3,2,12,17,2/6/2021,0,0,1,1,18,3,20,41,0,1,1,2,8,1,9,18,6,4,1,11
143437,2021,Italy,Japan,1,1,21,23,1/6/2021,0,0,1,1,21,7,22,50,1,1,0,2,12,3,6,21,1,1,0,2
143437,2021,Brazil,Japan,0,2,6,8,31/05/2021,0,0,4,4,12,3,18,33,1,5,2,8,5,0,9,14,6,0,0,6
143437,2021,Korea,Japan,0,1,12,13,27/05/2021,0,0,0,0,18,5,11,34,2,0,0,2,14,3,9,26,0,0,0,0
143437,2021,China,Japan,2,1,11,14,26/05/2021,0,0,0,0,11,5,11,27,0,0,1,1,11,0,9,20,10,1,0,11
143437,2021,Japan,Thailand,2,1,11,14,25/05/2021,0,0,0,0,8,2,7,17,2,1,2,5,11,1,5,17,5,0,0,5
141953,2021,Japan,Türkiye,0,1,7,8,25/06/2021,0,0,1,1,2,1,3,6,1,2,2,5,0,0,0,0,1,0,0,1
141953,2021,Brazil,Japan,0,0,8,8,24/06/2021,0,0,2,2,7,3,8,18,1,4,8,13,0,0,0,0,4,0,2,6
141953,2021,Japan,Germany,1,0,6,7,19/06/2021,0,0,1,1,12,1,9,22,0,3,3,6,1,0,1,2,4,1,0,5
141953,2021,Japan,Dominican Republic,0,0,11,11,18/06/2021,0,0,2,2,9,1,12,22,4,6,15,25,0,0,0,0,9,1,0,10
141953,2021,Belgium,Japan,0,0,0,0,14/06/2021,0,0,0,0,0,0,0,0,0,0,0,0,0,0,0,0,0,0,0,0
141953,2021,USA,Japan,1,0,5,6,13/06/2021,0,0,2,2,5,0,7,12,0,6,5,11,1,0,1,2,4,0,1,5
141953,2021,Japan,Türkiye,0,1,5,6,12/6/2021,0,0,0,0,6,2,7,15,2,3,5,10,0,0,1,1,6,0,1,7
141953,2021,Japan,Poland,0,0,0,0,8/6/2021,0,0,0,0,0,0,0,0,0,0,0,0,0,0,0,0,0,0,0,0
141953,2021,Canada,Japan,0,0,0,0,7/6/2021,0,0,0,0,0,0,0,0,0,0,0,0,0,0,0,0,0,0,0,0
141953,2021,Italy,Japan,0,0,3,3,1/6/2021,0,0,1,1,1,1,2,4,0,4,0,4,0,1,0,1,1,0,0,1
141953,2021,Brazil,Japan,1,0,6,7,31/05/2021,1,0,3,4,1,1,6,8,2,3,1,6,1,0,0,1,2,0,1,3
141953,2021,Korea,Japan,0,1,7,8,27/05/2021,0,0,0,0,3,1,10,14,1,0,0,1,4,0,0,4,0,0,0,0
141953,2021,China,Japan,0,1,15,16,26/05/2021,0,0,0,0,7,0,5,12,0,2,2,4,0,0,0,0,2,1,0,3
141953,2021,Japan,Thailand,0,1,10,11,25/05/2021,0,0,0,0,9,0,8,17,2,5,6,13,0,0,0,0,1,0,0,1
119385,2021,,,-,-,-,-,-,-,-,-,-,-,-,-,-,-,-,-,-,-,-,-,-,-,-,-,-
112717,2021,Japan,Türkiye,0,0,10,10,25/06/2021,0,0,1,1,3,0,7,10,2,3,0,5,0,0,0,0,0,2,1,3
112717,2021,Brazil,Japan,0,1,12,13,24/06/2021,0,0,2,2,5,1,4,10,1,8,3,12,0,0,0,0,1,0,0,1
112717,2021,Japan,Serbia,0,0,0,0,20/06/2021,0,0,0,0,0,0,0,0,0,0,0,0,0,0,0,0,0,0,0,0
112717,2021,Japan,Germany,0,0,0,0,19/06/2021,0,0,0,0,0,0,0,0,0,0,0,0,0,0,0,0,0,0,0,0
112717,2021,Japan,Dominican Republic,1,2,15,18,18/06/2021,0,0,4,4,6,3,6,15,0,5,6,11,0,0,1,1,4,1,0,5
112717,2021,Belgium,Japan,1,1,14,16,14/06/2021,0,0,0,0,6,1,7,14,2,8,9,19,0,0,1,1,4,0,0,4
112717,2021,USA,Japan,0,0,0,0,13/06/2021,0,0,0,0,0,0,0,0,0,0,0,0,0,0,0,0,0,0,0,0
112717,2021,Japan,Türkiye,1,0,16,17,12/6/2021,0,0,2,2,5,0,9,14,4,3,9,16,0,0,1,1,1,1,1,3
112717,2021,Japan,Poland,0,1,19,20,8/6/2021,0,0,0,0,8,2,9,19,1,4,6,11,0,0,1,1,6,0,0,6
112717,2021,Canada,Japan,0,0,0,0,7/6/2021,0,0,0,0,0,0,0,0,0,0,0,0,0,0,0,0,0,0,0,0
112717,2021,Japan,Netherlands,1,0,13,14,6/6/2021,0,0,2,2,6,1,8,15,3,5,3,11,0,0,0,0,1,1,4,6
112717,2021,Japan,Russia,1,1,12,14,2/6/2021,0,0,2,2,2,2,4,8,2,0,1,3,1,0,0,1,1,1,0,2
112717,2021,Italy,Japan,3,0,18,21,1/6/2021,0,1,0,1,11,3,6,20,2,8,3,13,0,0,0,0,2,1,0,3
112717,2021,Brazil,Japan,0,0,0,0,31/05/2021,0,0,0,0,0,0,0,0,0,0,0,0,0,0,0,0,0,0,0,0
112717,2021,Korea,Japan,0,0,0,0,27/05/2021,0,0,0,0,0,0,0,0,0,0,0,0,0,0,0,0,0,0,0,0
112717,2021,China,Japan,2,0,10,12,26/05/2021,0,0,1,1,3,1,7,11,1,4,1,6,0,0,0,0,1,0,0,1
112717,2021,Japan,Thailand,2,2,7,11,25/05/2021,0,0,0,0,9,1,4,14,3,2,5,10,3,0,0,3,1,0,0,1
135416,2021,Japan,Türkiye,0,1,2,3,25/06/2021,0,0,0,0,1,0,0,1,0,1,0,1,4,0,5,9,1,1,0,2
135416,2021,Brazil,Japan,0,0,0,0,24/06/2021,0,0,0,0,0,0,0,0,0,0,0,0,0,0,0,0,0,0,0,0
135416,2021,Japan,Serbia,0,1,8,9,20/06/2021,0,0,0,0,12,3,17,32,2,1,0,3,0,0,0,0,7,1,0,8
135416,2021,Japan,Germany,0,0,1,1,19/06/2021,0,0,0,0,0,0,0,0,0,0,0,0,0,2,0,2,0,0,0,0
135416,2021,Japan,Dominican Republic,0,0,0,0,18/06/2021,0,0,0,0,0,0,0,0,0,0,0,0,0,0,0,0,0,0,0,0
135416,2021,Belgium,Japan,0,0,0,0,14/06/2021,0,0,0,0,0,0,0,0,0,0,0,0,0,0,0,0,0,0,0,0
135416,2021,USA,Japan,0,0,12,12,13/06/2021,0,0,6,6,11,5,23,39,1,1,2,4,12,4,15,31,8,3,1,12
135416,2021,Japan,Türkiye,0,0,5,5,12/6/2021,0,0,1,1,3,0,3,6,0,0,0,0,3,1,4,8,1,0,0,1
135416,2021,Japan,Poland,0,0,0,0,8/6/2021,0,0,0,0,0,0,0,0,0,0,0,0,0,0,6,6,2,1,0,3
135416,2021,Canada,Japan,0,0,0,0,7/6/2021,0,0,0,0,0,0,0,0,0,0,0,0,0,0,0,0,0,0,0,0
135416,2021,Japan,Netherlands,0,0,1,1,6/6/2021,0,0,0,0,0,1,3,4,0,0,0,0,2,1,2,5,0,1,0,1
135416,2021,Japan,Russia,0,0,0,0,2/6/2021,0,0,0,0,0,0,0,0,0,0,0,0,0,0,0,0,0,0,0,0
135416,2021,Italy,Japan,0,0,0,0,1/6/2021,0,0,1,1,1,1,0,2,0,0,0,0,3,1,2,6,0,0,0,0
135416,2021,Brazil,Japan,0,0,1,1,31/05/2021,0,0,0,0,0,0,0,0,0,0,0,0,1,0,1,2,0,0,0,0
135416,2021,Korea,Japan,0,0,2,2,27/05/2021,0,0,0,0,0,0,0,0,0,0,0,0,0,0,0,0,0,0,0,0
135416,2021,China,Japan,0,0,1,1,26/05/2021,0,0,0,0,0,0,0,0,0,0,0,0,0,0,0,0,0,0,0,0
135416,2021,Japan,Thailand,0,0,2,2,25/05/2021,0,0,0,0,0,0,0,0,0,0,0,0,0,0,0,0,0,0,0,0
162218,2021,Japan,Türkiye,0,1,6,7,25/06/2021,0,0,0,0,6,5,8,19,0,0,0,0,11,0,12,23,2,1,3,6
162218,2021,Brazil,Japan,0,1,14,15,24/06/2021,0,0,5,5,17,8,17,42,1,2,1,4,17,0,21,38,9,4,0,13
162218,2021,Japan,Serbia,0,0,0,0,20/06/2021,0,0,0,0,0,0,0,0,0,0,0,0,0,0,0,0,0,0,0,0
162218,2021,Japan,Germany,0,0,10,10,19/06/2021,0,0,4,4,16,5,16,37,1,2,1,4,8,3,23,34,11,3,1,15
162218,2021,Japan,Dominican Republic,0,1,11,12,18/06/2021,0,0,6,6,23,2,27,52,1,1,3,5,16,1,12,29,18,3,2,23
162218,2021,Belgium,Japan,1,1,17,19,14/06/2021,0,0,0,0,11,7,19,37,0,0,1,1,12,1,21,34,16,4,2,22
162218,2021,USA,Japan,0,1,2,3,13/06/2021,0,0,2,2,2,2,5,9,0,1,0,1,2,1,1,4,1,0,0,1
162218,2021,Japan,Türkiye,2,1,16,19,12/6/2021,0,0,3,3,9,3,22,34,1,2,2,5,9,2,12,23,13,1,1,15
162218,2021,Japan,Poland,1,3,14,18,8/6/2021,0,0,1,1,19,7,16,42,1,2,4,7,20,0,14,34,10,5,0,15
162218,2021,Canada,Japan,5,0,13,18,7/6/2021,0,0,1,1,8,5,12,25,0,2,2,4,4,1,1,6,9,0,1,10
162218,2021,Japan,Netherlands,0,1,7,8,6/6/2021,0,0,2,2,5,5,7,17,0,0,1,1,6,1,20,27,9,4,2,15
162218,2021,Japan,Russia,1,0,12,13,2/6/2021,0,0,2,2,19,1,12,32,0,1,0,1,11,0,4,15,7,1,0,8
162218,2021,Italy,Japan,1,0,12,13,1/6/2021,0,0,0,0,17,2,23,42,2,3,0,5,15,2,10,27,9,5,0,14
162218,2021,Brazil,Japan,1,1,9,11,31/05/2021,0,0,1,1,10,7,6,23,0,1,1,2,17,2,11,30,8,1,0,9
162218,2021,Korea,Japan,1,1,12,14,27/05/2021,0,0,0,0,17,3,16,36,0,0,1,1,7,0,2,9,2,0,1,3
162218,2021,China,Japan,2,1,9,12,26/05/2021,0,0,2,2,15,3,10,28,1,0,0,1,13,0,6,19,8,1,0,9
162218,2021,Japan,Thailand,0,0,11,11,25/05/2021,0,0,0,0,8,1,5,14,1,2,2,5,11,0,6,17,3,1,0,4
143376,2021,Japan,Türkiye,0,0,2,2,25/06/2021,2,0,13,15,0,0,0,0,0,0,0,0,0,0,0,0,0,0,0,0
143376,2021,Brazil,Japan,0,0,3,3,24/06/2021,2,0,3,5,0,0,0,0,0,0,0,0,0,0,0,0,1,1,0,2
143376,2021,Japan,Germany,0,1,6,7,19/06/2021,0,0,8,8,0,0,0,0,0,0,0,0,0,0,0,0,0,0,0,0
143376,2021,Japan,Dominican Republic,0,0,2,2,18/06/2021,0,0,0,0,0,0,0,0,0,0,0,0,0,0,0,0,0,0,0,0
143376,2021,Belgium,Japan,0,0,3,3,14/06/2021,6,0,16,22,1,0,0,1,0,0,0,0,0,0,0,0,0,1,0,1
143376,2021,USA,Japan,0,0,7,7,13/06/2021,10,1,76,87,1,0,2,3,0,3,0,3,0,0,0,0,14,2,2,18
143376,2021,Japan,Türkiye,0,0,3,3,12/6/2021,0,0,11,11,0,0,0,0,0,0,0,0,0,0,0,0,2,1,0,3
143376,2021,Japan,Netherlands,0,0,0,0,6/6/2021,0,0,0,0,0,0,0,0,0,0,0,0,0,0,0,0,0,0,0,0
143376,2021,Japan,Russia,0,0,1,1,2/6/2021,0,0,6,6,0,0,0,0,0,0,0,0,0,0,0,0,0,0,0,0
143376,2021,Italy,Japan,0,0,2,2,1/6/2021,1,0,19,20,0,0,1,1,1,0,0,1,0,0,0,0,1,0,0,1
143376,2021,Brazil,Japan,0,0,0,0,31/05/2021,1,0,4,5,0,0,0,0,0,0,0,0,0,0,0,0,3,0,0,3
143376,2021,Korea,Japan,0,0,1,1,27/05/2021,1,0,12,13,0,0,0,0,0,0,0,0,0,0,0,0,0,0,0,0
143376,2021,China,Japan,0,0,0,0,26/05/2021,0,0,0,0,0,0,0,0,0,0,0,0,0,0,0,0,0,0,0,0
143376,2021,Japan,Thailand,0,0,3,3,25/05/2021,1,0,14,15,0,0,0,0,0,0,0,0,0,0,0,0,2,0,1,3
119378,2021,Japan,Serbia,1,1,9,11,20/06/2021,0,0,0,0,4,2,4,10,2,1,1,4,1,0,0,1,2,2,0,4
119378,2021,USA,Japan,0,1,1,2,13/06/2021,0,0,0,0,0,0,1,1,0,0,0,0,0,0,0,0,0,0,0,0
119378,2021,Japan,Türkiye,0,0,0,0,12/6/2021,0,0,0,0,0,0,0,0,0,0,0,0,0,0,0,0,0,0,0,0
119378,2021,Japan,Poland,0,0,0,0,8/6/2021,0,0,0,0,0,0,0,0,0,0,0,0,0,0,0,0,0,0,0,0
119378,2021,Canada,Japan,0,1,2,3,7/6/2021,0,0,0,0,2,0,4,6,0,0,0,0,0,0,0,0,3,0,0,3
119378,2021,Japan,Netherlands,0,0,0,0,6/6/2021,0,0,0,0,0,0,0,0,0,0,0,0,0,0,0,0,0,0,0,0
119378,2021,Japan,Russia,0,0,0,0,2/6/2021,0,0,0,0,0,0,0,0,0,0,0,0,0,0,0,0,0,0,0,0
119378,2021,Italy,Japan,0,0,0,0,1/6/2021,0,0,0,0,0,0,0,0,0,0,0,0,0,0,0,0,0,0,0,0
119378,2021,Brazil,Japan,0,0,0,0,31/05/2021,0,0,0,0,0,0,0,0,0,0,0,0,0,0,0,0,0,0,0,0
141956,2021,Japan,Türkiye,0,0,1,1,25/06/2021,0,0,1,1,0,0,0,0,0,0,0,0,0,0,0,0,0,0,0,0
141956,2021,Brazil,Japan,0,0,3,3,24/06/2021,0,0,0,0,0,0,0,0,0,0,0,0,0,0,0,0,0,0,0,0
141956,2021,Japan,Serbia,2,2,13,17,20/06/2021,0,0,0,0,8,3,8,19,1,0,0,1,8,1,9,18,7,2,0,9
141956,2021,Japan,Germany,0,0,0,0,19/06/2021,0,0,0,0,0,0,0,0,0,0,0,0,0,0,0,0,0,0,0,0
141956,2021,Japan,Dominican Republic,0,0,3,3,18/06/2021,0,0,0,0,0,0,0,0,0,0,0,0,0,0,0,0,0,1,0,1
141956,2021,Belgium,Japan,0,1,1,2,14/06/2021,0,0,0,0,0,0,0,0,0,0,0,0,0,0,0,0,0,0,0,0
141956,2021,USA,Japan,0,0,3,3,13/06/2021,0,0,1,1,2,1,2,5,0,0,0,0,1,0,1,2,0,1,1,2
141956,2021,Japan,Türkiye,0,0,5,5,12/6/2021,0,0,0,0,0,0,0,0,0,0,0,0,0,0,0,0,1,0,0,1
141956,2021,Japan,Poland,1,0,5,6,8/6/2021,0,0,0,0,0,0,0,0,0,0,0,0,0,0,0,0,0,2,1,3
141956,2021,Canada,Japan,0,0,3,3,7/6/2021,0,0,0,0,1,0,0,1,0,0,0,0,0,0,0,0,0,0,0,0
141956,2021,Japan,Netherlands,0,0,0,0,6/6/2021,0,0,0,0,0,0,0,0,0,0,0,0,0,0,0,0,0,0,0,0
141956,2021,Japan,Russia,0,0,0,0,2/6/2021,0,0,0,0,0,0,0,0,0,0,0,0,0,0,0,0,0,0,0,0
141956,2021,Italy,Japan,0,0,1,1,1/6/2021,0,0,0,0,0,0,0,0,0,0,0,0,0,0,0,0,0,0,0,0
138802,2021,Japan,Türkiye,0,0,0,0,25/06/2021,0,0,0,0,0,0,0,0,0,0,0,0,0,0,0,0,0,0,0,0
138802,2021,Brazil,Japan,0,0,0,0,24/06/2021,0,0,0,0,0,0,0,0,0,0,0,0,0,0,0,0,0,0,0,0
138802,2021,Japan,Serbia,2,0,13,15,20/06/2021,0,0,2,2,3,1,1,5,1,2,2,5,0,0,1,1,1,2,0,3
138802,2021,Japan,Germany,0,0,0,0,19/06/2021,0,0,0,0,0,0,0,0,0,0,0,0,0,0,0,0,0,0,0,0
138802,2021,Japan,Dominican Republic,0,0,0,0,18/06/2021,0,0,0,0,0,0,0,0,0,0,0,0,0,0,0,0,0,0,0,0
138802,2021,Belgium,Japan,0,0,0,0,14/06/2021,0,0,0,0,0,0,0,0,0,0,0,0,0,0,0,0,0,0,0,0
138802,2021,USA,Japan,0,0,10,10,13/06/2021,0,0,1,1,0,0,6,6,0,3,5,8,0,0,2,2,8,1,0,9
138802,2021,Japan,Türkiye,0,0,0,0,12/6/2021,0,0,0,0,0,0,0,0,0,0,0,0,0,0,0,0,0,0,0,0
138802,2021,Japan,Netherlands,0,0,0,0,6/6/2021,0,0,0,0,0,0,0,0,0,0,0,0,0,0,0,0,0,0,0,0
138802,2021,Japan,Russia,0,0,0,0,2/6/2021,0,0,0,0,0,0,0,0,0,0,0,0,0,0,0,0,0,0,0,0
138802,2021,Italy,Japan,0,0,7,7,1/6/2021,0,0,0,0,1,0,5,6,0,5,3,8,0,0,0,0,0,2,0,2
138802,2021,Brazil,Japan,0,0,12,12,31/05/2021,0,0,2,2,2,1,9,12,2,4,0,6,0,0,1,1,1,0,2,3
138802,2021,Korea,Japan,2,1,13,16,27/05/2021,0,0,0,0,5,1,4,10,3,0,0,3,0,0,1,1,0,0,0,0
138802,2021,China,Japan,0,0,0,0,26/05/2021,0,0,0,0,0,0,0,0,0,0,0,0,0,0,0,0,0,0,0,0
138802,2021,Japan,Thailand,0,0,0,0,25/05/2021,0,0,0,0,0,0,0,0,0,0,0,0,0,0,0,0,0,0,0,0
162767,2021,Japan,Türkiye,0,0,0,0,25/06/2021,0,0,6,6,0,0,0,0,0,0,0,0,7,0,3,10,6,3,2,11
162767,2021,Brazil,Japan,0,0,0,0,24/06/2021,0,0,9,9,0,0,0,0,0,0,0,0,7,2,6,15,15,2,2,19
162767,2021,Japan,Serbia,0,0,0,0,20/06/2021,0,0,2,2,0,0,0,0,0,0,0,0,0,0,0,0,6,1,0,7
162767,2021,Japan,Germany,0,0,0,0,19/06/2021,0,0,6,6,0,0,0,0,0,0,0,0,5,0,7,12,4,2,0,6
162767,2021,Japan,Dominican Republic,0,0,0,0,18/06/2021,0,0,8,8,0,0,0,0,0,0,0,0,13,0,10,23,6,2,0,8
162767,2021,Belgium,Japan,0,0,0,0,14/06/2021,0,0,17,17,0,0,0,0,0,0,0,0,4,0,6,10,15,1,2,18
162767,2021,USA,Japan,0,0,0,0,13/06/2021,0,0,0,0,0,0,0,0,0,0,0,0,0,0,0,0,0,0,0,0
162767,2021,Japan,Türkiye,0,0,0,0,12/6/2021,0,0,18,18,0,0,0,0,0,0,0,0,2,0,6,8,19,3,2,24
162767,2021,Japan,Poland,0,0,0,0,8/6/2021,0,0,7,7,0,0,0,0,0,0,0,0,8,0,6,14,10,3,0,13
162767,2021,Canada,Japan,0,0,0,0,7/6/2021,0,0,4,4,0,0,0,0,0,0,0,0,6,1,7,14,14,1,3,18
162767,2021,Japan,Netherlands,0,0,0,0,6/6/2021,0,0,3,3,0,0,0,0,0,0,0,0,4,1,8,13,13,2,0,15
162767,2021,Japan,Russia,0,0,0,0,2/6/2021,0,0,1,1,0,0,0,0,0,0,0,0,0,0,0,0,0,0,0,0
162767,2021,Italy,Japan,0,0,0,0,1/6/2021,0,0,5,5,0,0,0,0,0,0,0,0,18,0,5,23,9,10,1,20
162767,2021,Brazil,Japan,0,0,0,0,31/05/2021,0,0,7,7,0,0,0,0,0,0,0,0,1,0,3,4,8,1,1,10
162767,2021,Korea,Japan,0,0,0,0,27/05/2021,0,0,5,5,0,0,0,0,0,0,0,0,7,0,1,8,6,0,0,6
162767,2021,China,Japan,0,0,0,0,26/05/2021,1,0,5,6,0,0,0,0,0,0,0,0,2,0,1,3,14,5,0,19
162767,2021,Japan,Thailand,0,0,0,0,25/05/2021,0,0,1,1,0,0,0,0,0,0,0,0,1,1,4,6,16,0,1,17
124327,2021,Japan,Türkiye,0,0,0,0,25/06/2021,0,0,0,0,0,0,0,0,0,0,0,0,0,0,0,0,0,0,0,0
124327,2021,Brazil,Japan,0,0,0,0,24/06/2021,0,0,0,0,0,0,0,0,0,0,0,0,0,0,0,0,0,0,0,0
124327,2021,Japan,Serbia,0,0,0,0,20/06/2021,0,0,6,6,0,0,0,0,0,0,0,0,6,0,4,10,4,0,0,4
124327,2021,Japan,Germany,0,0,0,0,19/06/2021,0,0,6,6,0,0,0,0,0,0,0,0,0,0,0,0,16,2,5,23
124327,2021,Japan,Dominican Republic,0,0,0,0,18/06/2021,0,0,3,3,0,0,0,0,0,0,0,0,0,0,0,0,10,4,3,17
124327,2021,Belgium,Japan,0,0,0,0,14/06/2021,0,0,0,0,0,0,0,0,0,0,0,0,0,0,0,0,0,0,0,0
124327,2021,USA,Japan,0,0,0,0,13/06/2021,0,0,14,14,0,0,0,0,0,0,0,0,1,0,5,6,10,5,1,16
124327,2021,Japan,Türkiye,0,0,0,0,12/6/2021,0,0,0,0,0,0,0,0,0,0,0,0,0,0,0,0,0,0,0,0
124327,2021,Japan,Poland,0,0,0,0,8/6/2021,0,0,0,0,0,0,0,0,0,0,0,0,0,0,0,0,4,2,0,6
124327,2021,Canada,Japan,0,0,0,0,7/6/2021,0,0,0,0,0,0,0,0,0,0,0,0,0,0,0,0,0,0,0,0
124327,2021,Japan,Netherlands,0,0,0,0,6/6/2021,0,0,5,5,0,0,0,0,0,0,0,0,3,0,3,6,3,1,0,4
124327,2021,Japan,Russia,0,0,0,0,2/6/2021,0,0,7,7,0,0,0,0,0,0,0,0,10,1,8,19,13,5,2,20
124327,2021,Italy,Japan,0,0,0,0,1/6/2021,0,0,0,0,0,0,0,0,0,0,0,0,0,0,0,0,0,0,0,0
124327,2021,Brazil,Japan,0,0,0,0,31/05/2021,0,0,5,5,0,0,0,0,0,0,0,0,0,0,1,1,1,3,0,4
124327,2021,Korea,Japan,0,0,0,0,27/05/2021,0,0,0,0,0,0,0,0,0,0,0,0,0,0,0,0,0,0,0,0
124327,2021,China,Japan,0,0,0,0,26/05/2021,0,0,0,0,0,0,0,0,0,0,0,0,0,0,0,0,0,0,0,0
124327,2021,Japan,Thailand,0,0,0,0,25/05/2021,0,0,0,0,0,0,0,0,0,0,0,0,0,0,0,0,0,0,0,0
162227,2021,Japan,Türkiye,0,0,0,0,25/06/2021,0,0,0,0,0,0,0,0,0,0,0,0,0,0,0,0,0,0,0,0
162227,2021,Brazil,Japan,0,0,0,0,24/06/2021,0,0,0,0,0,0,0,0,0,0,0,0,0,0,0,0,0,0,0,0
162227,2021,Japan,Serbia,0,0,0,0,20/06/2021,0,0,0,0,0,0,0,0,0,0,0,0,0,0,0,0,0,0,0,0
162227,2021,Japan,Germany,1,0,16,17,19/06/2021,0,0,1,1,5,2,3,10,0,6,2,8,0,0,2,2,4,1,2,7
162227,2021,Japan,Dominican Republic,0,0,0,0,18/06/2021,0,0,0,0,0,0,0,0,0,0,0,0,0,0,0,0,0,0,0,0
162227,2021,Belgium,Japan,0,1,10,11,14/06/2021,0,0,1,1,12,0,7,19,0,5,7,12,0,0,0,0,4,2,1,7
162227,2021,USA,Japan,0,0,0,0,13/06/2021,0,0,0,0,0,0,0,0,0,0,0,0,0,0,0,0,0,0,0,0
162227,2021,Japan,Türkiye,0,0,0,0,12/6/2021,0,0,0,0,0,0,0,0,0,0,0,0,0,0,0,0,0,0,0,0
162227,2021,Japan,Poland,1,0,12,13,8/6/2021,0,0,0,0,3,4,4,11,3,5,2,10,0,0,2,2,3,0,2,5
162227,2021,Canada,Japan,0,1,8,9,7/6/2021,0,0,0,0,9,3,7,19,1,1,1,3,0,0,0,0,7,0,0,7
162227,2021,Japan,Netherlands,0,0,8,8,6/6/2021,0,0,0,0,3,3,7,13,1,5,5,11,0,0,0,0,2,2,1,5
162227,2021,Japan,Russia,0,0,7,7,2/6/2021,0,0,0,0,5,2,8,15,1,0,1,2,1,0,1,2,1,3,0,4
162227,2021,Korea,Japan,0,0,0,0,27/05/2021,0,0,0,0,0,0,0,0,0,0,0,0,0,0,0,0,0,0,0,0
162227,2021,China,Japan,0,0,0,0,26/05/2021,0,0,0,0,0,0,0,0,0,0,0,0,0,0,0,0,0,0,0,0
162227,2021,Japan,Thailand,0,0,0,0,25/05/2021,0,0,0,0,0,0,0,0,0,0,0,0,0,0,0,0,0,0,0,0
151944,2021,Japan,Serbia,1,1,5,7,20/06/2021,2,1,83,86,2,0,0,2,1,1,0,2,0,0,1,1,5,0,1,6
151944,2021,USA,Japan,0,0,2,2,13/06/2021,1,0,9,10,0,0,0,0,0,0,0,0,0,0,0,0,2,1,0,3
151944,2021,Japan,Poland,0,1,0,1,8/6/2021,0,0,0,0,0,0,0,0,0,0,0,0,0,0,0,0,0,0,0,0
151944,2021,Canada,Japan,0,0,4,4,7/6/2021,3,0,3,6,0,0,0,0,0,0,0,0,0,0,0,0,0,1,0,1
151944,2021,Brazil,Japan,0,0,1,1,31/05/2021,1,0,1,2,0,0,2,2,0,1,0,1,1,0,0,1,2,0,0,2
151944,2021,Korea,Japan,0,0,0,0,27/05/2021,0,0,0,0,0,0,0,0,0,0,0,0,0,0,0,0,0,0,0,0
151944,2021,China,Japan,0,0,0,0,26/05/2021,0,0,0,0,0,0,0,0,0,0,0,0,0,0,0,0,0,0,0,0
151944,2021,Japan,Thailand,0,0,0,0,25/05/2021,0,0,0,0,0,0,0,0,0,0,0,0,0,0,0,0,0,0,0,0
151953,2021,Japan,Türkiye,0,1,0,1,25/06/2021,0,0,0,0,0,0,0,0,0,0,0,0,1,0,0,1,0,0,0,0
151953,2021,Brazil,Japan,0,0,3,3,24/06/2021,0,0,0,0,0,0,0,0,0,0,0,0,0,0,0,0,0,0,0,0
151953,2021,Japan,Serbia,1,2,10,13,20/06/2021,0,0,1,1,12,6,12,30,0,0,1,1,6,1,6,13,6,1,0,7
151953,2021,Japan,Germany,0,0,8,8,19/06/2021,0,0,0,0,0,0,0,0,0,0,0,0,0,0,0,0,1,0,0,1
151953,2021,Japan,Dominican Republic,1,0,6,7,18/06/2021,0,0,1,1,0,0,0,0,0,0,0,0,0,0,0,0,0,0,1,1
151953,2021,Belgium,Japan,0,0,0,0,14/06/2021,0,0,0,0,0,0,0,0,0,0,0,0,0,1,0,1,0,0,0,0
151953,2021,USA,Japan,0,1,6,7,13/06/2021,0,0,3,3,8,3,12,23,0,1,1,2,2,0,9,11,10,3,0,13
151953,2021,Japan,Poland,0,0,0,0,8/6/2021,0,0,0,0,0,0,0,0,0,0,0,0,0,0,0,0,0,0,0,0
151953,2021,Canada,Japan,0,0,2,2,7/6/2021,0,0,0,0,0,0,0,0,0,0,0,0,0,0,0,0,0,0,0,0
151953,2021,Japan,Netherlands,0,0,1,1,6/6/2021,0,0,1,1,0,0,0,0,0,0,0,0,0,1,4,5,1,0,0,1
151953,2021,Japan,Russia,0,0,0,0,2/6/2021,0,0,0,0,0,0,0,0,0,0,1,1,0,0,2,2,0,0,0,0
151953,2021,Italy,Japan,0,1,2,3,1/6/2021,0,0,0,0,0,0,1,1,0,0,0,0,0,0,0,0,0,1,0,1
151953,2021,Brazil,Japan,0,0,0,0,31/05/2021,0,0,0,0,1,0,0,1,0,0,1,1,3,0,1,4,0,0,0,0
151953,2021,Korea,Japan,0,0,0,0,27/05/2021,0,0,0,0,0,0,0,0,0,0,0,0,1,0,1,2,0,0,0,0
151953,2021,China,Japan,0,0,1,1,26/05/2021,0,0,0,0,0,0,0,0,0,0,0,0,0,0,0,0,0,0,0,0
151953,2021,Japan,Thailand,0,0,0,0,25/05/2021,0,0,0,0,1,0,5,6,1,0,0,1,0,0,0,0,0,0,1,1
181033,2021,Japan,Türkiye,0,1,3,4,25/06/2021,10,1,53,64,0,0,1,1,0,1,2,3,0,0,0,0,3,5,0,8
181033,2021,Brazil,Japan,0,0,7,7,24/06/2021,38,2,93,133,2,1,1,4,2,6,3,11,0,0,0,0,13,3,0,16
181033,2021,Japan,Serbia,0,0,0,0,20/06/2021,0,0,0,0,0,0,0,0,0,0,0,0,0,0,0,0,0,0,0,0
181033,2021,Japan,Germany,0,1,9,10,19/06/2021,14,2,86,102,1,0,2,3,0,3,2,5,0,0,0,0,12,5,1,18
181033,2021,Japan,Dominican Republic,0,1,8,9,18/06/2021,70,1,87,158,0,0,4,4,2,6,2,10,0,0,0,0,16,2,0,18
181033,2021,Belgium,Japan,0,2,11,13,14/06/2021,33,1,70,104,0,0,1,1,1,4,3,8,0,0,0,0,9,4,3,16
181033,2021,Japan,Türkiye,0,2,9,11,12/6/2021,18,0,77,95,0,1,2,3,2,5,2,9,0,0,0,0,12,1,2,15
181033,2021,Japan,Poland,0,1,11,12,8/6/2021,57,0,94,151,0,0,0,0,0,3,3,6,0,0,0,0,5,7,1,13
181033,2021,Canada,Japan,0,1,2,3,7/6/2021,13,1,70,84,0,0,2,2,3,2,2,7,0,0,0,0,4,0,0,4
181033,2021,Japan,Netherlands,0,0,12,12,6/6/2021,35,2,61,98,0,0,2,2,0,1,1,2,0,0,0,0,7,1,1,9
181033,2021,Japan,Russia,0,1,10,11,2/6/2021,14,0,86,100,0,0,0,0,0,0,2,2,0,0,0,0,4,2,0,6
181033,2021,Italy,Japan,0,1,13,14,1/6/2021,8,0,127,135,2,2,3,7,0,2,1,3,0,0,0,0,0,4,0,4
181033,2021,Brazil,Japan,0,1,8,9,31/05/2021,18,0,67,85,0,1,1,2,0,2,0,2,0,0,0,0,9,1,1,11
181033,2021,Korea,Japan,1,1,10,12,27/05/2021,4,0,91,95,0,0,1,1,0,1,1,2,0,0,1,1,0,0,0,0
181033,2021,China,Japan,0,1,8,9,26/05/2021,43,1,61,105,1,0,3,4,1,2,0,3,0,0,0,0,6,1,0,7
181033,2021,Japan,Thailand,0,2,12,14,25/05/2021,21,1,52,74,0,0,0,0,0,1,1,2,0,0,0,0,1,2,3,6
135943,2021,Korea,Netherlands,1,3,12,16,20/06/2021,0,0,1,1,16,8,17,41,1,2,1,4,4,2,14,20,10,0,5,15
135943,2021,Korea,Türkiye,0,0,9,9,19/06/2021,0,0,3,3,9,2,11,22,0,2,1,3,3,1,8,12,6,1,0,7
135943,2021,Korea,Brazil,0,0,2,2,18/06/2021,0,0,1,1,2,2,5,9,0,1,0,1,7,0,11,18,3,1,1,5
135943,2021,Korea,Canada,0,1,0,1,14/06/2021,0,0,0,0,2,2,5,9,0,0,2,2,0,0,8,8,6,0,0,6
135943,2021,Korea,Serbia,0,1,2,3,13/06/2021,0,0,2,2,6,0,5,11,0,0,0,0,1,0,6,7,3,0,1,4
135943,2021,Russia,Korea,0,0,6,6,12/6/2021,0,0,1,1,0,2,6,8,0,2,1,3,1,1,9,11,4,0,1,5
135943,2021,Germany,Korea,1,1,5,7,8/6/2021,0,0,3,3,2,4,8,14,0,0,0,0,5,2,14,21,5,1,1,7
135943,2021,Korea,USA,0,0,0,0,7/6/2021,0,0,0,0,0,0,0,0,0,0,0,0,0,0,0,0,0,0,0,0
135943,2021,Italy,Korea,4,4,6,14,6/6/2021,0,0,1,1,14,10,20,44,2,2,1,5,9,4,21,34,10,2,5,17
135943,2021,Belgium,Korea,0,3,14,17,2/6/2021,0,0,3,3,23,4,17,44,0,6,2,8,9,2,29,40,18,3,4,25
135943,2021,Dominican Republic,Korea,0,1,7,8,1/6/2021,0,0,1,1,3,2,7,12,0,1,0,1,4,1,12,17,5,0,0,5
135943,2021,Korea,Poland,1,0,6,7,31/05/2021,0,0,0,0,3,4,4,11,0,2,0,2,4,0,10,14,3,0,1,4
135943,2021,Korea,Japan,1,1,7,9,27/05/2021,0,0,0,0,8,5,9,22,1,1,0,2,8,2,15,25,1,0,0,1
135943,2021,Thailand,Korea,1,0,19,20,26/05/2021,0,0,1,1,12,1,11,24,1,2,5,8,17,5,14,36,14,1,1,16
135943,2021,China,Korea,2,2,12,16,25/05/2021,0,0,1,1,14,5,22,41,0,0,3,3,12,3,16,31,10,2,0,12
163822,2021,Korea,Netherlands,0,0,0,0,20/06/2021,0,0,0,0,1,0,0,1,0,0,0,0,0,0,0,0,0,0,0,0
163822,2021,Korea,Türkiye,0,0,2,2,19/06/2021,0,0,1,1,2,0,1,3,1,0,0,1,0,0,0,0,0,0,0,0
163822,2021,Korea,Brazil,0,0,6,6,18/06/2021,0,0,0,0,4,2,3,9,1,5,2,8,0,0,0,0,2,0,0,2
163822,2021,Korea,Canada,0,0,0,0,14/06/2021,0,0,0,0,0,0,0,0,0,0,0,0,0,0,0,0,0,0,0,0
163822,2021,Korea,Serbia,0,2,8,10,13/06/2021,0,0,0,0,4,2,7,13,3,5,8,16,0,0,1,1,3,1,0,4
163822,2021,Russia,Korea,0,0,1,1,12/6/2021,0,0,0,0,0,1,3,4,1,4,2,7,0,1,0,1,2,0,1,3
163822,2021,Korea,USA,0,1,5,6,7/6/2021,0,0,2,2,1,0,6,7,1,2,1,4,0,0,0,0,3,0,0,3
163822,2021,Italy,Korea,0,0,5,5,6/6/2021,0,0,1,1,0,1,1,2,1,1,3,5,0,1,0,1,0,0,0,0
163822,2021,Belgium,Korea,0,0,0,0,2/6/2021,0,0,0,0,0,0,0,0,0,0,0,0,0,0,0,0,0,0,0,0
163822,2021,Dominican Republic,Korea,0,0,0,0,1/6/2021,0,0,0,0,0,0,0,0,0,0,0,0,0,0,0,0,0,0,0,0
163822,2021,Korea,Poland,0,1,5,6,31/05/2021,0,0,1,1,5,1,1,7,2,3,2,7,0,0,0,0,0,1,1,2
163822,2021,Korea,Japan,0,0,0,0,27/05/2021,0,0,0,0,0,0,0,0,0,0,0,0,0,0,0,0,0,0,0,0
163822,2021,Thailand,Korea,0,0,7,7,26/05/2021,0,0,1,1,7,0,2,9,3,3,5,11,0,0,0,0,6,0,0,6
163822,2021,China,Korea,0,0,0,0,25/05/2021,0,0,0,0,0,0,0,0,0,0,0,0,0,0,0,0,0,0,0,0
120148,2021,Korea,Netherlands,0,2,10,12,20/06/2021,9,1,68,78,0,0,1,1,0,1,0,1,0,0,1,1,4,1,4,9
120148,2021,Korea,Türkiye,3,3,11,17,19/06/2021,5,0,89,94,1,0,0,1,0,0,0,0,0,0,1,1,4,7,0,11
120148,2021,Korea,Brazil,2,1,9,12,18/06/2021,31,2,47,80,0,0,0,0,0,0,0,0,0,0,0,0,5,2,3,10
120148,2021,Korea,Canada,0,3,12,15,14/06/2021,17,0,90,107,2,0,0,2,0,2,2,4,0,0,0,0,10,5,2,17
120148,2021,Russia,Korea,1,0,2,3,12/6/2021,1,1,26,28,0,0,0,0,0,1,0,1,0,0,0,0,0,1,1,2
120148,2021,Germany,Korea,0,1,5,6,8/6/2021,1,1,42,44,0,0,1,1,0,1,0,1,0,0,1,1,7,2,0,9
120148,2021,Korea,USA,2,0,3,5,7/6/2021,2,1,15,18,0,0,0,0,0,0,0,0,0,0,0,0,3,2,1,6
120148,2021,Italy,Korea,0,1,11,12,6/6/2021,7,1,53,61,1,0,3,4,0,1,1,2,0,0,0,0,4,2,0,6
120148,2021,Belgium,Korea,0,2,11,13,2/6/2021,7,0,70,77,0,0,1,1,0,0,0,0,0,0,0,0,7,1,0,8
120148,2021,Dominican Republic,Korea,3,2,10,15,1/6/2021,6,0,52,58,1,0,0,1,0,1,2,3,0,0,1,1,8,1,2,11
120148,2021,Korea,Poland,0,2,8,10,31/05/2021,14,0,63,77,0,0,0,0,0,1,1,2,0,0,0,0,8,2,0,10
120148,2021,Korea,Japan,0,0,5,5,27/05/2021,1,1,56,58,0,0,1,1,0,0,0,0,0,0,0,0,0,0,0,0
120148,2021,Thailand,Korea,0,0,4,4,26/05/2021,5,0,9,14,0,0,0,0,0,0,0,0,0,0,0,0,2,1,0,3
181150,2021,Korea,Netherlands,0,0,0,0,20/06/2021,0,0,0,0,0,0,0,0,0,0,0,0,0,0,0,0,0,0,0,0
181150,2021,Korea,Türkiye,0,0,0,0,19/06/2021,0,0,1,1,0,0,0,0,0,0,0,0,3,0,9,12,4,2,0,6
181150,2021,Korea,Brazil,0,0,0,0,18/06/2021,0,0,0,0,0,0,0,0,0,0,0,0,0,0,0,0,0,0,0,0
181150,2021,Korea,Canada,0,0,0,0,14/06/2021,0,0,0,0,0,0,0,0,0,0,0,0,0,0,1,1,0,0,0,0
181150,2021,Korea,Serbia,0,0,0,0,13/06/2021,0,0,0,0,0,0,0,0,0,0,0,0,0,0,0,0,0,0,0,0
181150,2021,Russia,Korea,0,0,0,0,12/6/2021,0,0,0,0,0,0,0,0,0,0,0,0,0,0,0,0,0,0,0,0
181150,2021,Germany,Korea,0,0,0,0,8/6/2021,0,0,0,0,0,0,0,0,0,0,0,0,0,0,2,2,0,0,0,0
181150,2021,Korea,USA,0,0,0,0,7/6/2021,0,0,9,9,0,0,0,0,0,0,0,0,2,1,7,10,10,2,1,13
181150,2021,Italy,Korea,0,0,0,0,6/6/2021,0,0,1,1,0,0,0,0,0,0,0,0,5,0,3,8,6,1,0,7
181150,2021,Belgium,Korea,0,0,0,0,2/6/2021,0,0,0,0,0,0,0,0,0,0,0,0,0,0,0,0,0,0,0,0
181150,2021,Dominican Republic,Korea,0,0,0,0,1/6/2021,0,0,1,1,0,0,0,0,0,0,0,0,0,0,0,0,0,0,0,0
181150,2021,Korea,Poland,0,0,0,0,31/05/2021,0,0,2,2,0,0,0,0,0,0,0,0,3,0,11,14,12,2,1,15
181150,2021,Korea,Japan,0,0,0,0,27/05/2021,0,0,0,0,0,0,0,0,0,0,0,0,0,0,0,0,0,0,0,0
181150,2021,Thailand,Korea,0,0,0,0,26/05/2021,0,0,0,0,0,0,0,0,0,0,0,0,0,0,0,0,0,0,0,0
181150,2021,China,Korea,0,0,0,0,25/05/2021,0,0,0,0,0,0,0,0,0,0,0,0,0,0,0,0,0,0,0,0
181159,2021,Korea,Netherlands,0,2,4,6,20/06/2021,7,0,54,61,0,0,0,0,1,2,1,4,0,0,1,1,11,0,1,12
181159,2021,Korea,Türkiye,0,0,1,1,19/06/2021,2,0,6,8,0,0,0,0,0,0,0,0,0,0,0,0,0,0,0,0
181159,2021,Korea,Brazil,0,0,0,0,18/06/2021,2,0,10,12,0,0,0,0,0,0,0,0,0,0,0,0,1,1,0,2
181159,2021,Korea,Canada,0,0,3,3,14/06/2021,0,1,13,14,0,0,0,0,0,0,0,0,0,0,1,1,3,0,1,4
181159,2021,Korea,Serbia,0,1,6,7,13/06/2021,6,1,61,68,1,0,1,2,1,1,6,8,0,1,0,1,5,0,0,5
181159,2021,Germany,Korea,0,0,0,0,8/6/2021,0,0,0,0,0,0,0,0,0,0,0,0,0,0,0,0,0,0,0,0
181159,2021,Korea,USA,1,2,4,7,7/6/2021,7,0,54,61,0,0,1,1,0,0,0,0,0,0,0,0,5,2,0,7
181159,2021,Italy,Korea,0,1,9,10,6/6/2021,4,0,55,59,0,0,0,0,0,4,1,5,0,0,0,0,3,0,0,3
181159,2021,Belgium,Korea,0,0,12,12,2/6/2021,7,1,55,63,0,1,1,2,0,0,0,0,0,0,0,0,8,1,0,9
181159,2021,Dominican Republic,Korea,0,0,0,0,1/6/2021,1,0,11,12,0,0,0,0,0,0,0,0,0,0,0,0,2,0,0,2
181159,2021,Korea,Poland,0,0,3,3,31/05/2021,5,0,9,14,0,0,0,0,0,0,0,0,0,0,0,0,2,1,1,4
181159,2021,Korea,Japan,0,1,4,5,27/05/2021,2,0,45,47,0,0,1,1,0,0,0,0,0,0,0,0,0,0,0,0
181159,2021,China,Korea,1,1,13,15,25/05/2021,7,1,90,98,0,0,1,1,0,5,0,5,0,0,0,0,4,1,0,5
151959,2021,Korea,Netherlands,0,0,0,0,20/06/2021,0,0,0,0,0,0,0,0,0,0,0,0,0,0,0,0,0,0,0,0
151959,2021,Korea,Türkiye,0,0,0,0,19/06/2021,0,0,0,0,0,0,0,0,0,0,0,0,0,0,0,0,0,0,0,0
151959,2021,Korea,Serbia,0,0,7,7,13/06/2021,5,0,40,45,0,0,1,1,1,2,2,5,0,0,0,0,5,0,0,5
151959,2021,Russia,Korea,1,1,8,10,12/6/2021,6,1,57,64,0,1,0,1,0,0,1,1,0,0,0,0,4,0,0,4
151959,2021,Germany,Korea,1,1,6,8,8/6/2021,2,0,37,39,0,0,0,0,0,0,0,0,0,0,0,0,3,1,0,4
151959,2021,Thailand,Korea,1,1,11,13,26/05/2021,34,2,84,120,1,0,0,1,2,2,5,9,0,0,0,0,7,1,2,10
151959,2021,China,Korea,0,0,7,7,25/05/2021,5,0,32,37,0,0,1,1,0,1,0,1,0,0,0,0,3,1,0,4
168185,2021,Korea,Netherlands,1,0,5,6,20/06/2021,0,0,0,0,0,1,4,5,0,3,4,7,0,0,0,0,1,1,1,3
168185,2021,Korea,Türkiye,1,2,10,13,19/06/2021,0,0,2,2,4,2,4,10,1,2,0,3,0,0,0,0,2,0,0,2
168185,2021,Korea,Brazil,0,0,9,9,18/06/2021,0,0,1,1,0,0,0,0,0,0,0,0,0,0,0,0,1,0,0,1
168185,2021,Korea,Canada,2,4,17,23,14/06/2021,0,0,4,4,5,3,4,12,1,6,3,10,0,0,0,0,3,0,1,4
168185,2021,Korea,Serbia,3,1,15,19,13/06/2021,0,0,2,2,2,0,3,5,0,4,5,9,0,1,0,1,1,0,1,2
168185,2021,Russia,Korea,0,1,3,4,12/6/2021,0,0,0,0,0,0,1,1,0,1,0,1,0,0,0,0,4,0,0,4
168185,2021,Germany,Korea,0,1,3,4,8/6/2021,0,0,0,0,1,1,6,8,0,1,0,1,0,0,0,0,3,1,0,4
168185,2021,Korea,USA,0,0,1,1,7/6/2021,0,0,1,1,2,0,1,3,0,0,0,0,0,0,0,0,1,0,0,1
168185,2021,Italy,Korea,2,0,6,8,6/6/2021,0,0,0,0,2,1,3,6,0,2,2,4,0,0,1,1,2,0,0,2
168185,2021,Belgium,Korea,0,0,8,8,2/6/2021,0,0,1,1,0,0,3,3,0,6,1,7,0,0,0,0,1,2,0,3
168185,2021,Dominican Republic,Korea,1,0,11,12,1/6/2021,0,0,0,0,1,1,7,9,1,2,1,4,0,0,0,0,1,1,0,2
168185,2021,Korea,Poland,0,1,3,4,31/05/2021,0,0,0,0,3,1,0,4,1,0,1,2,0,1,0,1,0,1,1,2
168185,2021,Korea,Japan,0,0,0,0,27/05/2021,0,0,0,0,0,0,0,0,0,0,0,0,0,0,0,0,0,0,0,0
168185,2021,Thailand,Korea,1,1,5,7,26/05/2021,0,0,2,2,5,2,10,17,1,3,4,8,0,0,0,0,1,1,1,3
168185,2021,China,Korea,0,0,0,0,25/05/2021,0,0,0,0,0,0,0,0,0,0,0,0,0,0,0,0,0,0,0,0
116435,2021,Korea,Netherlands,0,0,0,0,20/06/2021,0,0,11,11,0,0,0,0,0,0,0,0,15,1,24,40,18,3,0,21
116435,2021,Korea,Türkiye,0,0,0,0,19/06/2021,0,0,5,5,0,0,0,0,0,0,0,0,9,4,20,33,9,7,1,17
116435,2021,Korea,Brazil,0,0,0,0,18/06/2021,0,0,5,5,0,0,0,0,0,0,0,0,6,2,6,14,14,2,0,16
116435,2021,Korea,Canada,0,0,0,0,14/06/2021,0,0,7,7,0,0,0,0,0,0,0,0,7,1,20,28,22,5,0,27
116435,2021,Korea,Serbia,0,0,0,0,13/06/2021,0,0,6,6,0,0,0,0,0,0,0,0,3,3,12,18,26,5,2,33
116435,2021,Russia,Korea,0,0,0,0,12/6/2021,0,1,4,5,0,0,0,0,0,0,0,0,6,0,10,16,11,2,2,15
116435,2021,Germany,Korea,0,0,0,0,8/6/2021,0,0,7,7,0,0,0,0,0,0,0,0,5,1,14,20,7,4,1,12
116435,2021,Korea,USA,0,0,0,0,7/6/2021,0,0,1,1,0,0,0,0,0,0,0,0,0,0,0,0,1,0,0,1
116435,2021,Italy,Korea,0,0,0,0,6/6/2021,0,0,9,9,0,0,0,0,0,0,0,0,8,1,8,17,11,3,1,15
116435,2021,Belgium,Korea,0,0,0,0,2/6/2021,0,0,12,12,0,0,0,0,0,0,0,0,6,0,18,24,16,4,2,22
116435,2021,Dominican Republic,Korea,0,0,0,0,1/6/2021,1,0,9,10,0,0,0,0,0,0,0,0,7,1,15,23,13,4,0,17
116435,2021,Korea,Poland,0,0,0,0,31/05/2021,0,0,0,0,0,0,0,0,0,0,0,0,0,0,0,0,0,0,0,0
116435,2021,Korea,Japan,0,0,0,0,27/05/2021,0,0,2,2,0,0,0,0,0,0,0,0,6,0,9,15,7,0,0,7
116435,2021,Thailand,Korea,0,0,0,0,26/05/2021,0,0,2,2,0,0,0,0,0,0,0,0,10,0,8,18,19,1,1,21
116435,2021,China,Korea,0,0,0,0,25/05/2021,0,0,8,8,0,0,0,0,0,0,0,0,13,1,8,22,13,3,3,19
116439,2021,Korea,Netherlands,1,1,16,18,20/06/2021,0,0,9,9,19,3,24,46,0,2,4,6,4,1,24,29,12,4,2,18
116439,2021,Korea,Türkiye,1,0,12,13,19/06/2021,0,0,6,6,10,3,8,21,1,0,0,1,3,0,3,6,3,3,0,6
116439,2021,Korea,Brazil,0,0,9,9,18/06/2021,0,0,2,2,16,5,14,35,1,0,2,3,5,1,10,16,7,1,0,8
116439,2021,Korea,Canada,0,1,23,24,14/06/2021,0,0,10,10,21,5,26,52,2,4,6,12,8,2,8,18,10,2,0,12
116439,2021,Korea,Serbia,0,1,19,20,13/06/2021,0,0,5,5,27,5,18,50,0,1,3,4,4,2,13,19,24,1,1,26
116439,2021,Russia,Korea,2,1,9,12,12/6/2021,0,0,2,2,7,2,13,22,0,2,1,3,3,1,9,13,5,3,1,9
116439,2021,Germany,Korea,0,0,11,11,8/6/2021,0,0,5,5,10,3,12,25,0,1,1,2,2,0,14,16,7,3,0,10
116439,2021,Korea,USA,0,0,0,0,7/6/2021,0,0,0,0,0,0,0,0,0,0,0,0,0,0,0,0,0,0,0,0
116439,2021,Italy,Korea,0,0,14,14,6/6/2021,0,1,11,12,12,2,17,31,0,2,3,5,4,1,11,16,16,3,2,21
116439,2021,Belgium,Korea,2,1,12,15,2/6/2021,0,0,8,8,24,6,18,48,1,3,4,8,12,2,19,33,15,3,3,21
116439,2021,Dominican Republic,Korea,0,1,8,9,1/6/2021,0,0,7,7,13,2,16,31,1,2,0,3,4,2,8,14,8,4,0,12
116439,2021,Korea,Poland,0,0,0,0,31/05/2021,0,0,0,0,0,0,0,0,0,0,0,0,0,0,0,0,0,0,0,0
116439,2021,Korea,Japan,1,1,8,10,27/05/2021,0,0,4,4,9,2,21,32,1,0,0,1,11,1,13,25,3,0,0,3
116439,2021,Thailand,Korea,0,0,0,0,26/05/2021,0,0,0,0,0,0,0,0,0,0,0,0,0,0,0,0,0,0,0,0
116439,2021,China,Korea,0,2,11,13,25/05/2021,0,0,2,2,13,8,20,41,1,0,3,4,13,3,13,29,12,1,0,13
112772,2021,Korea,Netherlands,0,0,12,12,20/06/2021,0,0,1,1,5,1,0,6,2,3,2,7,0,0,0,0,2,2,0,4
112772,2021,Korea,Türkiye,0,0,2,2,19/06/2021,0,0,0,0,2,1,5,8,0,2,0,2,1,0,0,1,2,1,0,3
112772,2021,Korea,Brazil,0,0,8,8,18/06/2021,0,0,3,3,5,1,3,9,1,3,1,5,0,0,0,0,0,0,0,0
112772,2021,Korea,Canada,0,0,0,0,14/06/2021,0,0,0,0,0,0,0,0,0,0,0,0,0,0,0,0,0,0,0,0
112772,2021,Korea,Serbia,0,0,0,0,13/06/2021,0,0,0,0,0,0,0,0,0,0,0,0,0,0,0,0,0,0,0,0
112772,2021,Russia,Korea,1,1,3,5,12/6/2021,0,0,0,0,1,0,0,1,1,2,1,4,1,0,0,1,0,0,0,0
112772,2021,Germany,Korea,0,0,1,1,8/6/2021,0,0,0,0,0,0,0,0,0,0,0,0,0,0,0,0,0,0,0,0
112772,2021,Korea,USA,0,1,9,10,7/6/2021,0,1,0,1,1,1,4,6,0,2,2,4,0,0,0,0,2,1,0,3
112772,2021,Italy,Korea,0,0,2,2,6/6/2021,0,0,0,0,2,0,1,3,0,0,4,4,0,0,0,0,1,0,1,2
112772,2021,Belgium,Korea,0,0,7,7,2/6/2021,0,0,0,0,0,0,2,2,0,0,0,0,0,0,0,0,1,0,1,2
112772,2021,Dominican Republic,Korea,0,0,0,0,1/6/2021,0,0,0,0,0,0,0,0,0,0,0,0,0,0,0,0,0,0,0,0
112772,2021,Korea,Poland,0,0,4,4,31/05/2021,0,0,1,1,1,0,2,3,0,5,0,5,1,0,0,1,2,0,0,2
112772,2021,Korea,Japan,0,0,8,8,27/05/2021,0,0,0,0,5,0,1,6,0,0,1,1,1,0,0,1,2,0,0,2
112772,2021,Thailand,Korea,0,0,0,0,26/05/2021,0,0,0,0,0,0,0,0,0,0,0,0,0,0,0,0,0,0,0,0
112772,2021,China,Korea,0,1,10,11,25/05/2021,0,0,0,0,3,2,4,9,1,1,1,3,0,0,0,0,3,0,1,4
131893,2021,Korea,Netherlands,0,3,10,13,20/06/2021,0,0,3,3,24,5,29,58,0,5,1,6,1,0,7,8,11,0,2,13
131893,2021,Korea,Türkiye,0,1,7,8,19/06/2021,0,0,1,1,11,3,18,32,1,2,0,3,1,1,14,16,6,6,0,12
131893,2021,Korea,Brazil,0,0,5,5,18/06/2021,0,0,3,3,3,3,10,16,0,0,0,0,12,1,11,24,6,6,1,13
131893,2021,Korea,Canada,0,3,6,9,14/06/2021,0,0,4,4,22,7,10,39,2,2,2,6,5,6,25,36,6,0,1,7
131893,2021,Korea,Serbia,1,3,7,11,13/06/2021,0,0,3,3,8,0,14,22,3,0,4,7,4,4,13,21,3,1,1,5
131893,2021,Russia,Korea,0,0,4,4,12/6/2021,0,0,1,1,5,0,12,17,2,0,3,5,3,0,11,14,10,1,2,13
131893,2021,Germany,Korea,0,0,7,7,8/6/2021,0,0,1,1,11,3,17,31,2,1,1,4,0,1,3,4,7,2,0,9
131893,2021,Korea,USA,0,1,4,5,7/6/2021,0,0,3,3,3,4,11,18,0,2,2,4,3,1,5,9,5,1,1,7
131893,2021,Italy,Korea,0,2,6,8,6/6/2021,0,0,1,1,8,2,16,26,0,0,4,4,0,0,1,1,2,1,0,3
131893,2021,Belgium,Korea,1,1,3,5,2/6/2021,0,0,5,5,5,6,17,28,1,2,6,9,0,0,0,0,3,1,0,4
131893,2021,Dominican Republic,Korea,0,4,7,11,1/6/2021,3,0,11,14,9,2,11,22,0,3,0,3,0,0,2,2,6,3,0,9
131893,2021,Korea,Poland,0,2,5,7,31/05/2021,0,0,0,0,7,3,18,28,1,0,0,1,2,2,5,9,4,3,0,7
131893,2021,Korea,Japan,0,1,3,4,27/05/2021,0,0,0,0,7,4,15,26,0,1,0,1,0,0,0,0,0,0,0,0
131893,2021,Thailand,Korea,1,2,8,11,26/05/2021,0,0,0,0,19,3,16,38,2,3,7,12,1,0,0,1,6,0,2,8
131893,2021,China,Korea,1,1,4,6,25/05/2021,0,0,0,0,9,5,14,28,0,3,0,3,0,0,0,0,3,1,0,4
116443,2021,Korea,Netherlands,0,1,16,17,20/06/2021,0,0,4,4,5,1,3,9,5,9,7,21,0,0,0,0,4,0,0,4
116443,2021,Korea,Türkiye,0,0,12,12,19/06/2021,0,0,1,1,1,1,8,10,4,3,1,8,0,0,0,0,1,1,1,3
116443,2021,Korea,Brazil,0,0,0,0,18/06/2021,0,0,0,0,0,0,0,0,0,0,0,0,0,0,0,0,0,0,0,0
116443,2021,Korea,Canada,3,2,15,20,14/06/2021,0,0,4,4,8,0,5,13,1,9,2,12,0,0,0,0,8,0,0,8
116443,2021,Korea,Serbia,0,0,0,0,13/06/2021,0,0,0,0,0,0,0,0,0,0,0,0,0,0,0,0,0,0,0,0
116443,2021,Russia,Korea,0,0,3,3,12/6/2021,0,0,1,1,2,0,3,5,1,3,8,12,1,0,0,1,3,0,1,4
116443,2021,Germany,Korea,0,0,9,9,8/6/2021,0,0,5,5,2,2,2,6,1,1,2,4,0,0,0,0,2,0,3,5
116443,2021,Korea,USA,0,0,0,0,7/6/2021,0,0,0,0,0,0,0,0,0,0,0,0,0,0,0,0,0,0,0,0
116443,2021,Italy,Korea,0,1,13,14,6/6/2021,0,0,2,2,6,0,6,12,1,6,0,7,0,0,0,0,2,0,1,3
116443,2021,Belgium,Korea,0,2,16,18,2/6/2021,0,0,1,1,6,2,6,14,3,7,9,19,0,0,0,0,4,1,3,8
116443,2021,Dominican Republic,Korea,0,1,8,9,1/6/2021,0,0,1,1,4,0,4,8,2,2,0,4,0,0,0,0,0,2,0,2
116443,2021,Korea,Poland,0,0,0,0,31/05/2021,0,0,0,0,0,0,0,0,0,0,0,0,0,0,0,0,0,0,0,0
116443,2021,Korea,Japan,0,0,10,10,27/05/2021,0,0,0,0,5,0,3,8,4,0,0,4,0,0,0,0,1,0,0,1
116443,2021,Thailand,Korea,0,1,6,7,26/05/2021,0,0,0,0,4,0,2,6,0,2,2,4,0,0,0,0,0,0,0,0
116443,2021,China,Korea,0,1,11,12,25/05/2021,0,0,0,0,7,1,7,15,1,3,1,5,1,0,0,1,3,0,0,3
181162,2021,Korea,Brazil,0,0,0,0,18/06/2021,0,0,0,0,0,0,0,0,0,0,0,0,0,0,0,0,0,0,0,0
181162,2021,Korea,Canada,0,0,0,0,14/06/2021,0,0,0,0,0,0,0,0,0,0,0,0,0,0,0,0,0,0,0,0
181162,2021,Korea,Serbia,0,0,0,0,13/06/2021,0,0,0,0,0,0,0,0,0,0,0,0,0,0,0,0,0,0,0,0
181162,2021,Russia,Korea,0,0,1,1,12/6/2021,0,0,0,0,0,0,0,0,0,0,0,0,0,0,0,0,0,0,0,0
181162,2021,Germany,Korea,0,0,0,0,8/6/2021,0,0,0,0,0,0,0,0,0,0,0,0,0,0,0,0,0,0,0,0
181162,2021,Korea,USA,0,1,2,3,7/6/2021,0,0,0,0,5,3,7,15,0,0,0,0,4,4,15,23,4,2,0,6
181162,2021,Italy,Korea,0,1,1,2,6/6/2021,0,0,0,0,2,0,2,4,0,0,0,0,1,0,4,5,1,1,0,2
181162,2021,Belgium,Korea,0,0,0,0,2/6/2021,0,0,0,0,0,0,0,0,0,0,0,0,0,0,0,0,0,0,0,0
181162,2021,Dominican Republic,Korea,0,0,0,0,1/6/2021,0,0,0,0,0,0,0,0,0,0,0,0,0,0,0,0,0,0,0,0
181162,2021,Korea,Poland,0,0,1,1,31/05/2021,0,0,0,0,1,1,4,6,0,0,1,1,0,0,0,0,0,0,0,0
181162,2021,Korea,Japan,0,0,0,0,27/05/2021,0,0,0,0,0,0,0,0,0,0,0,0,0,0,0,0,0,0,0,0
181162,2021,Thailand,Korea,0,2,4,6,26/05/2021,0,0,0,0,0,0,0,0,0,0,0,0,0,0,0,0,0,0,0,0
181162,2021,China,Korea,0,0,0,0,25/05/2021,0,0,0,0,0,0,0,0,0,0,0,0,0,0,0,0,0,0,0,0
163832,2021,Korea,Netherlands,0,0,0,0,20/06/2021,0,0,0,0,0,0,0,0,0,0,0,0,0,0,0,0,0,0,0,0
163832,2021,Korea,Türkiye,0,0,3,3,19/06/2021,0,0,0,0,5,5,4,14,0,0,0,0,0,0,0,0,3,0,0,3
163832,2021,Korea,Brazil,0,2,6,8,18/06/2021,0,0,4,4,12,5,10,27,1,0,0,1,0,0,0,0,7,2,3,12
163832,2021,Korea,Canada,2,0,12,14,14/06/2021,0,0,8,8,12,2,17,31,1,7,3,11,0,0,1,1,13,1,0,14
163832,2021,Korea,Serbia,1,2,17,20,13/06/2021,0,0,3,3,11,7,9,27,2,2,2,6,0,0,0,0,7,3,2,12
163832,2021,Russia,Korea,0,0,8,8,12/6/2021,0,0,1,1,9,6,13,28,2,5,3,10,0,0,0,0,3,2,2,7
163832,2021,Germany,Korea,0,0,3,3,8/6/2021,0,0,0,0,4,3,6,13,0,1,1,2,0,0,0,0,1,2,0,3
163832,2021,Korea,USA,1,0,3,4,7/6/2021,0,0,1,1,2,7,13,22,0,0,4,4,0,0,0,0,5,1,0,6
163832,2021,Italy,Korea,0,1,1,2,6/6/2021,0,0,0,0,3,2,4,9,0,1,2,3,1,0,0,1,1,0,0,1
163832,2021,Belgium,Korea,0,1,6,7,2/6/2021,0,0,1,1,8,4,14,26,2,5,5,12,0,0,0,0,6,3,3,12
163832,2021,Dominican Republic,Korea,0,0,0,0,1/6/2021,0,0,0,0,1,1,3,5,0,1,0,1,0,0,0,0,0,1,0,1
163832,2021,Korea,Poland,0,0,2,2,31/05/2021,0,0,0,0,5,4,10,19,1,0,0,1,0,0,0,0,3,2,0,5
163832,2021,Korea,Japan,1,0,7,8,27/05/2021,0,0,0,0,4,4,7,15,0,0,0,0,0,0,0,0,0,0,0,0
163832,2021,Thailand,Korea,0,1,0,1,26/05/2021,0,0,0,0,2,2,4,8,0,0,1,1,0,0,0,0,0,0,0,0
163832,2021,China,Korea,0,0,1,1,25/05/2021,0,0,5,5,2,6,10,18,0,1,1,2,0,0,0,0,1,0,0,1
133482,2021,Korea,Netherlands,0,0,1,1,20/06/2021,0,0,0,0,0,0,2,2,0,0,0,0,0,0,2,2,0,0,0,0
133482,2021,Korea,Türkiye,0,0,4,4,19/06/2021,0,0,0,0,0,0,0,0,0,1,0,1,0,0,2,2,0,0,0,0
133482,2021,Korea,Brazil,0,0,1,1,18/06/2021,0,0,0,0,0,1,2,3,0,1,0,1,0,0,0,0,2,0,0,2
133482,2021,Korea,Canada,0,2,2,4,14/06/2021,0,0,1,1,1,1,1,3,0,0,0,0,1,0,4,5,2,0,0,2
133482,2021,Korea,Serbia,0,0,0,0,13/06/2021,0,0,0,0,0,0,0,0,0,0,0,0,0,0,0,0,0,0,0,0
133482,2021,Russia,Korea,1,0,1,2,12/6/2021,0,0,0,0,1,3,4,8,0,0,0,0,1,0,5,6,2,1,2,5
133482,2021,Germany,Korea,0,0,1,1,8/6/2021,0,0,0,0,0,0,0,0,0,0,0,0,0,0,0,0,0,0,0,0
133482,2021,Korea,USA,0,0,4,4,7/6/2021,0,0,0,0,4,5,14,23,1,4,2,7,4,4,18,26,3,0,1,4
133482,2021,Italy,Korea,0,0,2,2,6/6/2021,0,0,0,0,0,1,1,2,0,0,0,0,1,0,2,3,2,0,1,3
133482,2021,Belgium,Korea,0,0,0,0,2/6/2021,0,0,0,0,0,0,0,0,0,0,0,0,0,0,0,0,0,0,0,0
133482,2021,Dominican Republic,Korea,1,1,3,5,1/6/2021,0,0,2,2,3,6,6,15,0,2,0,2,4,0,4,8,2,0,0,2
133482,2021,Korea,Poland,2,0,13,15,31/05/2021,0,0,0,0,7,4,10,21,0,2,0,2,9,3,17,29,4,2,2,8
133482,2021,Korea,Japan,0,0,3,3,27/05/2021,0,0,0,0,0,1,0,1,0,0,0,0,0,1,3,4,1,0,0,1
133482,2021,Thailand,Korea,1,1,11,13,26/05/2021,0,0,0,0,12,5,19,36,2,3,2,7,6,0,8,14,16,1,0,17
133482,2021,China,Korea,0,0,0,0,25/05/2021,0,0,0,0,1,1,1,3,0,0,0,0,0,0,1,1,0,0,0,0
124071,2021,Korea,Netherlands,0,0,0,0,20/06/2021,0,0,0,0,0,0,0,0,0,0,0,0,0,0,0,0,0,0,0,0
124071,2021,Brazil,Netherlands,0,0,0,0,19/06/2021,0,0,0,0,0,0,0,0,0,0,0,0,0,0,0,0,0,0,0,0
124071,2021,Türkiye,Netherlands,0,0,0,0,18/06/2021,0,0,0,0,0,0,0,0,0,0,0,0,0,0,0,0,0,0,0,0
124071,2021,Netherlands,Dominican Republic,0,0,0,0,14/06/2021,0,0,3,3,0,0,0,0,0,0,0,0,0,0,0,0,3,1,1,5
124071,2021,Poland,Netherlands,0,0,0,0,7/6/2021,0,0,2,2,0,0,0,0,0,0,0,0,1,0,5,6,10,4,2,16
124071,2021,Japan,Netherlands,0,0,0,0,6/6/2021,0,0,0,0,0,0,0,0,0,0,0,0,0,0,0,0,0,0,0,0
124071,2021,Netherlands,Serbia,0,0,0,0,2/6/2021,0,0,0,0,0,0,0,0,0,0,0,0,0,0,0,0,0,0,0,0
124071,2021,USA,Netherlands,0,0,0,0,1/6/2021,0,0,0,0,0,0,0,0,0,0,0,0,0,0,0,0,0,0,0,0
124071,2021,Thailand,Netherlands,0,0,0,0,31/05/2021,0,0,0,0,0,0,0,0,0,0,0,0,2,0,1,3,5,0,0,5
124071,2021,Russia,Netherlands,0,0,0,0,27/05/2021,0,0,0,0,0,0,0,0,0,0,0,0,0,0,0,0,0,0,0,0
124071,2021,Netherlands,Germany,0,0,0,0,26/05/2021,0,0,0,0,0,0,0,0,0,0,0,0,0,0,0,0,0,0,0,0
124071,2021,Netherlands,Belgium,0,0,0,0,25/05/2021,0,0,0,0,0,0,0,0,0,0,0,0,0,0,0,0,0,0,0,0
150828,2021,Korea,Netherlands,0,0,0,0,20/06/2021,0,0,0,0,0,0,0,0,0,0,0,0,0,0,0,0,0,0,0,0
150828,2021,Türkiye,Netherlands,0,0,0,0,18/06/2021,0,0,0,0,0,0,0,0,0,0,0,0,0,0,0,0,0,0,0,0
150828,2021,Netherlands,Dominican Republic,0,0,0,0,14/06/2021,0,0,0,0,0,0,0,0,0,0,0,0,0,0,0,0,0,0,0,0
150828,2021,Italy,Netherlands,0,0,0,0,13/06/2021,0,0,0,0,0,0,0,0,0,0,0,0,0,0,0,0,0,0,0,0
150828,2021,China,Netherlands,0,0,0,0,12/6/2021,0,0,0,0,0,0,0,0,0,0,0,0,0,0,0,0,0,0,0,0
150828,2021,Canada,Netherlands,0,0,0,0,8/6/2021,0,0,0,0,0,0,0,0,0,0,0,0,0,0,0,0,0,0,0,0
150828,2021,Japan,Netherlands,0,0,0,0,6/6/2021,0,0,0,0,0,0,0,0,0,0,0,0,0,0,0,0,0,0,0,0
150828,2021,Netherlands,Serbia,0,0,0,0,2/6/2021,0,0,0,0,0,0,0,0,0,0,0,0,0,0,0,0,0,0,0,0
150828,2021,USA,Netherlands,0,0,0,0,1/6/2021,0,0,0,0,0,0,0,0,0,0,0,0,0,0,0,0,0,0,0,0
150828,2021,Thailand,Netherlands,0,0,0,0,31/05/2021,0,0,0,0,1,0,2,3,0,0,0,0,0,0,0,0,0,0,0,0
150828,2021,Russia,Netherlands,0,0,0,0,27/05/2021,0,0,0,0,0,0,0,0,0,0,0,0,0,0,0,0,0,0,0,0
150828,2021,Netherlands,Germany,0,0,0,0,26/05/2021,0,0,0,0,0,0,0,0,0,0,0,0,0,0,0,0,0,0,0,0
150828,2021,Netherlands,Belgium,0,0,0,0,25/05/2021,0,0,0,0,0,0,0,0,0,0,0,0,0,0,0,0,0,0,0,0
142880,2021,Korea,Netherlands,0,1,7,8,20/06/2021,0,0,0,0,3,1,6,10,0,4,1,5,0,0,0,0,3,1,0,4
142880,2021,Brazil,Netherlands,1,0,12,13,19/06/2021,0,0,1,1,15,4,16,35,1,3,4,8,0,0,0,0,13,2,1,16
142880,2021,Türkiye,Netherlands,0,1,2,3,18/06/2021,0,0,0,0,2,5,2,9,0,1,0,1,0,0,0,0,2,0,0,2
142880,2021,Netherlands,Dominican Republic,0,2,15,17,14/06/2021,0,1,0,1,11,4,15,30,0,2,4,6,0,0,1,1,8,3,2,13
142880,2021,Italy,Netherlands,0,1,5,6,13/06/2021,0,0,0,0,12,3,3,18,0,2,1,3,0,0,0,0,2,1,1,4
142880,2021,China,Netherlands,0,1,6,7,12/6/2021,0,0,2,2,9,1,12,22,1,1,0,2,0,0,0,0,3,3,0,6
142880,2021,Canada,Netherlands,0,0,9,9,8/6/2021,0,0,0,0,4,1,5,10,0,2,0,2,0,0,0,0,3,1,0,4
142880,2021,Poland,Netherlands,0,1,0,1,7/6/2021,0,0,0,0,0,0,0,0,0,0,0,0,0,0,0,0,0,0,0,0
142880,2021,Japan,Netherlands,0,1,1,2,6/6/2021,0,0,0,0,0,0,2,2,0,0,0,0,0,0,0,0,3,1,0,4
142880,2021,Netherlands,Serbia,0,0,1,1,2/6/2021,0,0,0,0,0,0,2,2,0,0,0,0,0,0,0,0,2,0,0,2
151194,2021,Korea,Netherlands,1,2,11,14,20/06/2021,0,0,2,2,5,0,2,7,0,6,5,11,0,0,0,0,3,0,0,3
151194,2021,Brazil,Netherlands,0,1,5,6,19/06/2021,0,0,2,2,3,0,5,8,0,2,2,4,0,0,1,1,2,0,1,3
151194,2021,Türkiye,Netherlands,1,1,11,13,18/06/2021,0,0,1,1,5,0,3,8,0,2,3,5,0,0,0,0,2,0,2,4
151194,2021,Netherlands,Dominican Republic,1,2,15,18,14/06/2021,0,0,1,1,7,1,6,14,3,8,7,18,0,0,0,0,7,0,1,8
151194,2021,Italy,Netherlands,3,3,20,26,13/06/2021,0,0,2,2,11,1,8,20,1,5,3,9,0,0,0,0,4,1,1,6
151194,2021,China,Netherlands,0,0,8,8,12/6/2021,0,0,0,0,1,3,6,10,1,2,1,4,0,0,0,0,0,0,0,0
151194,2021,Canada,Netherlands,1,0,10,11,8/6/2021,0,0,0,0,10,0,2,12,1,3,1,5,0,0,0,0,3,1,0,4
151194,2021,Poland,Netherlands,1,2,14,17,7/6/2021,0,0,1,1,6,1,4,11,1,5,8,14,0,0,0,0,2,2,1,5
151194,2021,Japan,Netherlands,0,1,6,7,6/6/2021,0,0,0,0,5,2,9,16,3,3,7,13,0,0,1,1,1,0,2,3
151194,2021,Netherlands,Serbia,3,1,17,21,2/6/2021,0,0,2,2,9,3,4,16,5,4,6,15,0,0,0,0,3,2,0,5
151194,2021,USA,Netherlands,0,1,6,7,1/6/2021,0,0,0,0,0,0,2,2,0,0,0,0,0,0,0,0,1,0,0,1
151194,2021,Thailand,Netherlands,1,4,13,18,31/05/2021,0,0,0,0,3,0,0,3,0,1,2,3,0,0,0,0,1,1,1,3
167777,2021,Korea,Netherlands,0,0,5,5,20/06/2021,0,0,0,0,1,1,1,3,1,0,1,2,0,0,0,0,0,0,0,0
167777,2021,Brazil,Netherlands,0,0,5,5,19/06/2021,0,0,0,0,2,0,3,5,1,1,1,3,0,0,0,0,2,1,0,3
167777,2021,Türkiye,Netherlands,0,0,0,0,18/06/2021,0,0,0,0,0,0,0,0,0,0,0,0,0,0,0,0,0,0,0,0
167777,2021,Netherlands,Dominican Republic,0,0,2,2,14/06/2021,0,0,0,0,0,0,0,0,0,0,0,0,0,0,0,0,0,0,0,0
167777,2021,Italy,Netherlands,0,0,1,1,13/06/2021,0,0,0,0,0,0,0,0,0,0,0,0,0,0,0,0,0,0,0,0
167777,2021,China,Netherlands,0,0,0,0,12/6/2021,0,0,0,0,0,0,0,0,0,0,0,0,0,0,0,0,0,0,0,0
167777,2021,Canada,Netherlands,0,0,2,2,8/6/2021,0,0,0,0,0,0,1,1,1,0,1,2,0,0,0,0,1,0,0,1
167777,2021,Poland,Netherlands,0,0,0,0,7/6/2021,0,0,0,0,0,0,0,0,0,0,0,0,0,0,0,0,0,0,0,0
167777,2021,Netherlands,Serbia,0,0,3,3,2/6/2021,0,0,0,0,0,0,0,0,0,0,0,0,0,0,0,0,0,1,0,1
167777,2021,USA,Netherlands,0,0,1,1,1/6/2021,0,0,0,0,0,0,0,0,0,0,0,0,0,0,0,0,0,0,0,0
167777,2021,Thailand,Netherlands,0,0,0,0,31/05/2021,0,0,0,0,0,0,0,0,0,0,2,2,0,0,0,0,0,0,0,0
167777,2021,Russia,Netherlands,1,0,4,5,27/05/2021,0,0,0,0,0,0,0,0,0,0,0,0,0,0,0,0,0,0,0,0
167777,2021,Netherlands,Germany,0,1,2,3,26/05/2021,0,0,0,0,0,0,0,0,0,0,0,0,0,0,0,0,0,0,0,0
167777,2021,Netherlands,Belgium,0,0,5,5,25/05/2021,0,0,0,0,0,0,0,0,0,0,0,0,0,0,0,0,0,0,0,0
123468,2021,Korea,Netherlands,0,0,0,0,20/06/2021,0,0,10,10,0,0,0,0,0,0,0,0,2,0,4,6,18,7,6,31
123468,2021,Brazil,Netherlands,0,0,0,0,19/06/2021,0,0,11,11,0,0,0,0,0,0,0,0,4,1,4,9,4,1,6,11
123468,2021,Türkiye,Netherlands,0,0,0,0,18/06/2021,0,0,5,5,0,0,0,0,0,0,0,0,3,1,5,9,12,2,2,16
123468,2021,Netherlands,Dominican Republic,0,0,0,0,14/06/2021,0,0,7,7,0,0,0,0,0,0,0,0,7,0,14,21,9,7,1,17
123468,2021,Italy,Netherlands,0,0,0,0,13/06/2021,0,0,11,11,0,0,0,0,0,0,0,0,9,0,6,15,18,5,1,24
123468,2021,China,Netherlands,0,0,0,0,12/6/2021,0,0,10,10,0,0,0,0,0,0,0,0,6,1,5,12,12,8,2,22
123468,2021,Canada,Netherlands,0,0,0,0,8/6/2021,0,0,6,6,0,0,0,0,0,0,0,0,6,1,9,16,10,1,0,11
123468,2021,Poland,Netherlands,0,0,0,0,7/6/2021,0,0,7,7,0,0,0,0,0,0,0,0,0,0,3,3,5,1,1,7
123468,2021,Japan,Netherlands,0,0,0,0,6/6/2021,0,0,14,14,0,0,0,0,0,0,0,0,4,1,2,7,13,2,2,17
123468,2021,Netherlands,Serbia,0,0,0,0,2/6/2021,0,0,6,6,0,0,0,0,0,0,0,0,6,0,8,14,21,5,4,30
123468,2021,USA,Netherlands,0,0,0,0,1/6/2021,0,0,11,11,0,0,0,0,0,0,0,0,4,0,5,9,13,6,0,19
123468,2021,Thailand,Netherlands,0,0,0,0,31/05/2021,0,1,0,1,0,0,0,0,0,0,0,0,3,0,1,4,7,1,2,10
123468,2021,Russia,Netherlands,0,0,0,0,27/05/2021,0,0,3,3,0,0,0,0,0,0,0,0,10,0,8,18,18,1,0,19
123468,2021,Netherlands,Germany,0,0,0,0,26/05/2021,0,0,6,6,0,0,0,0,0,0,0,0,12,3,27,42,18,0,0,18
123468,2021,Netherlands,Belgium,0,0,0,0,25/05/2021,0,0,2,2,0,0,0,0,0,0,0,0,4,0,6,10,15,2,1,18
162356,2021,Korea,Netherlands,0,0,0,0,20/06/2021,0,0,0,0,0,0,0,0,0,0,0,0,0,0,0,0,0,0,0,0
162356,2021,Brazil,Netherlands,0,0,0,0,19/06/2021,1,0,5,6,0,0,0,0,0,0,0,0,0,0,0,0,0,0,0,0
162356,2021,Türkiye,Netherlands,0,0,0,0,18/06/2021,0,0,0,0,0,0,0,0,0,0,0,0,0,0,0,0,0,0,0,0
162356,2021,Netherlands,Dominican Republic,0,0,0,0,14/06/2021,0,0,0,0,0,0,0,0,0,0,0,0,0,0,0,0,0,0,0,0
162356,2021,Italy,Netherlands,0,0,0,0,13/06/2021,0,0,0,0,0,0,0,0,0,0,0,0,0,0,0,0,0,0,0,0
162356,2021,China,Netherlands,0,0,0,0,12/6/2021,1,0,0,1,0,0,0,0,0,0,0,0,0,0,0,0,0,0,0,0
162356,2021,Canada,Netherlands,0,0,0,0,8/6/2021,0,0,0,0,0,0,0,0,0,0,0,0,0,0,0,0,0,0,0,0
162356,2021,Poland,Netherlands,0,0,0,0,7/6/2021,0,0,0,0,0,0,0,0,0,0,0,0,0,0,0,0,0,0,0,0
162356,2021,Japan,Netherlands,0,0,0,0,6/6/2021,0,0,0,0,0,0,0,0,0,0,0,0,0,0,0,0,0,0,0,0
162356,2021,Netherlands,Serbia,0,0,0,0,2/6/2021,0,0,0,0,0,0,0,0,0,0,0,0,0,0,0,0,0,0,0,0
162356,2021,USA,Netherlands,0,0,0,0,1/6/2021,0,0,0,0,0,0,0,0,0,0,0,0,0,0,0,0,0,0,0,0
162356,2021,Thailand,Netherlands,0,0,1,1,31/05/2021,0,0,0,0,0,0,0,0,0,0,0,0,0,0,0,0,0,0,0,0
162356,2021,Russia,Netherlands,0,0,0,0,27/05/2021,0,0,0,0,0,0,0,0,0,0,0,0,0,0,0,0,0,0,0,0
162356,2021,Netherlands,Germany,0,0,0,0,26/05/2021,0,0,0,0,0,0,0,0,0,0,0,0,0,0,0,0,0,0,0,0
162356,2021,Netherlands,Belgium,0,0,0,0,25/05/2021,0,0,0,0,0,0,0,0,0,0,0,0,0,0,0,0,0,0,0,0
120503,2021,Korea,Netherlands,0,1,13,14,20/06/2021,0,0,1,1,14,6,11,31,1,4,3,8,14,1,21,36,9,4,3,16
120503,2021,Brazil,Netherlands,0,1,9,10,19/06/2021,0,0,2,2,6,3,6,15,0,2,1,3,12,2,12,26,6,5,1,12
120503,2021,Türkiye,Netherlands,1,1,4,6,18/06/2021,0,0,0,0,2,1,5,8,0,0,0,0,3,0,14,17,1,1,0,2
120503,2021,Netherlands,Dominican Republic,0,3,7,10,14/06/2021,0,0,0,0,16,9,23,48,0,4,5,9,11,1,20,32,13,2,3,18
120503,2021,Italy,Netherlands,0,3,6,9,13/06/2021,0,0,2,2,14,4,25,43,1,2,1,4,12,2,19,33,1,2,0,3
120503,2021,China,Netherlands,0,0,8,8,12/6/2021,0,0,0,0,8,4,23,35,1,3,0,4,12,2,12,26,3,2,0,5
120503,2021,Canada,Netherlands,1,0,13,14,8/6/2021,0,0,0,0,11,2,10,23,3,2,0,5,6,0,10,16,2,1,0,3
120503,2021,Poland,Netherlands,0,0,21,21,7/6/2021,0,0,2,2,16,7,22,45,1,4,3,8,15,2,30,47,11,3,1,15
120503,2021,Japan,Netherlands,0,1,4,5,6/6/2021,0,0,1,1,3,3,7,13,0,2,0,2,4,0,11,15,4,1,1,6
120503,2021,Netherlands,Serbia,0,0,0,0,2/6/2021,0,0,0,0,0,0,0,0,0,0,0,0,0,0,0,0,0,0,0,0
120503,2021,USA,Netherlands,0,0,8,8,1/6/2021,0,0,6,6,5,2,24,31,4,4,1,9,9,3,11,23,11,2,2,15
120503,2021,Thailand,Netherlands,3,0,16,19,31/05/2021,0,0,0,0,10,1,8,19,0,1,0,1,5,1,11,17,5,2,3,10
120503,2021,Russia,Netherlands,0,0,17,17,27/05/2021,0,0,1,1,12,2,12,26,3,3,0,6,8,4,15,27,15,2,0,17
120503,2021,Netherlands,Germany,0,1,15,16,26/05/2021,0,0,0,0,13,6,21,40,1,0,0,1,13,3,19,35,9,1,0,10
120503,2021,Netherlands,Belgium,0,1,10,11,25/05/2021,0,0,1,1,12,4,11,27,0,3,4,7,13,2,12,27,10,0,0,10
147432,2021,Korea,Netherlands,1,0,13,14,20/06/2021,35,0,94,129,4,0,4,8,0,8,11,19,0,0,0,0,9,2,1,12
147432,2021,Brazil,Netherlands,0,2,4,6,19/06/2021,17,2,65,84,1,1,2,4,0,1,1,2,0,0,0,0,13,3,1,17
147432,2021,Türkiye,Netherlands,0,2,10,12,18/06/2021,10,0,75,85,2,0,0,2,0,2,3,5,0,0,0,0,5,5,0,10
147432,2021,Netherlands,Dominican Republic,1,0,13,14,14/06/2021,30,0,106,136,1,0,5,6,0,4,1,5,0,0,0,0,5,3,1,9
147432,2021,Italy,Netherlands,0,1,10,11,13/06/2021,22,1,118,141,4,1,3,8,3,3,4,10,0,0,0,0,6,5,0,11
147432,2021,China,Netherlands,1,0,15,16,12/6/2021,6,1,105,112,1,0,0,1,0,3,0,3,0,0,0,0,3,3,0,6
147432,2021,Canada,Netherlands,1,1,6,8,8/6/2021,10,1,67,78,1,0,2,3,2,1,3,6,0,0,0,0,4,3,1,8
147432,2021,Poland,Netherlands,0,0,13,13,7/6/2021,29,0,97,126,2,0,1,3,1,1,2,4,0,1,0,1,12,1,1,14
147432,2021,Japan,Netherlands,0,2,11,13,6/6/2021,35,0,60,95,1,0,3,4,0,3,5,8,0,0,0,0,6,1,3,10
147432,2021,Netherlands,Serbia,0,0,12,12,2/6/2021,28,1,94,123,1,0,2,3,2,2,5,9,0,0,0,0,9,3,1,13
147432,2021,USA,Netherlands,0,2,7,9,1/6/2021,20,0,74,94,0,0,0,0,0,3,4,7,0,1,0,1,6,5,0,11
147432,2021,Thailand,Netherlands,0,0,6,6,31/05/2021,19,0,0,19,4,0,3,7,3,2,1,6,0,0,0,0,2,2,1,5
147432,2021,Russia,Netherlands,3,0,14,17,27/05/2021,22,0,87,109,1,0,2,3,0,3,0,3,0,0,0,0,5,1,0,6
147432,2021,Netherlands,Germany,3,1,14,18,26/05/2021,33,0,103,136,2,0,3,5,0,4,1,5,0,0,0,0,7,0,0,7
147432,2021,Netherlands,Belgium,0,1,8,9,25/05/2021,36,0,62,98,2,0,3,5,1,1,3,5,0,0,0,0,2,1,0,3
167778,2021,Canada,Netherlands,0,0,0,0,8/6/2021,0,0,0,0,0,0,0,0,0,0,0,0,0,0,0,0,0,0,0,0
150807,2021,Brazil,Netherlands,0,0,0,0,19/06/2021,0,0,0,0,0,0,0,0,0,0,0,0,0,0,0,0,0,0,0,0
150807,2021,Türkiye,Netherlands,0,1,0,1,18/06/2021,0,0,0,0,0,0,0,0,0,0,0,0,0,0,0,0,0,0,0,0
159904,2021,Korea,Netherlands,0,0,5,5,20/06/2021,0,0,1,1,0,1,0,1,0,0,0,0,4,0,2,6,3,1,2,6
159904,2021,Brazil,Netherlands,0,0,1,1,19/06/2021,0,0,2,2,2,0,2,4,1,0,2,3,3,0,4,7,1,1,0,2
159904,2021,Türkiye,Netherlands,0,0,6,6,18/06/2021,0,0,2,2,8,2,11,21,0,4,2,6,4,0,9,13,6,1,0,7
159904,2021,Netherlands,Dominican Republic,0,1,1,2,14/06/2021,0,0,1,1,0,0,0,0,0,0,0,0,2,0,7,9,4,0,0,4
159904,2021,Italy,Netherlands,1,0,8,9,13/06/2021,0,0,0,0,0,0,0,0,0,0,0,0,2,1,0,3,2,1,0,3
159904,2021,China,Netherlands,0,0,2,2,12/6/2021,0,0,0,0,0,0,0,0,0,0,0,0,1,0,6,7,2,1,1,4
159904,2021,Canada,Netherlands,0,0,1,1,8/6/2021,0,0,1,1,0,1,1,2,0,0,0,0,0,0,4,4,2,2,0,4
159904,2021,Poland,Netherlands,1,0,5,6,7/6/2021,0,0,0,0,0,0,3,3,0,0,0,0,3,0,3,6,3,1,0,4
159904,2021,Japan,Netherlands,0,1,9,10,6/6/2021,0,0,0,0,5,3,9,17,0,1,3,4,7,0,4,11,10,1,0,11
159904,2021,Netherlands,Serbia,1,0,13,14,2/6/2021,0,0,2,2,4,5,15,24,0,0,1,1,8,0,9,17,15,1,1,17
159904,2021,USA,Netherlands,0,1,1,2,1/6/2021,0,0,0,0,1,0,3,4,0,0,1,1,2,1,5,8,3,2,1,6
159904,2021,Thailand,Netherlands,0,1,2,3,31/05/2021,0,0,0,0,0,0,0,0,0,0,0,0,0,0,1,1,1,0,0,1
159904,2021,Russia,Netherlands,0,0,0,0,27/05/2021,0,0,0,0,0,0,0,0,0,0,0,0,0,1,0,1,0,0,0,0
159904,2021,Netherlands,Germany,0,0,5,5,26/05/2021,0,0,0,0,0,0,0,0,0,0,0,0,0,0,0,0,1,0,0,1
159904,2021,Netherlands,Belgium,0,0,0,0,25/05/2021,0,0,0,0,0,0,0,0,0,0,0,0,0,0,0,0,0,0,0,0
150809,2021,Korea,Netherlands,0,2,13,15,20/06/2021,0,0,4,4,28,7,30,65,2,2,4,8,10,1,27,38,12,4,2,18
150809,2021,Brazil,Netherlands,0,1,10,11,19/06/2021,0,0,4,4,12,2,16,30,0,0,2,2,13,0,16,29,4,2,5,11
150809,2021,Türkiye,Netherlands,1,1,9,11,18/06/2021,0,0,2,2,7,4,8,19,1,2,3,6,9,3,16,28,9,3,0,12
150809,2021,Netherlands,Dominican Republic,3,3,12,18,14/06/2021,0,0,3,3,19,4,20,43,1,1,2,4,5,1,20,26,13,0,3,16
150809,2021,Italy,Netherlands,2,3,13,18,13/06/2021,0,0,0,0,16,1,26,43,2,6,2,10,18,3,22,43,13,3,0,16
150809,2021,China,Netherlands,0,0,10,10,12/6/2021,0,0,1,1,11,4,24,39,0,0,2,2,11,1,20,32,5,4,0,9
150809,2021,Canada,Netherlands,1,1,13,15,8/6/2021,0,0,0,0,7,3,11,21,1,0,1,2,3,1,7,11,3,4,1,8
150809,2021,Poland,Netherlands,1,1,10,12,7/6/2021,0,0,2,2,16,7,16,39,1,3,7,11,6,1,17,24,4,4,2,10
150809,2021,Japan,Netherlands,2,2,9,13,6/6/2021,0,0,0,0,19,3,14,36,1,2,1,4,4,1,24,29,4,2,4,10
150809,2021,Netherlands,Serbia,2,2,10,14,2/6/2021,0,0,0,0,15,5,23,43,3,3,6,12,11,2,29,42,8,0,2,10
150809,2021,USA,Netherlands,0,1,5,6,1/6/2021,0,0,2,2,6,7,20,33,0,3,1,4,5,2,13,20,4,2,1,7
150809,2021,Thailand,Netherlands,0,1,9,10,31/05/2021,0,0,0,0,11,1,9,21,1,3,2,6,12,1,3,16,7,1,0,8
150809,2021,Russia,Netherlands,1,3,12,16,27/05/2021,0,0,0,0,13,4,16,33,1,4,2,7,5,2,16,23,4,6,0,10
150809,2021,Netherlands,Germany,1,4,16,21,26/05/2021,0,0,1,1,21,5,20,46,3,1,0,4,7,0,10,17,13,2,0,15
150809,2021,Netherlands,Belgium,1,1,14,16,25/05/2021,0,0,0,0,7,3,11,21,2,3,2,7,6,0,5,11,8,6,1,15
168147,2021,Korea,Netherlands,0,0,0,0,20/06/2021,0,0,0,0,0,0,0,0,0,0,0,0,0,0,0,0,0,0,0,0
168147,2021,Brazil,Netherlands,0,0,0,0,19/06/2021,0,0,0,0,0,0,0,0,0,0,0,0,0,0,0,0,0,0,0,0
168147,2021,Netherlands,Dominican Republic,0,0,1,1,14/06/2021,0,0,0,0,0,0,0,0,0,0,0,0,0,0,0,0,0,1,0,1
168147,2021,Italy,Netherlands,0,0,0,0,13/06/2021,0,0,0,0,0,0,0,0,0,0,0,0,0,0,0,0,0,0,0,0
168147,2021,China,Netherlands,0,0,2,2,12/6/2021,0,0,0,0,0,0,2,2,0,0,0,0,0,0,0,0,1,0,0,1
168147,2021,Thailand,Netherlands,0,0,0,0,31/05/2021,0,0,0,0,1,0,1,2,0,0,0,0,0,0,0,0,0,0,0,0
172894,2021,Korea,Netherlands,1,2,12,15,20/06/2021,0,0,0,0,8,1,7,16,4,10,9,23,1,0,1,2,5,1,3,9
172894,2021,Brazil,Netherlands,0,1,7,8,19/06/2021,0,0,1,1,5,3,6,14,0,9,4,13,0,0,0,0,0,0,1,1
172894,2021,Türkiye,Netherlands,0,1,6,7,18/06/2021,0,0,2,2,7,0,8,15,2,4,4,10,1,0,0,1,2,0,1,3
172894,2021,Netherlands,Dominican Republic,0,4,8,12,14/06/2021,0,0,2,2,8,5,4,17,1,7,10,18,0,0,1,1,6,0,2,8
172894,2021,Italy,Netherlands,0,4,11,15,13/06/2021,0,0,4,4,7,3,6,16,0,4,1,5,1,0,0,1,1,0,1,2
172894,2021,China,Netherlands,0,1,5,6,12/6/2021,0,0,0,0,6,0,7,13,3,3,1,7,0,0,0,0,2,2,0,4
172894,2021,Canada,Netherlands,0,3,5,8,8/6/2021,0,0,1,1,6,1,4,11,4,2,1,7,0,0,0,0,3,1,1,5
172894,2021,Poland,Netherlands,1,2,17,20,7/6/2021,0,0,4,4,10,1,4,15,5,8,13,26,0,0,1,1,6,2,1,9
172894,2021,Japan,Netherlands,2,0,9,11,6/6/2021,0,0,0,0,7,1,2,10,3,2,6,11,0,0,0,0,3,0,0,3
172894,2021,Netherlands,Serbia,1,2,7,10,2/6/2021,0,0,1,1,6,2,6,14,4,9,6,19,0,0,0,0,2,0,0,2
172894,2021,USA,Netherlands,0,2,5,7,1/6/2021,0,0,0,0,3,2,5,10,1,5,8,14,0,0,0,0,3,1,1,5
172894,2021,Thailand,Netherlands,1,3,5,9,31/05/2021,0,0,0,0,4,0,6,10,6,2,1,9,0,0,1,1,1,0,0,1
172894,2021,Russia,Netherlands,0,4,10,14,27/05/2021,0,0,0,0,10,1,3,14,2,8,0,10,0,0,0,0,5,0,0,5
172894,2021,Netherlands,Germany,1,2,15,18,26/05/2021,0,0,1,1,7,4,10,21,1,2,2,5,0,0,1,1,5,0,0,5
172894,2021,Netherlands,Belgium,2,3,8,13,25/05/2021,0,0,1,1,7,2,2,11,1,4,4,9,0,0,0,0,4,0,1,5
162357,2021,Russia,Netherlands,0,0,0,0,27/05/2021,0,0,0,0,0,0,0,0,0,0,0,0,0,0,0,0,1,0,0,1
162357,2021,Netherlands,Germany,0,0,0,0,26/05/2021,0,0,0,0,0,0,0,0,0,0,0,0,0,0,0,0,0,0,0,0
162357,2021,Netherlands,Belgium,0,0,0,0,25/05/2021,0,0,0,0,0,0,0,0,0,0,0,0,0,0,0,0,0,0,0,0
148581,2021,Italy,Netherlands,0,0,0,0,13/06/2021,0,0,0,0,0,0,0,0,0,0,0,0,0,0,0,0,0,0,0,0
148581,2021,China,Netherlands,0,0,0,0,12/6/2021,0,0,0,0,0,0,0,0,0,0,0,0,0,0,0,0,0,0,0,0
162372,2021,Korea,Netherlands,1,0,18,19,20/06/2021,0,0,3,3,9,2,8,19,0,3,8,11,0,1,0,1,4,2,3,9
162372,2021,Brazil,Netherlands,0,0,0,0,19/06/2021,0,0,0,0,1,0,1,2,0,1,1,2,0,0,0,0,0,0,0,0
162372,2021,Türkiye,Netherlands,1,1,6,8,18/06/2021,0,0,2,2,4,2,12,18,2,2,0,4,0,0,0,0,3,1,1,5
162372,2021,Netherlands,Dominican Republic,0,1,4,5,14/06/2021,0,0,0,0,2,0,4,6,1,0,0,1,0,0,0,0,6,2,1,9
162372,2021,Italy,Netherlands,0,0,15,15,13/06/2021,0,0,1,1,5,2,11,18,2,1,0,3,0,0,0,0,6,1,0,7
162372,2021,China,Netherlands,1,0,2,3,12/6/2021,0,0,0,0,2,0,6,8,1,0,2,3,0,0,0,0,0,0,0,0
162372,2021,Canada,Netherlands,0,0,0,0,8/6/2021,0,0,0,0,0,0,0,0,0,0,0,0,0,0,0,0,0,0,0,0
162372,2021,Poland,Netherlands,0,0,2,2,7/6/2021,0,0,0,0,0,1,0,1,0,1,0,1,0,0,0,0,2,0,0,2
162372,2021,Japan,Netherlands,0,0,0,0,6/6/2021,0,0,0,0,0,0,0,0,0,0,0,0,0,0,0,0,0,0,0,0
162372,2021,USA,Netherlands,0,0,0,0,1/6/2021,0,0,0,0,0,0,0,0,0,0,0,0,0,0,0,0,0,0,0,0
162372,2021,Russia,Netherlands,0,0,0,0,27/05/2021,0,0,0,0,0,0,0,0,0,0,0,0,0,0,0,0,0,0,0,0
162372,2021,Netherlands,Germany,0,0,0,0,26/05/2021,0,0,0,0,0,0,0,0,0,0,0,0,0,0,0,0,0,0,0,0
162372,2021,Netherlands,Belgium,0,0,0,0,25/05/2021,0,0,0,0,0,0,0,0,0,0,0,0,0,0,0,0,0,0,0,0
152216,2021,Russia,Poland,0,0,7,7,20/06/2021,2,0,5,7,0,0,1,1,0,0,0,0,0,0,0,0,3,0,0,3
152216,2021,China,Poland,0,0,0,0,19/06/2021,2,0,2,4,0,0,0,0,0,0,0,0,0,0,0,0,1,0,0,1
152216,2021,Poland,USA,0,1,2,3,18/06/2021,1,0,15,16,0,0,0,0,0,0,0,0,0,0,0,0,3,1,0,4
152216,2021,Germany,Poland,0,0,7,7,14/06/2021,1,0,11,12,0,0,0,0,0,0,1,1,0,0,0,0,1,0,0,1
152216,2021,Thailand,Poland,0,0,0,0,13/06/2021,6,0,10,16,0,0,0,0,0,0,0,0,0,0,0,0,1,0,0,1
152216,2021,Poland,Brazil,0,0,3,3,12/6/2021,0,0,4,4,0,0,0,0,0,0,0,0,0,0,0,0,3,1,1,5
152216,2021,Japan,Poland,0,1,19,20,8/6/2021,29,2,95,126,4,0,4,8,1,7,0,8,0,0,0,0,6,2,1,9
152216,2021,Poland,Netherlands,1,4,16,21,7/6/2021,33,0,71,104,0,0,0,0,0,2,5,7,0,0,1,1,14,1,2,17
152216,2021,Canada,Poland,1,2,17,20,6/6/2021,12,0,91,103,1,1,2,4,2,1,1,4,0,0,0,0,4,4,0,8
152216,2021,Poland,Dominican Republic,1,1,17,19,2/6/2021,36,0,81,117,1,1,6,8,2,4,0,6,0,0,0,0,16,0,1,17
152216,2021,Belgium,Poland,1,1,21,23,1/6/2021,20,1,92,113,0,0,3,3,0,2,5,7,0,0,0,0,11,3,3,17
152216,2021,Korea,Poland,3,1,21,25,31/05/2021,20,1,47,68,1,0,2,3,0,0,0,0,0,0,1,1,7,1,0,8
152216,2021,Poland,Türkiye,0,0,20,20,27/05/2021,27,2,80,109,2,0,2,4,3,2,1,6,0,0,2,2,8,3,1,12
152216,2021,Serbia,Poland,0,0,8,8,26/05/2021,10,1,50,61,1,1,2,4,2,2,3,7,0,0,1,1,1,2,1,4
152216,2021,Italy,Poland,0,2,16,18,25/05/2021,16,3,112,131,2,1,4,7,0,5,4,9,0,0,0,0,13,2,0,15
162398,2021,Russia,Poland,2,0,11,13,20/06/2021,0,0,1,1,0,3,2,5,2,0,1,3,0,0,0,0,3,1,0,4
162398,2021,China,Poland,0,1,5,6,19/06/2021,0,0,0,0,4,3,0,7,1,2,0,3,0,0,1,1,2,0,0,2
162398,2021,Poland,USA,1,0,12,13,18/06/2021,0,0,0,0,6,1,1,8,0,0,5,5,0,0,1,1,4,0,0,4
162398,2021,Germany,Poland,1,0,12,13,14/06/2021,0,0,1,1,4,1,2,7,2,3,4,9,0,0,0,0,3,0,0,3
162398,2021,Thailand,Poland,0,2,6,8,13/06/2021,0,0,1,1,4,0,3,7,1,4,3,8,0,0,0,0,2,4,0,6
162398,2021,Poland,Brazil,0,2,8,10,12/6/2021,0,0,4,4,4,1,2,7,0,5,1,6,0,0,0,0,2,1,1,4
162398,2021,Japan,Poland,0,2,22,24,8/6/2021,0,0,0,0,5,1,2,8,2,4,2,8,0,0,0,0,4,4,0,8
162398,2021,Poland,Netherlands,0,0,4,4,7/6/2021,0,0,1,1,2,0,1,3,0,0,2,2,0,0,0,0,2,0,0,2
162398,2021,Canada,Poland,1,0,15,16,6/6/2021,0,0,0,0,6,3,2,11,2,3,2,7,0,0,1,1,2,2,0,4
162398,2021,Poland,Dominican Republic,0,2,20,22,2/6/2021,0,0,1,1,9,1,4,14,0,3,4,7,0,0,1,1,5,2,0,7
162398,2021,Belgium,Poland,0,2,14,16,1/6/2021,0,0,1,1,8,2,1,11,4,5,7,16,0,0,1,1,7,1,0,8
162398,2021,Korea,Poland,0,0,9,9,31/05/2021,0,0,2,2,4,0,3,7,2,3,4,9,0,0,0,0,2,0,0,2
162398,2021,Poland,Türkiye,0,1,14,15,27/05/2021,0,0,1,1,3,2,1,6,3,1,0,4,0,0,0,0,1,1,2,4
162398,2021,Serbia,Poland,0,0,5,5,26/05/2021,0,0,1,1,0,0,3,3,0,1,0,1,0,0,0,0,0,0,0,0
162398,2021,Italy,Poland,1,0,11,12,25/05/2021,0,0,1,1,3,1,0,4,1,0,3,4,0,0,1,1,2,0,0,2
136317,2021,Russia,Poland,1,0,7,8,20/06/2021,0,0,0,0,2,0,1,3,7,2,1,10,0,0,0,0,2,1,2,5
136317,2021,China,Poland,0,0,2,2,19/06/2021,0,0,0,0,2,0,0,2,0,0,1,1,0,0,0,0,1,1,0,2
136317,2021,Poland,USA,0,0,1,1,18/06/2021,0,0,1,1,0,0,0,0,0,0,0,0,0,0,0,0,0,0,0,0
136317,2021,Japan,Poland,0,1,12,13,8/6/2021,0,0,1,1,5,1,8,14,2,5,4,11,0,0,0,0,3,0,0,3
136317,2021,Poland,Netherlands,1,2,11,14,7/6/2021,0,0,1,1,7,4,5,16,0,3,10,13,0,1,0,1,4,1,3,8
136317,2021,Canada,Poland,0,0,0,0,6/6/2021,0,0,0,0,0,0,0,0,0,0,0,0,0,0,0,0,0,0,0,0
136317,2021,Poland,Dominican Republic,0,1,10,11,2/6/2021,0,0,1,1,3,2,2,7,6,4,3,13,0,0,0,0,5,3,3,11
136317,2021,Belgium,Poland,0,0,0,0,1/6/2021,0,0,0,0,0,0,0,0,0,0,0,0,0,0,0,0,0,0,0,0
136317,2021,Korea,Poland,0,0,0,0,31/05/2021,0,0,0,0,0,0,0,0,0,0,0,0,0,0,0,0,0,0,0,0
136317,2021,Serbia,Poland,1,1,7,9,26/05/2021,0,0,1,1,7,2,8,17,1,3,0,4,2,0,0,2,1,2,0,3
136317,2021,Italy,Poland,2,2,6,10,25/05/2021,0,0,1,1,2,0,7,9,1,1,7,9,0,0,0,0,1,0,0,1
152233,2021,Russia,Poland,0,0,0,0,20/06/2021,0,0,7,7,0,0,0,0,0,0,0,0,12,3,13,28,5,0,0,5
152233,2021,China,Poland,0,0,0,0,19/06/2021,0,0,8,8,0,0,0,0,0,0,0,0,10,1,6,17,3,0,0,3
152233,2021,Poland,USA,0,0,0,0,18/06/2021,0,0,11,11,0,0,0,0,0,0,0,0,8,1,5,14,6,3,0,9
152233,2021,Germany,Poland,0,0,0,0,14/06/2021,0,0,10,10,0,0,0,0,0,0,0,0,6,3,8,17,9,1,0,10
152233,2021,Thailand,Poland,0,0,0,0,13/06/2021,0,0,18,18,0,0,0,0,0,0,0,0,2,0,19,21,14,1,0,15
152233,2021,Poland,Brazil,0,0,0,0,12/6/2021,0,0,9,9,0,0,0,0,0,0,0,0,10,0,7,17,10,1,0,11
152233,2021,Japan,Poland,0,0,0,0,8/6/2021,0,0,12,12,0,0,0,0,0,0,0,0,10,0,13,23,10,3,1,14
152233,2021,Poland,Netherlands,0,0,0,0,7/6/2021,0,0,8,8,0,0,0,0,0,0,0,0,13,1,20,34,4,1,0,5
152233,2021,Canada,Poland,0,0,0,0,6/6/2021,1,0,8,9,0,0,0,0,0,0,0,0,13,1,12,26,3,2,0,5
152233,2021,Poland,Dominican Republic,0,0,0,0,2/6/2021,0,0,13,13,0,0,0,0,0,0,0,0,14,1,11,26,10,3,3,16
152233,2021,Belgium,Poland,0,0,0,0,1/6/2021,0,0,16,16,0,0,0,0,0,0,0,0,5,4,26,35,10,0,1,11
152233,2021,Korea,Poland,0,0,0,0,31/05/2021,0,0,2,2,0,0,0,0,0,0,0,0,6,0,11,17,4,2,1,7
152233,2021,Poland,Türkiye,0,0,0,0,27/05/2021,0,0,7,7,0,0,0,0,0,0,0,0,7,0,13,20,7,2,0,9
152233,2021,Serbia,Poland,0,0,0,0,26/05/2021,0,0,8,8,0,0,0,0,0,0,0,0,18,0,14,32,5,3,0,8
152233,2021,Italy,Poland,0,0,0,0,25/05/2021,0,0,5,5,0,0,0,0,0,0,0,0,13,2,16,31,8,2,0,10
152217,2021,Russia,Poland,0,1,5,6,20/06/2021,0,0,1,1,25,10,19,54,1,2,1,4,0,0,0,0,6,2,4,12
152217,2021,China,Poland,0,2,5,7,19/06/2021,0,0,1,1,15,4,10,29,1,6,1,8,0,0,0,0,4,1,0,5
152217,2021,Poland,USA,1,3,13,17,18/06/2021,0,0,1,1,15,10,14,39,1,1,3,5,5,3,10,18,6,3,2,11
152217,2021,Germany,Poland,0,3,5,8,14/06/2021,0,0,0,0,13,7,3,23,0,1,0,1,1,0,4,5,2,2,0,4
152217,2021,Thailand,Poland,1,2,12,15,13/06/2021,0,0,1,1,14,2,11,27,1,2,2,5,0,0,0,0,10,1,2,13
152217,2021,Poland,Brazil,2,5,6,13,12/6/2021,0,0,1,1,9,9,15,33,3,1,0,4,3,0,12,15,2,1,0,3
152217,2021,Japan,Poland,0,4,12,16,8/6/2021,0,0,2,2,33,8,17,58,2,4,1,7,0,0,0,0,14,3,2,19
152217,2021,Poland,Netherlands,0,1,0,1,7/6/2021,0,0,1,1,8,2,5,15,0,2,0,2,0,0,0,0,0,0,0,0
152217,2021,Canada,Poland,1,3,3,7,6/6/2021,0,0,0,0,7,3,7,17,0,1,0,1,1,1,3,5,3,1,1,5
152217,2021,Poland,Dominican Republic,1,4,7,12,2/6/2021,0,0,2,2,21,12,27,60,4,7,5,16,0,0,0,0,14,1,1,16
152217,2021,Belgium,Poland,0,2,13,15,1/6/2021,0,0,1,1,19,11,17,47,2,3,1,6,0,2,11,13,4,4,1,9
152217,2021,Korea,Poland,0,2,8,10,31/05/2021,0,0,0,0,16,3,6,25,1,1,0,2,4,0,7,11,3,2,0,5
152217,2021,Poland,Türkiye,5,4,10,19,27/05/2021,0,0,0,0,19,8,13,40,2,1,1,4,4,2,21,27,5,1,0,6
152217,2021,Serbia,Poland,4,3,15,22,26/05/2021,0,0,1,1,10,9,13,32,1,0,2,3,3,0,6,9,9,0,0,9
152217,2021,Italy,Poland,1,6,9,16,25/05/2021,0,0,2,2,21,6,25,52,3,3,2,8,6,1,10,17,6,2,0,8
119138,2021,Russia,Poland,0,0,11,11,20/06/2021,0,0,0,0,5,1,2,8,3,4,5,12,0,0,0,0,3,1,0,4
119138,2021,China,Poland,0,0,7,7,19/06/2021,0,0,2,2,2,0,1,3,0,2,0,2,0,0,3,3,1,0,0,1
119138,2021,Poland,USA,0,1,6,7,18/06/2021,0,0,0,0,5,1,6,12,1,5,2,8,0,0,0,0,1,1,0,2
119138,2021,Germany,Poland,1,0,5,6,14/06/2021,0,0,0,0,2,1,1,4,0,1,1,2,0,1,0,1,1,3,0,4
119138,2021,Thailand,Poland,0,1,5,6,13/06/2021,0,0,0,0,2,0,4,6,1,3,8,12,0,0,0,0,3,0,1,4
119138,2021,Poland,Brazil,1,2,4,7,12/6/2021,0,0,0,0,2,0,5,7,0,2,3,5,0,0,0,0,1,1,0,2
119138,2021,Poland,Netherlands,1,1,11,13,7/6/2021,0,0,0,0,10,1,3,14,2,7,9,18,0,0,0,0,3,0,0,3
119138,2021,Canada,Poland,1,1,10,12,6/6/2021,0,0,1,1,5,0,8,13,4,3,4,11,0,0,0,0,1,1,0,2
119138,2021,Belgium,Poland,2,1,14,17,1/6/2021,0,0,0,0,4,1,4,9,2,5,7,14,0,1,0,1,6,0,0,6
119138,2021,Korea,Poland,0,0,8,8,31/05/2021,0,0,0,0,3,0,3,6,1,4,4,9,0,0,0,0,2,2,1,5
119138,2021,Poland,Türkiye,0,2,12,14,27/05/2021,0,0,0,0,4,1,4,9,1,3,0,4,1,0,0,1,1,0,0,1
119138,2021,Serbia,Poland,0,2,4,6,26/05/2021,0,0,1,1,4,0,1,5,0,1,0,1,0,0,0,0,2,0,0,2
119138,2021,Italy,Poland,2,3,11,16,25/05/2021,0,0,0,0,4,0,2,6,5,3,4,12,1,0,0,1,2,1,0,3
163098,2021,Russia,Poland,3,1,19,23,20/06/2021,0,0,2,2,8,4,6,18,3,3,0,6,11,2,16,29,10,2,0,12
163098,2021,China,Poland,3,0,14,17,19/06/2021,0,0,0,0,14,3,11,28,0,4,1,5,2,1,11,14,3,4,0,7
163098,2021,Poland,USA,0,1,9,10,18/06/2021,0,1,1,2,6,6,16,28,1,4,1,6,11,1,24,36,6,3,1,10
163098,2021,Germany,Poland,0,0,5,5,14/06/2021,0,0,0,0,4,2,4,10,1,0,0,1,2,1,3,6,1,2,1,4
163098,2021,Thailand,Poland,0,3,12,15,13/06/2021,0,0,0,0,12,1,12,25,1,3,1,5,3,2,13,18,8,1,2,11
163098,2021,Poland,Brazil,0,0,0,0,12/6/2021,0,0,0,0,0,0,0,0,0,0,0,0,0,0,0,0,0,0,0,0
163098,2021,Japan,Poland,0,2,7,9,8/6/2021,0,0,1,1,3,0,4,7,0,0,3,3,3,0,3,6,4,1,0,5
163098,2021,Poland,Netherlands,2,4,13,19,7/6/2021,0,0,3,3,13,2,19,34,3,5,3,11,3,4,28,35,14,0,1,15
163098,2021,Canada,Poland,1,2,18,21,6/6/2021,0,0,2,2,10,1,15,26,6,1,0,7,5,2,9,16,10,4,1,15
163098,2021,Poland,Dominican Republic,2,1,15,18,2/6/2021,0,0,3,3,10,6,11,27,0,3,1,4,3,1,16,20,10,0,1,11
163098,2021,Belgium,Poland,0,1,12,13,1/6/2021,0,0,0,0,7,5,11,23,1,2,2,5,6,1,27,34,7,2,3,12
163098,2021,Korea,Poland,2,0,9,11,31/05/2021,0,0,3,3,6,3,9,18,0,1,1,2,4,2,10,16,10,3,0,13
163098,2021,Poland,Türkiye,3,0,12,15,27/05/2021,0,0,2,2,6,5,17,28,1,5,0,6,9,1,25,35,5,2,0,7
163098,2021,Serbia,Poland,0,0,0,0,26/05/2021,0,0,0,0,0,0,1,1,0,0,0,0,1,1,1,3,0,0,0,0
163098,2021,Italy,Poland,0,0,1,1,25/05/2021,0,0,0,0,1,0,3,4,0,0,0,0,1,0,0,1,1,0,0,1
164106,2021,Russia,Poland,0,0,0,0,20/06/2021,0,0,5,5,0,0,0,0,0,0,0,0,0,0,0,0,9,0,2,11
164106,2021,China,Poland,0,0,0,0,19/06/2021,0,0,1,1,0,0,0,0,0,0,0,0,0,0,0,0,9,0,1,10
164106,2021,Poland,USA,0,0,0,0,18/06/2021,0,0,6,6,0,0,0,0,0,0,0,0,0,0,0,0,3,1,1,5
164106,2021,Germany,Poland,0,0,0,0,14/06/2021,0,0,0,0,0,0,0,0,0,0,0,0,0,0,0,0,0,0,0,0
164106,2021,Thailand,Poland,0,0,0,0,13/06/2021,0,0,0,0,0,0,0,0,0,0,0,0,0,0,0,0,0,0,0,0
164106,2021,Poland,Brazil,0,0,0,0,12/6/2021,0,0,3,3,0,0,0,0,0,0,0,0,0,0,0,0,6,0,1,7
164106,2021,Japan,Poland,0,0,0,0,8/6/2021,0,0,4,4,0,0,0,0,0,0,0,0,0,0,0,0,6,4,1,11
164106,2021,Poland,Netherlands,0,0,0,0,7/6/2021,0,0,4,4,0,0,0,0,0,0,0,0,0,0,0,0,7,0,1,8
164106,2021,Canada,Poland,0,0,0,0,6/6/2021,0,0,3,3,0,0,0,0,0,0,0,0,0,0,0,0,9,13,0,22
164106,2021,Poland,Dominican Republic,0,0,0,0,2/6/2021,0,0,6,6,0,0,0,0,0,0,0,0,0,0,0,0,4,5,0,9
164106,2021,Belgium,Poland,0,0,0,0,1/6/2021,0,0,6,6,0,0,0,0,0,0,0,0,0,0,0,0,6,8,1,15
164106,2021,Korea,Poland,0,0,0,0,31/05/2021,0,0,2,2,0,0,0,0,0,0,0,0,0,0,0,0,8,4,1,13
164106,2021,Poland,Türkiye,0,0,0,0,27/05/2021,1,0,4,5,0,0,0,0,0,0,0,0,0,0,0,0,5,5,2,12
164106,2021,Serbia,Poland,0,0,0,0,26/05/2021,0,0,1,1,0,0,0,0,0,0,0,0,0,0,0,0,11,5,0,16
164106,2021,Italy,Poland,0,0,0,0,25/05/2021,0,0,5,5,0,0,0,0,0,0,0,0,0,0,0,0,9,7,1,17
143463,2021,Poland,USA,0,1,4,5,18/06/2021,0,0,3,3,7,4,7,18,1,3,5,9,1,0,2,3,8,1,1,10
143463,2021,Germany,Poland,0,0,5,5,14/06/2021,0,0,1,1,7,4,11,22,2,1,6,9,0,1,2,3,5,1,0,6
143463,2021,Thailand,Poland,0,0,0,0,13/06/2021,0,0,0,0,0,0,0,0,0,0,0,0,0,0,0,0,0,0,0,0
143463,2021,Poland,Brazil,0,1,9,10,12/6/2021,0,0,3,3,13,4,22,39,0,3,1,4,0,0,3,3,7,1,2,10
143463,2021,Japan,Poland,0,0,0,0,8/6/2021,0,0,0,0,0,0,0,0,0,0,0,0,0,0,0,0,0,0,0,0
143463,2021,Poland,Netherlands,0,1,7,8,7/6/2021,1,0,2,3,16,8,23,47,3,3,2,8,0,0,0,0,5,1,0,6
143463,2021,Canada,Poland,1,0,12,13,6/6/2021,0,0,0,0,21,6,19,46,1,2,2,5,0,0,3,3,9,4,1,14
143463,2021,Belgium,Poland,0,0,8,8,1/6/2021,0,0,1,1,17,5,28,50,2,4,4,10,0,0,1,1,6,2,4,12
143463,2021,Korea,Poland,1,2,4,7,31/05/2021,0,0,3,3,11,6,9,26,6,1,5,12,2,1,3,6,6,0,1,7
143463,2021,Poland,Türkiye,0,1,8,9,27/05/2021,0,0,2,2,21,4,18,43,2,1,2,5,0,0,1,1,6,1,0,7
143463,2021,Serbia,Poland,0,1,8,9,26/05/2021,0,0,1,1,10,2,12,24,0,3,2,5,0,0,1,1,8,1,0,9
143463,2021,Italy,Poland,1,1,17,19,25/05/2021,0,0,2,2,17,12,22,51,0,4,3,7,0,0,0,0,5,1,1,7
152231,2021,Russia,Poland,0,0,0,0,20/06/2021,0,0,0,0,0,0,0,0,0,0,0,0,0,0,0,0,0,0,0,0
152231,2021,China,Poland,0,0,0,0,19/06/2021,0,0,0,0,0,0,0,0,0,0,0,0,0,0,0,0,0,0,0,0
152231,2021,Poland,USA,0,0,0,0,18/06/2021,0,0,0,0,0,0,0,0,0,0,0,0,0,0,0,0,0,0,0,0
152231,2021,Germany,Poland,0,0,0,0,14/06/2021,0,0,0,0,0,0,0,0,0,0,0,0,0,0,0,0,0,0,0,0
152231,2021,Thailand,Poland,0,0,0,0,13/06/2021,0,0,0,0,0,0,0,0,0,0,0,0,0,0,0,0,0,0,0,0
152231,2021,Poland,Brazil,0,0,0,0,12/6/2021,0,0,0,0,0,0,0,0,0,0,0,0,0,0,0,0,0,0,0,0
152231,2021,Japan,Poland,0,0,0,0,8/6/2021,0,0,0,0,0,0,0,0,0,0,0,0,0,0,0,0,0,0,0,0
152231,2021,Canada,Poland,0,0,0,0,6/6/2021,0,0,0,0,0,0,0,0,0,0,0,0,0,0,0,0,0,0,0,0
152231,2021,Poland,Dominican Republic,0,0,0,0,2/6/2021,0,0,0,0,0,0,0,0,0,0,0,0,0,0,0,0,0,0,0,0
152231,2021,Belgium,Poland,0,0,1,1,1/6/2021,0,0,0,0,0,0,3,3,0,1,0,1,1,0,8,9,2,2,0,4
152231,2021,Korea,Poland,0,0,0,0,31/05/2021,0,0,1,1,0,1,2,3,0,0,0,0,1,0,1,2,1,0,0,1
152231,2021,Poland,Türkiye,0,0,0,0,27/05/2021,0,0,0,0,1,0,0,1,0,0,0,0,1,1,4,6,0,0,0,0
152231,2021,Serbia,Poland,0,0,8,8,26/05/2021,0,0,0,0,5,2,8,15,0,2,1,3,9,1,7,17,5,2,0,7
152231,2021,Italy,Poland,0,1,0,1,25/05/2021,0,0,0,0,0,0,0,0,0,0,0,0,0,0,0,0,0,0,0,0
181268,2021,Russia,Poland,0,0,0,0,20/06/2021,0,0,1,1,4,1,4,9,0,0,0,0,0,0,0,0,0,0,0,0
181268,2021,China,Poland,0,0,0,0,19/06/2021,0,0,0,0,2,0,1,3,0,0,0,0,0,0,0,0,0,0,0,0
181268,2021,Poland,USA,0,0,0,0,18/06/2021,0,0,1,1,3,0,5,8,0,1,0,1,0,0,1,1,1,0,0,1
181268,2021,Germany,Poland,0,1,0,1,14/06/2021,0,0,0,0,1,0,2,3,0,1,0,1,1,0,1,2,0,1,0,1
181268,2021,Thailand,Poland,0,0,0,0,13/06/2021,0,0,0,0,1,1,1,3,1,0,0,1,0,0,0,0,2,1,0,3
181268,2021,Poland,Brazil,0,1,6,7,12/6/2021,0,0,0,0,3,4,9,16,4,1,3,8,6,1,17,24,4,3,0,7
181268,2021,Japan,Poland,0,0,0,0,8/6/2021,0,0,0,0,0,0,0,0,0,0,0,0,0,0,0,0,0,0,0,0
181268,2021,Poland,Netherlands,0,0,17,17,7/6/2021,0,0,2,2,11,3,12,26,1,2,6,9,3,1,19,23,14,5,4,23
181268,2021,Canada,Poland,0,0,0,0,6/6/2021,0,0,0,0,0,0,0,0,0,0,0,0,0,0,0,0,0,0,0,0
181268,2021,Poland,Dominican Republic,0,0,0,0,2/6/2021,0,0,0,0,0,0,0,0,0,0,0,0,0,0,0,0,0,0,0,0
181268,2021,Belgium,Poland,0,0,0,0,1/6/2021,0,0,0,0,1,0,4,5,0,2,0,2,0,0,0,0,0,0,0,0
181268,2021,Poland,Türkiye,0,0,0,0,27/05/2021,0,0,0,0,0,0,0,0,0,0,0,0,0,0,0,0,0,0,0,0
181268,2021,Serbia,Poland,0,0,1,1,26/05/2021,0,0,0,0,3,1,1,5,0,0,0,0,0,0,0,0,0,1,0,1
181268,2021,Italy,Poland,0,0,0,0,25/05/2021,0,0,0,0,0,0,0,0,0,0,0,0,0,0,0,0,0,0,0,0
181267,2021,China,Poland,0,0,0,0,19/06/2021,0,0,0,0,0,0,0,0,0,0,0,0,0,0,0,0,0,0,0,0
181267,2021,Poland,Netherlands,0,0,0,0,7/6/2021,0,0,0,0,0,0,0,0,0,0,0,0,0,0,0,0,0,0,0,0
181267,2021,Poland,Dominican Republic,0,0,0,0,2/6/2021,0,0,3,3,0,0,0,0,0,0,0,0,0,0,0,0,0,0,0,0
181267,2021,Poland,Türkiye,0,0,0,0,27/05/2021,0,0,0,0,0,0,0,0,0,0,0,0,0,0,0,0,0,0,0,0
181273,2021,,,-,-,-,-,-,-,-,-,-,-,-,-,-,-,-,-,-,-,-,-,-,-,-,-,-
181263,2021,Russia,Poland,1,1,23,25,20/06/2021,23,1,72,96,1,0,1,2,0,4,2,6,0,0,0,0,1,2,0,3
181263,2021,China,Poland,0,0,15,15,19/06/2021,11,0,64,75,0,0,2,2,0,1,0,1,0,0,0,0,4,0,0,4
181263,2021,Poland,USA,1,1,11,13,18/06/2021,10,0,63,73,1,0,1,2,1,0,3,4,0,0,0,0,7,4,2,13
181263,2021,Germany,Poland,0,1,9,10,14/06/2021,10,1,51,62,1,0,1,2,0,0,2,2,0,0,0,0,3,4,2,9
181263,2021,Thailand,Poland,0,1,11,12,13/06/2021,24,1,44,69,1,0,1,2,0,2,2,4,0,0,0,0,7,4,2,13
181263,2021,Poland,Brazil,1,4,10,15,12/6/2021,11,0,73,84,1,0,0,1,0,0,0,0,0,0,0,0,9,3,0,12
173996,2021,Japan,Poland,0,0,0,0,8/6/2021,0,0,2,2,0,0,0,0,1,1,1,3,0,0,0,0,0,0,0,0
173996,2021,Poland,Netherlands,0,0,7,7,7/6/2021,3,0,19,22,0,0,0,0,0,1,0,1,0,0,0,0,0,1,0,1
173996,2021,Canada,Poland,0,1,0,1,6/6/2021,3,0,16,19,1,0,1,2,0,0,0,0,0,0,0,0,1,1,0,2
173996,2021,Poland,Dominican Republic,0,0,1,1,2/6/2021,0,0,0,0,0,0,0,0,0,0,0,0,0,0,0,0,0,0,0,0
173996,2021,Belgium,Poland,0,1,1,2,1/6/2021,3,0,6,9,0,0,0,0,0,0,0,0,0,0,0,0,2,0,0,2
173996,2021,Korea,Poland,0,0,2,2,31/05/2021,2,1,7,10,0,0,0,0,0,0,0,0,0,0,0,0,0,0,0,0
173996,2021,Poland,Türkiye,0,0,2,2,27/05/2021,1,0,2,3,0,0,0,0,0,0,0,0,0,0,0,0,0,0,0,0
173996,2021,Serbia,Poland,0,0,7,7,26/05/2021,4,2,40,46,2,1,0,3,0,2,1,3,0,0,0,0,2,3,0,5
173996,2021,Italy,Poland,0,0,1,1,25/05/2021,1,0,10,11,0,0,0,0,0,0,0,0,0,0,0,0,0,0,0,0
151231,2021,Russia,Poland,0,0,0,0,20/06/2021,0,0,0,0,0,0,0,0,0,0,0,0,0,0,0,0,0,0,0,0
151231,2021,China,Poland,0,0,0,0,19/06/2021,0,0,0,0,0,0,2,2,0,0,1,1,0,0,1,1,0,0,1,1
151231,2021,Germany,Poland,0,0,0,0,14/06/2021,0,0,0,0,0,0,0,0,0,0,0,0,0,0,0,0,0,0,0,0
151231,2021,Thailand,Poland,0,0,0,0,13/06/2021,0,0,0,0,0,0,0,0,0,0,0,0,0,0,0,0,0,0,0,0
151231,2021,Poland,Brazil,0,0,0,0,12/6/2021,0,0,0,0,0,1,1,2,0,0,0,0,0,0,0,0,0,0,0,0
151231,2021,Japan,Poland,0,2,7,9,8/6/2021,0,0,0,0,9,3,14,26,3,0,2,5,1,1,12,14,5,3,2,10
151231,2021,Poland,Netherlands,0,0,0,0,7/6/2021,0,0,0,0,0,0,0,0,0,0,0,0,0,0,0,0,0,0,0,0
151231,2021,Poland,Dominican Republic,0,0,0,0,2/6/2021,0,0,0,0,0,2,1,3,0,0,0,0,0,0,0,0,1,0,0,1
151231,2021,Belgium,Poland,0,0,0,0,1/6/2021,0,0,0,0,0,1,0,1,0,0,0,0,0,0,0,0,0,0,0,0
151231,2021,Korea,Poland,0,0,0,0,31/05/2021,0,0,0,0,4,0,0,4,0,2,0,2,0,0,0,0,0,0,0,0
151231,2021,Poland,Türkiye,0,0,0,0,27/05/2021,0,0,1,1,1,0,0,1,0,0,0,0,0,0,0,0,0,0,0,0
151231,2021,Serbia,Poland,0,0,0,0,26/05/2021,0,0,0,0,0,0,0,0,0,0,0,0,0,0,0,0,0,0,0,0
151231,2021,Italy,Poland,0,0,0,0,25/05/2021,0,0,0,0,0,0,0,0,0,0,0,0,0,1,1,2,0,0,0,0
163097,2021,Russia,Poland,0,0,0,0,20/06/2021,0,0,0,0,0,0,0,0,0,0,0,0,0,0,0,0,0,0,0,0
163097,2021,Poland,USA,0,0,0,0,18/06/2021,0,0,0,0,0,0,0,0,0,0,0,0,0,0,0,0,0,0,0,0
163097,2021,Germany,Poland,0,0,3,3,14/06/2021,0,0,0,0,2,0,2,4,1,2,2,5,0,0,0,0,1,1,0,2
163097,2021,Thailand,Poland,1,1,3,5,13/06/2021,0,0,0,0,3,0,3,6,0,1,4,5,0,0,1,1,0,0,0,0
163097,2021,Poland,Brazil,0,0,0,0,12/6/2021,0,0,0,0,0,0,0,0,0,0,0,0,0,0,0,0,0,0,0,0
163097,2021,Japan,Poland,0,0,0,0,8/6/2021,0,0,0,0,0,0,0,0,0,1,0,1,0,0,0,0,0,0,0,0
163097,2021,Canada,Poland,0,0,0,0,6/6/2021,0,0,0,0,0,0,0,0,0,0,0,0,0,0,0,0,0,0,0,0
163097,2021,Poland,Dominican Republic,0,0,0,0,2/6/2021,0,0,0,0,0,0,0,0,0,0,0,0,0,0,0,0,0,0,0,0
163097,2021,Korea,Poland,0,0,1,1,31/05/2021,0,0,0,0,0,0,0,0,0,0,0,0,0,0,0,0,0,0,0,0
163097,2021,Poland,Türkiye,0,0,0,0,27/05/2021,0,0,0,0,0,0,0,0,0,0,0,0,0,0,0,0,0,0,0,0
152223,2021,Russia,Poland,1,0,12,13,20/06/2021,1,0,2,3,13,4,10,27,3,4,3,10,5,1,18,24,7,3,2,12
152223,2021,China,Poland,0,1,8,9,19/06/2021,0,0,2,2,8,1,13,22,0,4,0,4,14,2,19,35,4,4,1,9
152223,2021,Poland,USA,0,0,0,0,18/06/2021,0,0,0,0,0,0,0,0,0,0,0,0,0,0,0,0,0,0,0,0
152223,2021,Germany,Poland,1,0,8,9,14/06/2021,0,0,4,4,6,0,6,12,2,1,0,3,9,2,19,30,9,3,1,13
152223,2021,Thailand,Poland,1,2,9,12,13/06/2021,0,0,1,1,15,0,15,30,2,2,1,5,5,0,9,14,11,1,1,13
152223,2021,Poland,Brazil,0,0,1,1,12/6/2021,0,0,1,1,1,2,0,3,0,0,0,0,0,0,6,6,2,0,0,2
152223,2021,Japan,Poland,0,1,17,18,8/6/2021,0,0,4,4,15,2,19,36,4,1,1,6,14,4,39,57,13,4,1,18
152223,2021,Poland,Netherlands,0,0,0,0,7/6/2021,0,0,0,0,0,0,0,0,0,0,0,0,0,1,2,3,0,0,0,0
152223,2021,Canada,Poland,2,1,15,18,6/6/2021,0,0,0,0,6,6,10,22,1,1,0,2,13,1,16,30,3,3,0,6
152223,2021,Poland,Dominican Republic,1,0,11,12,2/6/2021,0,0,1,1,11,0,21,32,0,1,4,5,13,4,24,41,9,1,2,12
152223,2021,Belgium,Poland,0,0,1,1,1/6/2021,0,0,0,0,1,0,1,2,0,0,0,0,0,0,4,4,2,0,1,3
152223,2021,Korea,Poland,0,0,0,0,31/05/2021,0,0,0,0,0,0,0,0,0,0,0,0,0,0,0,0,0,0,0,0
152223,2021,Serbia,Poland,0,1,4,5,26/05/2021,0,0,0,0,2,4,8,14,0,4,1,5,5,1,11,17,2,1,0,3
152223,2021,Italy,Poland,1,2,11,14,25/05/2021,0,0,0,0,9,5,10,24,1,0,3,4,10,6,30,46,14,3,3,20
142377,2021,Japan,Russia,0,0,0,0,2/6/2021,0,0,0,0,0,0,0,0,0,0,0,0,0,0,0,0,0,0,0,0
142377,2021,Brazil,Russia,0,1,6,7,1/6/2021,0,0,1,1,2,0,4,6,0,1,1,2,0,0,0,0,2,0,0,2
142377,2021,Russia,Italy,0,0,0,0,31/05/2021,0,0,0,0,0,0,0,0,0,0,0,0,0,0,0,0,0,0,0,0
142377,2021,Russia,Netherlands,1,2,7,10,27/05/2021,0,0,0,0,2,1,3,6,3,2,3,8,0,0,0,0,0,1,0,1
142377,2021,Belgium,Russia,0,1,0,1,26/05/2021,0,0,0,0,0,0,1,1,0,1,2,3,0,0,0,0,0,0,0,0
142377,2021,Germany,Russia,0,0,0,0,25/05/2021,0,0,0,0,0,0,0,0,0,0,0,0,0,0,0,0,0,0,0,0
119361,2021,Russia,Poland,0,0,0,0,20/06/2021,0,0,5,5,0,0,0,0,0,0,0,0,3,2,12,17,6,2,1,9
119361,2021,USA,Russia,0,0,0,0,19/06/2021,0,0,5,5,0,0,0,0,0,0,0,0,2,1,5,8,3,2,2,7
119361,2021,China,Russia,0,0,0,0,18/06/2021,0,0,0,0,0,0,0,0,0,0,0,0,0,0,0,0,0,0,0,0
119361,2021,Russia,Serbia,0,0,0,0,14/06/2021,0,0,0,0,0,0,0,0,0,0,0,0,0,0,1,1,3,1,1,5
119361,2021,Russia,Canada,0,0,0,0,13/06/2021,0,0,0,0,0,0,0,0,0,0,0,0,0,0,0,0,0,0,0,0
119361,2021,Russia,Korea,0,0,0,0,12/6/2021,0,0,0,0,0,0,0,0,0,0,0,0,0,0,0,0,0,0,0,0
119361,2021,Türkiye,Russia,0,0,0,0,8/6/2021,0,0,6,6,0,0,0,0,0,0,0,0,7,5,12,24,10,5,4,19
119361,2021,Russia,Thailand,0,0,0,0,7/6/2021,0,0,9,9,0,0,0,0,0,0,0,0,5,0,13,18,10,5,3,18
119361,2021,Dominican Republic,Russia,0,0,0,0,6/6/2021,0,0,8,8,0,0,0,0,0,0,0,0,11,1,15,27,22,4,1,27
119361,2021,Japan,Russia,0,0,0,0,2/6/2021,0,0,8,8,0,0,0,0,0,0,0,0,6,1,14,21,10,6,0,16
119361,2021,Brazil,Russia,0,0,0,0,1/6/2021,0,0,6,6,0,0,0,0,0,0,0,0,2,2,4,8,10,3,1,14
119361,2021,Russia,Italy,0,0,0,0,31/05/2021,0,0,5,5,0,0,0,0,0,0,0,0,3,1,10,14,12,5,0,17
119361,2021,Russia,Netherlands,0,0,0,0,27/05/2021,0,0,2,2,0,0,0,0,0,0,0,0,1,0,5,6,1,2,1,4
119361,2021,Belgium,Russia,0,0,0,0,26/05/2021,0,0,6,6,0,0,0,0,0,0,0,0,3,0,5,8,5,3,0,8
119361,2021,Germany,Russia,0,0,0,0,25/05/2021,0,0,0,0,0,0,0,0,0,0,0,0,1,1,1,3,4,0,0,4
175202,2021,Russia,Poland,2,2,19,23,20/06/2021,0,0,2,2,15,9,8,32,0,4,2,6,13,3,20,36,1,3,2,6
175202,2021,USA,Russia,1,3,11,15,19/06/2021,0,0,2,2,13,3,17,33,0,1,2,3,9,7,19,35,6,1,1,8
175202,2021,China,Russia,1,1,5,7,18/06/2021,0,0,0,0,8,5,8,21,0,0,0,0,1,1,13,15,0,3,1,4
175202,2021,Russia,Serbia,3,0,7,10,14/06/2021,0,0,2,2,8,2,3,13,1,0,0,1,2,0,6,8,1,0,0,1
175202,2021,Russia,Canada,2,2,6,10,13/06/2021,0,0,1,1,13,0,6,19,1,1,0,2,4,0,11,15,6,0,2,8
175202,2021,Russia,Korea,0,1,8,9,12/6/2021,0,0,2,2,10,3,10,23,2,1,4,7,4,6,7,17,1,1,0,2
175202,2021,Türkiye,Russia,1,2,12,15,8/6/2021,0,0,1,1,11,5,11,27,1,0,0,1,6,3,19,28,5,4,4,13
175202,2021,Russia,Thailand,3,2,17,22,7/6/2021,0,0,1,1,16,3,12,31,1,2,5,8,6,3,13,22,4,1,4,9
175202,2021,Dominican Republic,Russia,0,3,17,20,6/6/2021,0,1,3,4,18,7,22,47,2,2,2,6,11,1,23,35,8,1,2,11
175202,2021,Japan,Russia,0,2,4,6,2/6/2021,0,0,1,1,4,1,5,10,0,0,0,0,2,2,6,10,1,0,0,1
175202,2021,Brazil,Russia,0,1,6,7,1/6/2021,0,0,0,0,6,4,10,20,1,2,0,3,1,2,3,6,3,2,1,6
175202,2021,Russia,Italy,3,0,7,10,31/05/2021,0,0,0,0,13,2,9,24,2,2,0,4,3,0,5,8,3,1,0,4
175202,2021,Russia,Netherlands,1,2,9,12,27/05/2021,0,1,1,2,14,2,9,25,3,0,0,3,9,1,17,27,2,2,0,4
175202,2021,Belgium,Russia,0,1,14,15,26/05/2021,0,0,0,0,10,3,7,20,0,0,2,2,4,3,14,21,4,1,1,6
175202,2021,Germany,Russia,0,1,3,4,25/05/2021,0,0,0,0,0,0,0,0,0,0,1,1,0,1,1,2,1,0,0,1
168181,2021,Russia,Poland,1,0,7,8,20/06/2021,0,0,1,1,11,2,4,17,5,3,8,16,0,0,1,1,0,2,2,4
168181,2021,USA,Russia,0,0,10,10,19/06/2021,0,1,0,1,7,0,2,9,3,5,9,17,0,0,1,1,1,3,2,6
168181,2021,China,Russia,1,0,9,10,18/06/2021,0,0,1,1,3,3,2,8,1,3,4,8,0,0,1,1,2,1,6,9
168181,2021,Russia,Serbia,4,0,10,14,14/06/2021,0,0,0,0,3,2,4,9,4,1,4,9,1,0,0,1,3,0,0,3
168181,2021,Russia,Canada,2,0,7,9,13/06/2021,0,0,2,2,6,1,2,9,1,3,7,11,0,0,0,0,1,0,2,3
168181,2021,Russia,Korea,0,2,3,5,12/6/2021,0,0,0,0,3,0,5,8,4,4,4,12,0,0,0,0,2,0,0,2
168181,2021,Türkiye,Russia,0,2,11,13,8/6/2021,0,0,1,1,3,0,5,8,5,7,3,15,0,0,1,1,2,1,0,3
168181,2021,Russia,Thailand,1,0,14,15,7/6/2021,0,0,0,0,8,0,4,12,2,5,9,16,0,0,0,0,3,0,0,3
168181,2021,Dominican Republic,Russia,0,0,15,15,6/6/2021,0,0,4,4,6,1,3,10,4,11,19,34,0,0,0,0,4,1,2,7
168181,2021,Japan,Russia,0,0,8,8,2/6/2021,0,0,0,0,5,0,5,10,1,3,1,5,0,0,0,0,1,0,0,1
168181,2021,Brazil,Russia,0,0,7,7,1/6/2021,0,0,1,1,0,0,2,2,1,1,1,3,0,1,1,2,1,1,0,2
168181,2021,Russia,Italy,0,1,8,9,31/05/2021,0,0,0,0,4,0,3,7,2,4,2,8,0,0,0,0,2,0,0,2
168181,2021,Russia,Netherlands,0,1,2,3,27/05/2021,0,0,0,0,1,0,0,1,0,1,0,1,0,0,0,0,0,0,0,0
168181,2021,Belgium,Russia,0,0,10,10,26/05/2021,0,0,0,0,7,2,5,14,4,5,8,17,0,0,0,0,8,0,0,8
168181,2021,Germany,Russia,2,0,7,9,25/05/2021,0,0,0,0,5,1,2,8,1,6,2,9,0,0,0,0,1,0,0,1
132071,2021,Russia,Poland,0,0,0,0,20/06/2021,0,0,0,0,0,0,0,0,0,0,0,0,0,0,0,0,0,0,0,0
132071,2021,USA,Russia,0,0,9,9,19/06/2021,0,0,0,0,12,5,14,31,1,2,4,7,0,0,1,1,6,3,3,12
132071,2021,China,Russia,1,0,9,10,18/06/2021,0,0,7,7,13,2,15,30,0,1,2,3,0,0,0,0,8,2,2,12
132071,2021,Russia,Serbia,0,0,5,5,14/06/2021,0,0,1,1,7,0,2,9,1,2,0,3,0,0,0,0,2,0,0,2
132071,2021,Russia,Canada,1,1,9,11,13/06/2021,0,0,0,0,5,1,6,12,1,0,0,1,0,0,0,0,5,2,2,9
132071,2021,Russia,Korea,0,0,10,10,12/6/2021,0,0,3,3,8,2,16,26,1,0,4,5,0,0,0,0,8,1,1,10
132071,2021,Türkiye,Russia,0,2,10,12,8/6/2021,0,0,3,3,13,7,9,29,1,3,2,6,0,0,0,0,6,1,1,8
132071,2021,Russia,Thailand,1,2,10,13,7/6/2021,0,0,1,1,14,2,15,31,4,1,5,10,0,0,1,1,8,2,1,11
132071,2021,Dominican Republic,Russia,0,1,14,15,6/6/2021,0,0,3,3,30,7,21,58,1,0,8,9,0,0,0,0,13,3,2,18
132071,2021,Japan,Russia,0,0,10,10,2/6/2021,0,0,0,0,12,2,21,35,1,4,1,6,0,0,0,0,3,3,0,6
132071,2021,Russia,Italy,0,0,5,5,31/05/2021,0,0,1,1,7,3,11,21,3,0,5,8,0,0,0,0,1,1,0,2
132071,2021,Russia,Netherlands,0,0,1,1,27/05/2021,0,1,0,1,3,1,2,6,0,0,0,0,0,0,1,1,3,0,0,3
132071,2021,Belgium,Russia,1,1,13,15,26/05/2021,0,0,1,1,20,5,23,48,3,1,3,7,0,0,0,0,10,0,2,12
132071,2021,Germany,Russia,0,0,14,14,25/05/2021,0,0,1,1,18,3,10,31,2,3,6,11,0,0,0,0,5,0,0,5
173154,2021,Türkiye,Russia,0,0,0,0,8/6/2021,0,0,0,0,0,0,0,0,0,0,0,0,0,0,0,0,0,0,0,0
173154,2021,Russia,Thailand,0,0,0,0,7/6/2021,0,0,0,0,0,0,0,0,0,0,0,0,0,0,0,0,0,0,0,0
173154,2021,Dominican Republic,Russia,0,0,0,0,6/6/2021,0,0,0,0,0,0,0,0,0,0,0,0,0,0,0,0,0,0,0,0
173154,2021,Brazil,Russia,0,0,0,0,1/6/2021,0,0,0,0,0,0,0,0,0,0,0,0,0,0,0,0,0,0,0,0
173154,2021,Belgium,Russia,0,0,1,1,26/05/2021,0,0,0,0,0,0,3,3,0,0,0,0,0,0,1,1,1,0,0,1
164015,2021,Russia,Poland,0,1,7,8,20/06/2021,9,0,34,43,1,0,0,1,1,1,1,3,0,0,0,0,4,4,1,9
164015,2021,USA,Russia,0,2,1,3,19/06/2021,0,0,12,12,0,0,0,0,0,0,0,0,0,0,1,1,0,0,0,0
164015,2021,China,Russia,0,1,1,2,18/06/2021,0,0,23,23,0,0,0,0,0,2,0,2,0,0,0,0,0,0,0,0
164015,2021,Russia,Canada,0,0,1,1,13/06/2021,1,0,8,9,0,0,0,0,1,0,0,1,0,0,0,0,2,0,1,3
164015,2021,Russia,Korea,0,0,0,0,12/6/2021,0,0,0,0,0,0,0,0,0,0,0,0,0,0,0,0,0,0,0,0
164015,2021,Türkiye,Russia,0,0,1,1,8/6/2021,0,0,13,13,0,0,1,1,0,1,1,2,0,0,0,0,1,1,2,4
164015,2021,Russia,Thailand,1,3,10,14,7/6/2021,14,2,62,78,4,0,1,5,2,0,1,3,0,0,0,0,7,2,0,9
164015,2021,Dominican Republic,Russia,0,0,9,9,6/6/2021,13,0,64,77,0,1,0,1,0,4,3,7,0,0,0,0,8,2,0,10
164015,2021,Japan,Russia,0,0,0,0,2/6/2021,0,0,0,0,0,0,0,0,0,0,0,0,0,0,0,0,0,0,0,0
164015,2021,Brazil,Russia,0,0,2,2,1/6/2021,3,0,40,43,0,0,2,2,0,0,0,0,0,0,1,1,4,2,0,6
164015,2021,Belgium,Russia,0,0,0,0,26/05/2021,0,0,16,16,0,0,0,0,0,0,1,1,0,0,0,0,0,0,0,0
163842,2021,Russia,Poland,0,1,11,12,20/06/2021,0,0,1,1,5,1,2,8,2,3,4,9,1,0,0,1,1,0,0,1
163842,2021,USA,Russia,1,0,7,8,19/06/2021,0,0,1,1,1,0,1,2,2,2,1,5,0,0,0,0,2,1,1,4
163842,2021,China,Russia,0,0,0,0,18/06/2021,0,0,0,0,0,0,0,0,0,0,0,0,0,0,0,0,0,0,0,0
163842,2021,Russia,Serbia,0,0,0,0,14/06/2021,0,0,0,0,0,0,0,0,0,0,0,0,0,0,0,0,0,0,0,0
163842,2021,Russia,Canada,0,0,0,0,13/06/2021,0,0,0,0,0,0,0,0,0,0,0,0,0,0,0,0,0,0,0,0
163842,2021,Russia,Korea,0,0,3,3,12/6/2021,0,0,1,1,2,0,1,3,0,1,2,3,0,0,0,0,1,0,0,1
163842,2021,Türkiye,Russia,0,0,0,0,8/6/2021,0,0,0,0,0,0,0,0,0,0,0,0,0,0,0,0,0,0,0,0
163842,2021,Russia,Thailand,0,0,1,1,7/6/2021,0,0,0,0,2,0,0,2,0,0,0,0,0,0,0,0,0,0,0,0
163842,2021,Dominican Republic,Russia,0,0,0,0,6/6/2021,0,0,1,1,0,0,2,2,0,1,1,2,0,0,0,0,0,0,0,0
163842,2021,Japan,Russia,0,0,0,0,2/6/2021,0,0,0,0,0,0,0,0,0,0,0,0,0,0,0,0,0,0,0,0
163842,2021,Brazil,Russia,0,0,2,2,1/6/2021,0,0,0,0,1,0,2,3,2,2,1,5,0,0,0,0,1,0,0,1
163842,2021,Russia,Italy,0,0,0,0,31/05/2021,0,0,0,0,0,0,0,0,0,0,0,0,0,0,0,0,0,0,0,0
163842,2021,Russia,Netherlands,1,0,8,9,27/05/2021,0,0,0,0,5,0,6,11,1,6,0,7,0,0,0,0,0,0,0,0
163842,2021,Belgium,Russia,0,0,1,1,26/05/2021,0,0,0,0,0,1,0,1,0,0,0,0,0,0,0,0,0,0,0,0
163842,2021,Germany,Russia,0,0,8,8,25/05/2021,0,0,0,0,0,1,0,1,0,1,0,1,0,0,0,0,0,0,0,0
153448,2021,Russia,Poland,0,1,5,6,20/06/2021,0,0,1,1,7,6,6,19,2,0,1,3,0,0,0,0,3,2,0,5
153448,2021,USA,Russia,0,1,4,5,19/06/2021,0,0,0,0,1,1,3,5,0,1,1,2,0,0,0,0,0,0,0,0
153448,2021,China,Russia,0,0,0,0,18/06/2021,0,0,0,0,1,1,0,2,0,1,0,1,0,0,0,0,0,0,0,0
153448,2021,Russia,Serbia,0,1,2,3,14/06/2021,0,0,0,0,5,4,9,18,0,2,2,4,0,0,0,0,3,2,0,5
153448,2021,Russia,Canada,0,0,2,2,13/06/2021,0,0,0,0,4,0,4,8,0,1,1,2,0,0,0,0,2,0,0,2
153448,2021,Russia,Korea,0,1,0,1,12/6/2021,0,0,0,0,3,0,1,4,0,0,1,1,0,0,0,0,2,0,0,2
119097,2021,Russia,Poland,0,1,2,3,20/06/2021,12,1,54,67,0,0,1,1,0,0,0,0,0,0,0,0,5,3,0,8
119097,2021,USA,Russia,0,0,12,12,19/06/2021,12,1,73,86,3,1,1,5,1,1,2,4,0,0,1,1,9,5,2,16
119097,2021,China,Russia,0,0,4,4,18/06/2021,6,0,61,67,0,0,0,0,0,1,2,3,0,0,0,0,3,0,3,6
119097,2021,Russia,Serbia,0,0,3,3,14/06/2021,3,0,22,25,1,0,0,1,1,1,1,3,0,0,1,1,3,2,1,6
119097,2021,Russia,Canada,0,1,9,10,13/06/2021,8,0,38,46,1,1,0,2,1,1,1,3,0,0,0,0,7,1,0,8
119097,2021,Russia,Korea,1,1,6,8,12/6/2021,12,1,59,72,1,0,0,1,1,0,2,3,0,0,0,0,13,2,1,16
119097,2021,Türkiye,Russia,0,0,12,12,8/6/2021,6,0,74,80,1,0,2,3,0,3,5,8,0,0,0,0,4,3,1,8
119097,2021,Dominican Republic,Russia,0,0,5,5,6/6/2021,5,0,53,58,0,0,2,2,0,0,0,0,0,0,0,0,5,0,0,5
119097,2021,Japan,Russia,1,1,9,11,2/6/2021,3,0,92,95,1,0,1,2,1,4,0,5,0,0,1,1,6,2,2,10
119097,2021,Russia,Italy,0,4,13,17,31/05/2021,9,1,68,78,1,0,1,2,0,2,3,5,0,0,0,0,6,5,1,12
119097,2021,Russia,Netherlands,0,0,1,1,27/05/2021,1,0,14,15,1,0,0,1,0,0,0,0,0,0,0,0,2,1,0,3
119097,2021,Belgium,Russia,1,1,9,11,26/05/2021,9,1,110,120,2,2,0,4,0,4,2,6,0,0,1,1,12,4,2,18
119097,2021,Germany,Russia,0,1,6,7,25/05/2021,6,0,77,83,3,0,0,3,0,3,6,9,0,0,0,0,3,2,1,6
142339,2021,Russia,Poland,0,0,4,4,20/06/2021,0,0,0,0,1,0,1,2,1,1,1,3,0,0,0,0,0,0,0,0
142339,2021,USA,Russia,0,0,9,9,19/06/2021,0,0,3,3,3,0,4,7,1,3,2,6,0,0,0,0,6,2,0,8
142339,2021,China,Russia,0,1,9,10,18/06/2021,0,0,0,0,0,1,1,2,1,2,6,9,0,0,3,3,1,2,0,3
142339,2021,Russia,Serbia,1,1,10,12,14/06/2021,0,0,2,2,4,1,1,6,0,1,2,3,0,0,0,0,0,0,0,0
142339,2021,Russia,Canada,1,0,9,10,13/06/2021,0,0,2,2,4,0,0,4,1,2,1,4,0,0,2,2,3,0,1,4
142339,2021,Russia,Korea,0,2,9,11,12/6/2021,0,0,1,1,3,1,1,5,1,2,8,11,0,0,0,0,3,0,1,4
142339,2021,Türkiye,Russia,1,0,12,13,8/6/2021,0,0,3,3,5,0,5,10,6,5,8,19,1,0,4,5,5,2,0,7
142339,2021,Russia,Thailand,0,1,11,12,7/6/2021,0,0,1,1,4,1,1,6,6,4,6,16,0,0,0,0,3,0,0,3
142339,2021,Dominican Republic,Russia,0,1,23,24,6/6/2021,0,0,5,5,2,0,0,2,2,5,10,17,0,0,0,0,5,2,3,10
142339,2021,Japan,Russia,0,0,8,8,2/6/2021,0,0,2,2,2,0,9,11,4,6,1,11,0,0,0,0,1,5,0,6
142339,2021,Russia,Italy,1,1,16,18,31/05/2021,0,1,1,2,3,0,1,4,1,3,4,8,0,0,0,0,3,2,0,5
142339,2021,Russia,Netherlands,0,0,2,2,27/05/2021,0,0,0,0,0,0,2,2,0,0,0,0,0,0,0,0,0,0,0,0
142339,2021,Belgium,Russia,0,2,15,17,26/05/2021,0,0,0,0,1,1,2,4,2,4,3,9,1,0,0,1,2,1,2,5
142339,2021,Germany,Russia,0,1,3,4,25/05/2021,0,0,0,0,0,0,2,2,0,2,2,4,0,0,0,0,0,0,0,0
119677,2021,Russia,Poland,1,1,3,5,20/06/2021,0,0,1,1,1,1,3,5,2,1,0,3,2,0,10,12,0,1,0,1
119677,2021,USA,Russia,0,0,2,2,19/06/2021,0,0,0,0,2,1,3,6,1,1,0,2,1,0,6,7,0,0,0,0
119677,2021,China,Russia,0,0,3,3,18/06/2021,0,0,0,0,3,3,8,14,0,2,0,2,1,0,6,7,1,2,0,3
119677,2021,Russia,Serbia,1,0,5,6,14/06/2021,0,0,0,0,2,2,1,5,0,1,1,2,1,0,1,2,4,0,0,4
119677,2021,Russia,Canada,2,0,7,9,13/06/2021,0,0,2,2,7,0,8,15,0,0,1,1,2,2,5,9,4,0,0,4
119677,2021,Japan,Russia,0,0,7,7,2/6/2021,0,0,2,2,5,2,14,21,1,2,0,3,5,3,10,18,3,5,0,8
119677,2021,Brazil,Russia,1,0,7,8,1/6/2021,0,1,0,1,5,0,3,8,0,4,0,4,7,2,18,27,6,1,2,9
119677,2021,Russia,Italy,0,1,7,8,31/05/2021,0,0,0,0,10,1,5,16,1,2,0,3,7,2,26,35,4,3,1,8
119677,2021,Russia,Netherlands,0,0,1,1,27/05/2021,0,0,1,1,1,1,2,4,0,1,1,2,2,0,2,4,0,1,0,1
119677,2021,Belgium,Russia,0,1,7,8,26/05/2021,0,0,1,1,6,2,11,19,6,2,7,15,6,0,8,14,7,1,4,12
119677,2021,Germany,Russia,0,1,4,5,25/05/2021,0,0,0,0,10,1,11,22,1,2,5,8,4,3,11,18,1,1,1,3
142329,2021,Russia,Poland,1,0,8,9,20/06/2021,0,0,0,0,10,6,11,27,2,2,3,7,6,3,18,27,3,1,1,5
142329,2021,USA,Russia,1,3,6,10,19/06/2021,0,0,5,5,12,2,10,24,0,3,2,5,4,1,13,18,8,3,3,14
142329,2021,China,Russia,1,0,7,8,18/06/2021,0,0,1,1,12,3,14,29,0,1,4,5,7,0,21,28,8,4,1,13
142329,2021,Russia,Serbia,0,1,7,8,14/06/2021,0,0,0,0,8,1,3,12,1,0,2,3,2,0,3,5,6,0,1,7
142329,2021,Russia,Canada,0,0,0,0,13/06/2021,0,0,0,0,0,0,0,0,0,0,0,0,0,0,0,0,0,0,0,0
142329,2021,Russia,Korea,2,2,16,20,12/6/2021,0,0,3,3,14,4,6,24,2,1,5,8,3,0,12,15,5,2,2,9
142329,2021,Türkiye,Russia,1,1,9,11,8/6/2021,0,0,1,1,9,6,15,30,0,1,4,5,5,1,13,19,10,1,0,11
142329,2021,Russia,Thailand,0,2,8,10,7/6/2021,0,0,2,2,5,2,10,17,1,2,0,3,10,1,11,22,13,1,0,14
142329,2021,Dominican Republic,Russia,1,3,14,18,6/6/2021,0,0,5,5,18,6,19,43,0,3,6,9,5,1,22,28,14,0,2,16
142329,2021,Japan,Russia,1,1,9,11,2/6/2021,0,0,0,0,10,2,10,22,0,2,1,3,10,1,7,18,2,2,0,4
142329,2021,Brazil,Russia,0,0,5,5,1/6/2021,0,0,0,0,5,4,12,21,1,0,0,1,3,1,4,8,2,2,2,6
142329,2021,Russia,Italy,0,1,2,3,31/05/2021,0,0,0,0,3,4,6,13,0,0,0,0,0,1,2,3,4,1,0,5
142329,2021,Russia,Netherlands,0,0,2,2,27/05/2021,0,0,1,1,0,1,4,5,0,0,0,0,1,0,1,2,3,1,0,4
142329,2021,Belgium,Russia,1,4,13,18,26/05/2021,0,0,1,1,16,3,18,37,0,6,2,8,13,0,24,37,9,2,1,12
142329,2021,Germany,Russia,3,1,10,14,25/05/2021,0,0,1,1,10,3,8,21,1,3,2,6,9,2,11,22,5,0,0,5
173153,2021,Russia,Poland,0,0,0,0,20/06/2021,0,0,6,6,0,0,0,0,0,0,0,0,2,0,4,6,11,3,1,15
173153,2021,USA,Russia,0,0,0,0,19/06/2021,0,0,4,4,0,0,0,0,0,0,0,0,0,1,10,11,6,3,1,10
173153,2021,China,Russia,0,0,0,0,18/06/2021,0,0,6,6,0,0,0,0,0,0,0,0,1,0,16,17,14,3,2,19
173153,2021,Russia,Serbia,0,0,0,0,14/06/2021,0,0,4,4,0,0,0,0,0,0,0,0,3,1,7,11,10,3,2,15
173153,2021,Russia,Canada,0,0,0,0,13/06/2021,0,0,4,4,0,0,0,0,0,0,0,0,0,0,5,5,10,3,0,13
173153,2021,Russia,Korea,0,0,0,0,12/6/2021,0,0,12,12,0,0,0,0,0,0,0,0,3,0,10,13,17,2,4,23
180970,2021,Russia,Serbia,1,0,4,5,14/06/2021,6,0,39,45,1,0,2,3,0,2,2,4,0,0,0,0,1,1,0,2
180970,2021,Russia,Korea,0,0,0,0,12/6/2021,2,0,8,10,0,1,0,1,0,0,0,0,0,0,0,0,0,0,0,0
180970,2021,Türkiye,Russia,0,0,1,1,8/6/2021,2,1,14,17,0,0,0,0,0,0,1,1,0,0,0,0,0,0,0,0
180970,2021,Russia,Thailand,0,1,2,3,7/6/2021,3,0,18,21,0,0,1,1,0,0,0,0,0,0,0,0,3,0,1,4
180970,2021,Brazil,Russia,0,0,3,3,1/6/2021,1,3,42,46,0,0,0,0,0,1,1,2,0,0,0,0,7,2,1,10
180970,2021,Russia,Italy,0,0,0,0,31/05/2021,0,0,0,0,0,0,0,0,0,0,0,0,0,0,0,0,0,0,0,0
180970,2021,Russia,Netherlands,1,1,12,14,27/05/2021,8,0,77,85,1,0,1,2,0,2,0,2,0,0,0,0,10,4,0,14
180970,2021,Germany,Russia,0,0,0,0,25/05/2021,0,0,0,0,0,0,0,0,0,0,0,0,0,0,0,0,0,0,0,0
164025,2021,Russia,Poland,0,1,1,2,20/06/2021,0,0,0,0,0,0,0,0,0,0,0,0,0,0,0,0,0,0,0,0
164025,2021,USA,Russia,0,0,0,0,19/06/2021,0,0,0,0,0,0,0,0,0,0,0,0,0,0,0,0,0,0,0,0
164025,2021,China,Russia,0,1,0,1,18/06/2021,0,0,0,0,0,0,0,0,0,0,0,0,0,0,0,0,0,0,0,0
164025,2021,Russia,Serbia,1,0,1,2,14/06/2021,0,0,0,0,0,0,0,0,0,0,0,0,0,0,0,0,0,0,0,0
164025,2021,Russia,Canada,0,1,1,2,13/06/2021,0,0,1,1,0,0,0,0,0,0,0,0,0,0,1,1,0,0,0,0
164025,2021,Russia,Korea,0,0,0,0,12/6/2021,0,0,0,0,0,0,0,0,0,0,0,0,0,0,0,0,2,0,0,2
164025,2021,Türkiye,Russia,1,2,3,6,8/6/2021,0,0,0,0,0,0,0,0,0,0,0,0,0,0,0,0,2,2,0,4
164025,2021,Russia,Thailand,0,0,0,0,7/6/2021,0,0,0,0,0,0,0,0,0,0,0,0,0,0,1,1,1,0,0,1
164025,2021,Dominican Republic,Russia,0,0,0,0,6/6/2021,0,0,0,0,0,0,0,0,0,0,0,0,0,0,0,0,0,0,0,0
164025,2021,Brazil,Russia,0,0,0,0,1/6/2021,0,0,0,0,0,2,2,4,0,0,1,1,0,1,4,5,2,0,0,2
151625,2021,Russia,Poland,1,2,8,11,20/06/2021,0,0,1,1,5,5,8,18,0,1,2,3,2,0,1,3,3,0,0,3
151625,2021,USA,Russia,0,1,3,4,19/06/2021,0,0,0,0,2,0,2,4,0,2,0,2,1,3,3,7,0,0,1,1
151625,2021,China,Russia,0,0,3,3,18/06/2021,0,0,0,0,0,0,0,0,0,0,0,0,0,0,0,0,0,0,0,0
151625,2021,Russia,Serbia,0,0,6,6,14/06/2021,0,0,0,0,4,3,1,8,0,0,0,0,3,2,12,17,3,1,0,4
151625,2021,Russia,Canada,2,1,6,9,13/06/2021,0,0,0,0,0,1,2,3,0,2,1,3,1,0,1,2,1,0,0,1
151625,2021,Russia,Korea,0,1,5,6,12/6/2021,0,0,0,0,4,3,5,12,0,1,0,1,2,0,8,10,2,1,0,3
151625,2021,Türkiye,Russia,2,2,8,12,8/6/2021,0,0,1,1,10,3,6,19,0,2,2,4,2,1,12,15,6,2,0,8
151625,2021,Russia,Thailand,0,1,1,2,7/6/2021,0,0,0,0,5,1,3,9,2,1,0,3,1,2,3,6,2,0,0,2
151625,2021,Dominican Republic,Russia,0,0,1,1,6/6/2021,0,0,0,0,0,0,2,2,0,0,0,0,0,0,1,1,3,0,0,3
151625,2021,Japan,Russia,0,1,1,2,2/6/2021,0,0,0,0,0,0,0,0,0,0,0,0,0,0,0,0,0,0,0,0
151625,2021,Brazil,Russia,0,0,7,7,1/6/2021,0,0,1,1,8,5,20,33,0,1,0,1,1,0,0,1,6,3,0,9
151625,2021,Russia,Italy,0,1,4,5,31/05/2021,0,0,0,0,0,0,0,0,0,0,0,0,0,0,0,0,1,0,0,1
151625,2021,Russia,Netherlands,1,3,8,12,27/05/2021,0,1,0,1,17,5,18,40,0,0,0,0,0,0,0,0,5,3,0,8
151625,2021,Germany,Russia,0,0,4,4,25/05/2021,0,0,0,0,0,0,1,1,0,0,0,0,0,0,0,0,1,0,0,1
152168,2021,Canada,Serbia,0,0,0,0,12/6/2021,0,0,0,0,0,0,0,0,0,0,0,0,0,0,0,0,1,0,0,1
152168,2021,Belgium,Serbia,0,3,16,19,8/6/2021,0,0,5,5,14,9,32,55,2,6,7,15,5,0,21,26,24,2,8,34
152168,2021,China,Serbia,3,1,14,18,7/6/2021,0,0,3,3,22,12,14,48,1,2,1,4,14,0,22,36,9,3,0,12
152168,2021,Brazil,Serbia,0,1,4,5,6/6/2021,0,0,2,2,6,2,6,14,0,0,1,1,12,4,12,28,4,0,1,5
152168,2021,Netherlands,Serbia,2,3,10,15,2/6/2021,0,0,3,3,14,6,16,36,0,0,3,3,7,1,27,35,11,5,5,21
152168,2021,Serbia,Thailand,0,2,16,18,1/6/2021,1,0,1,2,14,2,12,28,0,2,0,2,8,0,12,20,14,0,1,15
152168,2021,Serbia,USA,2,2,2,6,31/05/2021,0,0,0,0,8,3,10,21,2,2,4,8,6,1,16,23,5,2,1,8
152168,2021,Serbia,Italy,0,3,14,17,27/05/2021,0,0,4,4,17,8,22,47,1,2,3,6,7,0,15,22,10,0,1,11
152168,2021,Serbia,Poland,0,4,17,21,26/05/2021,0,0,3,3,17,3,18,38,1,4,0,5,7,3,22,32,4,2,1,7
152168,2021,Türkiye,Serbia,5,2,23,30,25/05/2021,0,0,0,0,10,10,21,41,2,4,4,10,9,2,14,25,14,2,1,17
163120,2021,Canada,Serbia,1,1,13,15,12/6/2021,0,0,3,3,12,6,14,32,2,2,3,7,0,0,0,0,9,3,0,12
163120,2021,Belgium,Serbia,0,1,14,15,8/6/2021,0,0,3,3,18,5,24,47,1,5,11,17,0,0,0,0,12,4,1,17
163120,2021,China,Serbia,0,1,12,13,7/6/2021,0,0,0,0,20,5,17,42,2,4,0,6,0,0,0,0,6,2,1,9
163120,2021,Brazil,Serbia,1,0,5,6,6/6/2021,0,0,5,5,3,3,11,17,0,1,1,2,0,0,0,0,3,1,0,4
163120,2021,Netherlands,Serbia,0,0,8,8,2/6/2021,0,0,1,1,7,8,20,35,0,1,2,3,0,0,0,0,8,3,3,14
163120,2021,Serbia,Thailand,0,1,9,10,1/6/2021,0,0,0,0,8,7,16,31,6,3,3,12,0,0,0,0,13,2,2,17
163120,2021,Serbia,Italy,0,4,5,9,27/05/2021,0,0,2,2,8,9,10,27,3,1,1,5,0,0,0,0,8,0,1,9
163120,2021,Serbia,Poland,0,1,8,9,26/05/2021,0,0,1,1,19,3,13,35,2,2,1,5,0,0,0,0,5,2,0,7
163120,2021,Türkiye,Serbia,0,4,9,13,25/05/2021,0,0,0,0,18,8,26,52,4,1,2,7,1,1,3,5,10,0,1,11
181204,2021,Japan,Serbia,0,0,6,6,20/06/2021,0,0,0,0,1,4,13,18,1,0,0,1,3,1,7,11,1,0,0,1
181204,2021,Dominican Republic,Serbia,0,3,8,11,19/06/2021,0,0,4,4,14,0,8,22,2,1,0,3,11,2,18,31,4,1,0,5
181204,2021,Germany,Serbia,0,0,0,0,18/06/2021,0,0,0,0,0,1,0,1,0,0,0,0,0,0,0,0,0,1,0,1
181204,2021,Russia,Serbia,0,0,5,5,14/06/2021,0,0,1,1,4,2,4,10,0,0,1,1,0,2,2,4,0,2,1,3
181204,2021,Korea,Serbia,1,1,5,7,13/06/2021,0,0,0,0,3,2,7,12,0,2,1,3,1,1,2,4,8,0,1,9
181204,2021,Canada,Serbia,0,0,1,1,12/6/2021,0,0,0,0,0,1,1,2,0,0,0,0,0,0,5,5,1,1,0,2
181204,2021,Belgium,Serbia,0,0,4,4,8/6/2021,0,0,1,1,1,2,4,7,0,2,1,3,0,0,0,0,1,0,0,1
181204,2021,China,Serbia,0,0,0,0,7/6/2021,0,0,0,0,0,0,0,0,0,0,0,0,0,0,0,0,0,0,0,0
181204,2021,Brazil,Serbia,0,0,0,0,6/6/2021,0,0,0,0,0,0,0,0,0,0,0,0,0,0,0,0,0,0,0,0
181204,2021,Netherlands,Serbia,0,1,0,1,2/6/2021,0,0,0,0,1,2,0,3,0,0,0,0,0,0,0,0,1,0,0,1
181204,2021,Serbia,Thailand,0,0,0,0,1/6/2021,0,0,0,0,0,0,0,0,0,0,0,0,0,0,0,0,0,0,0,0
181204,2021,Serbia,USA,0,0,11,11,31/05/2021,0,1,3,4,8,7,8,23,0,1,0,1,3,3,8,14,4,2,3,9
181204,2021,Serbia,Italy,0,0,0,0,27/05/2021,0,0,0,0,0,0,0,0,0,0,0,0,0,0,0,0,0,0,0,0
181204,2021,Serbia,Poland,0,0,0,0,26/05/2021,0,0,0,0,0,0,0,0,0,0,0,0,0,0,0,0,0,0,0,0
181204,2021,Türkiye,Serbia,0,0,0,0,25/05/2021,0,0,0,0,0,0,0,0,0,0,0,0,0,0,0,0,0,0,0,0
152169,2021,Japan,Serbia,0,0,1,1,20/06/2021,1,0,20,21,0,0,0,0,1,2,1,4,0,0,0,0,0,0,0,0
152169,2021,Dominican Republic,Serbia,0,1,5,6,19/06/2021,11,1,36,48,1,0,1,2,0,1,0,1,0,0,0,0,4,3,0,7
152169,2021,Germany,Serbia,0,0,8,8,18/06/2021,2,0,50,52,2,0,1,3,0,1,1,2,0,0,0,0,5,3,1,9
152169,2021,Russia,Serbia,1,0,5,6,14/06/2021,5,0,53,58,1,0,1,2,1,3,2,6,0,0,0,0,3,2,1,6
152169,2021,Korea,Serbia,0,1,3,4,13/06/2021,3,0,30,33,0,0,2,2,0,1,2,3,0,1,0,1,1,1,1,3
152169,2021,Canada,Serbia,0,1,9,10,12/6/2021,9,0,54,63,1,0,0,1,0,3,1,4,0,0,0,0,7,3,1,11
152169,2021,Belgium,Serbia,1,1,17,19,8/6/2021,23,3,104,130,1,0,2,3,2,1,4,7,0,0,0,0,8,3,1,12
152169,2021,China,Serbia,1,2,13,16,7/6/2021,5,0,71,76,3,0,1,4,0,1,0,1,0,0,0,0,2,5,0,7
152169,2021,Brazil,Serbia,0,0,1,1,6/6/2021,1,0,24,25,0,0,2,2,0,1,0,1,0,0,0,0,2,0,0,2
152169,2021,Netherlands,Serbia,0,1,1,2,2/6/2021,3,0,21,24,0,0,1,1,0,0,0,0,0,0,0,0,2,0,0,2
152169,2021,Serbia,Thailand,1,0,9,10,1/6/2021,14,1,75,90,3,0,3,6,2,0,3,5,0,0,0,0,3,0,1,4
152169,2021,Serbia,USA,0,0,5,5,31/05/2021,5,0,66,71,0,1,0,1,0,1,3,4,0,1,0,1,7,3,2,12
152169,2021,Serbia,Italy,1,1,19,21,27/05/2021,20,1,81,102,1,0,1,2,1,0,0,1,0,0,0,0,11,0,1,12
152169,2021,Serbia,Poland,0,2,11,13,26/05/2021,10,1,90,101,1,0,0,1,1,2,0,3,0,0,0,0,4,1,0,5
152169,2021,Türkiye,Serbia,0,0,14,14,25/05/2021,8,0,124,132,0,0,1,1,1,1,3,5,0,0,0,0,2,1,2,5
152167,2021,Japan,Serbia,0,0,7,7,20/06/2021,0,0,0,0,4,2,2,8,3,2,0,5,0,0,0,0,2,0,0,2
152167,2021,Dominican Republic,Serbia,0,1,3,4,19/06/2021,0,0,1,1,1,2,2,5,2,5,4,11,0,0,0,0,1,0,0,1
152167,2021,Germany,Serbia,0,0,8,8,18/06/2021,0,0,0,0,1,1,1,3,3,4,0,7,0,0,0,0,1,1,0,2
152167,2021,Russia,Serbia,0,0,6,6,14/06/2021,0,0,1,1,0,3,2,5,2,2,1,5,0,0,0,0,0,0,0,0
152167,2021,Korea,Serbia,2,0,11,13,13/06/2021,0,0,2,2,4,1,2,7,1,8,5,14,0,0,0,0,3,1,3,7
152167,2021,Canada,Serbia,0,0,12,12,12/6/2021,0,0,1,1,6,1,4,11,1,5,5,11,0,0,0,0,3,0,2,5
152167,2021,Belgium,Serbia,1,0,18,19,8/6/2021,0,0,3,3,5,0,6,11,4,8,12,24,0,0,0,0,9,0,0,9
152167,2021,China,Serbia,0,0,9,9,7/6/2021,0,0,0,0,7,2,5,14,2,0,1,3,0,0,0,0,4,0,0,4
152167,2021,Brazil,Serbia,0,0,3,3,6/6/2021,0,0,1,1,2,0,3,5,0,3,1,4,0,0,0,0,2,0,0,2
152167,2021,Netherlands,Serbia,0,0,13,13,2/6/2021,0,0,4,4,7,0,7,14,7,5,10,22,0,0,2,2,4,0,1,5
152167,2021,Serbia,Thailand,0,1,12,13,1/6/2021,0,0,1,1,4,1,4,9,5,4,6,15,1,0,1,2,2,0,1,3
152167,2021,Serbia,USA,0,0,0,0,31/05/2021,0,0,0,0,0,0,0,0,0,0,0,0,0,0,0,0,0,0,0,0
152167,2021,Serbia,Italy,0,1,22,23,27/05/2021,0,0,2,2,8,0,6,14,1,7,2,10,0,0,0,0,0,2,0,2
152167,2021,Serbia,Poland,0,1,16,17,26/05/2021,0,0,0,0,3,0,2,5,6,4,4,14,0,0,1,1,3,0,0,3
152167,2021,Türkiye,Serbia,1,3,15,19,25/05/2021,0,0,0,0,5,2,3,10,6,10,5,21,0,0,1,1,4,2,0,6
142479,2021,Japan,Serbia,0,1,4,5,20/06/2021,0,0,5,5,6,2,9,17,1,1,0,2,14,5,17,36,1,4,0,5
142479,2021,Dominican Republic,Serbia,0,0,0,0,19/06/2021,0,0,0,0,0,0,0,0,0,0,0,0,0,0,0,0,0,0,0,0
142479,2021,Germany,Serbia,1,1,9,11,18/06/2021,0,0,5,5,8,3,10,21,1,0,0,1,9,1,11,21,8,4,0,12
142479,2021,Russia,Serbia,1,0,9,10,14/06/2021,0,0,5,5,7,5,9,21,1,1,1,3,2,2,15,19,6,4,0,10
142479,2021,Korea,Serbia,0,2,8,10,13/06/2021,0,0,4,4,7,4,25,36,1,1,1,3,9,1,29,39,11,5,2,18
142479,2021,Canada,Serbia,3,0,11,14,12/6/2021,0,0,5,5,12,5,13,30,1,0,3,4,8,3,22,33,11,5,0,16
142479,2021,Belgium,Serbia,2,1,14,17,8/6/2021,0,0,7,7,13,3,27,43,1,3,8,12,8,4,24,36,16,1,1,18
142479,2021,China,Serbia,3,2,10,15,7/6/2021,0,0,4,4,11,5,14,30,2,1,0,3,12,1,14,27,10,2,0,12
142479,2021,Brazil,Serbia,0,2,0,2,6/6/2021,0,0,1,1,2,3,3,8,0,1,0,1,4,1,4,9,1,0,1,2
142479,2021,Netherlands,Serbia,0,2,3,5,2/6/2021,0,0,3,3,7,5,14,26,1,2,2,5,0,3,13,16,3,2,0,5
142479,2021,Serbia,Thailand,3,0,5,8,1/6/2021,0,0,1,1,3,4,9,16,0,0,0,0,3,2,9,14,5,0,0,5
142479,2021,Serbia,USA,0,0,0,0,31/05/2021,0,0,0,0,0,0,1,1,0,0,0,0,0,0,0,0,0,0,0,0
142479,2021,Serbia,Italy,0,1,7,8,27/05/2021,0,0,1,1,8,4,7,19,0,1,0,1,5,0,20,25,7,1,0,8
142479,2021,Serbia,Poland,0,1,13,14,26/05/2021,0,0,4,4,13,6,12,31,0,5,1,6,6,1,14,21,12,1,1,14
142479,2021,Türkiye,Serbia,1,3,9,13,25/05/2021,0,0,0,0,13,2,21,36,1,0,2,3,13,2,28,43,7,0,2,9
163056,2021,Japan,Serbia,0,2,7,9,20/06/2021,2,0,55,57,3,0,1,4,2,6,2,10,0,0,0,0,4,3,0,7
163056,2021,Dominican Republic,Serbia,0,2,0,2,19/06/2021,4,0,22,26,1,0,0,1,0,1,0,1,0,0,0,0,2,3,0,5
163056,2021,Germany,Serbia,0,1,1,2,18/06/2021,0,0,21,21,0,2,0,2,1,0,0,1,0,0,0,0,3,0,0,3
163056,2021,Russia,Serbia,0,0,0,0,14/06/2021,1,0,2,3,0,0,0,0,0,0,0,0,0,0,0,0,1,0,0,1
163056,2021,Korea,Serbia,1,0,6,7,13/06/2021,7,0,77,84,1,1,0,2,0,4,2,6,0,0,0,0,5,1,0,6
163056,2021,Canada,Serbia,0,1,3,4,12/6/2021,3,0,39,42,0,0,3,3,3,3,2,8,0,0,0,0,2,3,0,5
163056,2021,Belgium,Serbia,0,0,0,0,8/6/2021,2,0,19,21,0,1,0,1,1,1,0,2,0,0,0,0,2,2,0,4
163056,2021,China,Serbia,0,2,1,3,7/6/2021,2,0,46,48,0,0,0,0,0,1,0,1,0,0,0,0,2,0,0,2
163056,2021,Brazil,Serbia,0,2,3,5,6/6/2021,6,1,35,42,1,0,0,1,1,1,1,3,0,0,0,0,3,1,1,5
163056,2021,Netherlands,Serbia,0,1,18,19,2/6/2021,21,2,83,106,0,0,2,2,0,1,1,2,0,0,0,0,12,0,2,14
163056,2021,Serbia,Thailand,0,0,1,1,1/6/2021,2,0,12,14,1,0,0,1,0,1,0,1,0,0,0,0,1,0,0,1
163056,2021,Serbia,USA,0,0,0,0,31/05/2021,0,1,15,16,0,0,0,0,0,0,0,0,0,0,0,0,2,2,2,6
163056,2021,Serbia,Italy,0,1,1,2,27/05/2021,1,0,14,15,1,0,0,1,0,1,0,1,0,0,0,0,1,2,0,3
163056,2021,Serbia,Poland,0,1,0,1,26/05/2021,0,1,8,9,0,0,0,0,0,0,0,0,0,0,0,0,0,0,0,0
163056,2021,Türkiye,Serbia,0,0,1,1,25/05/2021,1,0,28,29,1,1,0,2,0,0,1,1,0,0,0,0,1,1,0,2
138480,2021,Japan,Serbia,0,0,1,1,20/06/2021,0,0,0,0,0,1,1,2,0,0,0,0,0,0,0,0,0,0,0,0
138480,2021,Dominican Republic,Serbia,0,0,0,0,19/06/2021,0,0,0,0,0,0,0,0,0,0,0,0,0,0,0,0,0,0,0,0
138480,2021,Germany,Serbia,1,0,4,5,18/06/2021,0,0,0,0,0,0,0,0,0,2,0,2,0,0,1,1,0,0,0,0
138480,2021,Russia,Serbia,1,1,3,5,14/06/2021,0,0,0,0,2,0,0,2,1,1,0,2,0,0,0,0,2,0,0,2
138480,2021,Korea,Serbia,1,1,5,7,13/06/2021,0,0,0,0,2,1,1,4,1,3,4,8,0,0,0,0,0,0,0,0
138480,2021,Canada,Serbia,0,1,5,6,12/6/2021,0,0,0,0,1,2,3,6,1,5,2,8,0,0,1,1,5,0,0,5
138480,2021,Belgium,Serbia,0,0,2,2,8/6/2021,0,0,1,1,0,0,0,0,1,2,1,4,0,0,0,0,0,0,0,0
138480,2021,China,Serbia,1,0,16,17,7/6/2021,0,0,1,1,3,2,3,8,1,3,1,5,0,0,0,0,1,0,0,1
138480,2021,Brazil,Serbia,0,0,0,0,6/6/2021,0,0,0,0,0,0,0,0,0,0,0,0,0,0,0,0,0,0,0,0
138480,2021,Netherlands,Serbia,0,2,8,10,2/6/2021,0,0,2,2,4,1,4,9,3,7,7,17,0,0,1,1,4,0,1,5
138480,2021,Serbia,Thailand,0,2,6,8,1/6/2021,0,0,0,0,1,3,3,7,3,0,7,10,0,0,0,0,1,0,0,1
138480,2021,Serbia,USA,1,0,4,5,31/05/2021,0,0,2,2,2,1,4,7,2,2,5,9,0,0,0,0,3,0,0,3
138480,2021,Serbia,Italy,1,1,11,13,27/05/2021,0,0,1,1,5,0,6,11,2,4,3,9,0,0,1,1,0,0,0,0
138480,2021,Serbia,Poland,0,0,2,2,26/05/2021,0,0,0,0,0,1,3,4,0,1,0,1,0,0,1,1,0,0,0,0
138480,2021,Türkiye,Serbia,2,2,9,13,25/05/2021,0,0,0,0,5,2,7,14,4,2,6,12,0,0,0,0,3,1,1,5
153452,2021,Japan,Serbia,0,2,2,4,20/06/2021,0,0,0,0,2,1,4,7,0,0,0,0,0,0,0,0,0,0,0,0
153452,2021,Dominican Republic,Serbia,0,0,2,2,19/06/2021,0,0,0,0,0,1,2,3,0,1,0,1,0,0,0,0,1,0,0,1
153452,2021,Germany,Serbia,0,1,6,7,18/06/2021,0,0,0,0,1,0,7,8,0,2,0,2,1,0,1,2,1,1,0,2
153452,2021,Russia,Serbia,0,1,2,3,14/06/2021,0,0,0,0,0,0,2,2,0,2,1,3,0,0,1,1,2,0,0,2
153452,2021,Korea,Serbia,0,0,2,2,13/06/2021,0,0,0,0,3,3,0,6,0,2,2,4,0,0,0,0,0,0,0,0
153452,2021,Canada,Serbia,0,0,1,1,12/6/2021,0,0,0,0,0,0,0,0,0,0,0,0,0,0,0,0,1,0,0,1
153452,2021,Belgium,Serbia,0,1,7,8,8/6/2021,0,0,1,1,9,1,3,13,1,9,13,23,0,0,0,0,2,1,1,4
153452,2021,China,Serbia,0,0,1,1,7/6/2021,0,0,0,0,0,0,0,0,0,0,0,0,0,0,0,0,0,1,0,1
153452,2021,Brazil,Serbia,0,1,8,9,6/6/2021,0,0,2,2,2,2,4,8,1,4,5,10,0,0,0,0,2,0,2,4
153452,2021,Serbia,Italy,0,0,0,0,27/05/2021,0,0,0,0,0,0,0,0,0,0,0,0,0,0,0,0,0,0,0,0
153452,2021,Serbia,Poland,3,0,12,15,26/05/2021,0,0,0,0,5,1,0,6,1,4,0,5,0,0,0,0,1,0,0,1
153452,2021,Türkiye,Serbia,0,0,0,0,25/05/2021,0,0,0,0,0,0,0,0,0,0,0,0,0,0,0,0,0,0,0,0
173974,2021,Japan,Serbia,1,1,10,12,20/06/2021,0,0,2,2,6,6,14,26,0,2,0,2,0,0,0,0,4,4,0,8
173974,2021,Dominican Republic,Serbia,0,2,7,9,19/06/2021,0,0,1,1,9,2,7,18,0,2,1,3,0,0,0,0,3,1,0,4
173974,2021,Germany,Serbia,0,1,8,9,18/06/2021,0,0,0,0,10,5,10,25,3,0,0,3,0,0,0,0,1,3,0,4
173974,2021,Russia,Serbia,0,0,6,6,14/06/2021,0,0,0,0,7,3,8,18,0,3,0,3,0,0,0,0,1,2,2,5
173974,2021,Korea,Serbia,3,0,7,10,13/06/2021,0,0,0,0,7,4,14,25,0,2,1,3,0,0,0,0,10,2,0,12
173974,2021,Canada,Serbia,0,2,1,3,12/6/2021,0,0,0,0,1,0,4,5,0,2,2,4,0,0,0,0,1,0,0,1
173974,2021,Brazil,Serbia,0,0,0,0,6/6/2021,0,0,1,1,0,3,1,4,0,0,0,0,0,0,0,0,1,2,0,3
173974,2021,Netherlands,Serbia,1,0,2,3,2/6/2021,0,0,0,0,3,1,3,7,0,0,1,1,0,0,0,0,2,1,0,3
173974,2021,Serbia,Thailand,0,0,0,0,1/6/2021,0,0,0,0,0,0,0,0,0,0,0,0,0,0,0,0,0,0,0,0
173974,2021,Serbia,USA,0,1,4,5,31/05/2021,0,0,0,0,1,5,16,22,0,3,3,6,0,0,0,0,3,0,2,5
173974,2021,Serbia,Italy,0,0,0,0,27/05/2021,0,0,0,0,1,2,1,4,1,0,0,1,0,0,0,0,0,0,0,0
173974,2021,Serbia,Poland,0,1,0,1,26/05/2021,0,0,0,0,0,1,2,3,0,0,1,1,0,0,0,0,1,0,0,1
173974,2021,Türkiye,Serbia,0,1,1,2,25/05/2021,0,0,0,0,3,1,5,9,0,1,1,2,0,0,0,0,2,0,1,3
152176,2021,Japan,Serbia,0,0,0,0,20/06/2021,0,0,0,0,0,0,0,0,0,0,0,0,0,0,0,0,0,0,0,0
152176,2021,Dominican Republic,Serbia,0,1,2,3,19/06/2021,0,0,0,0,3,2,4,9,0,0,0,0,0,0,0,0,1,3,0,4
152176,2021,Germany,Serbia,0,1,0,1,18/06/2021,0,0,0,0,0,0,1,1,0,0,0,0,0,0,0,0,0,0,0,0
152176,2021,Russia,Serbia,0,0,0,0,14/06/2021,0,0,1,1,1,0,0,1,0,0,1,1,0,0,0,0,0,0,0,0
152176,2021,Korea,Serbia,0,0,0,0,13/06/2021,0,0,0,0,0,0,0,0,0,0,0,0,0,0,0,0,0,0,0,0
152176,2021,Belgium,Serbia,0,0,0,0,8/6/2021,0,0,0,0,0,0,0,0,0,0,0,0,0,0,0,0,0,0,0,0
152176,2021,China,Serbia,0,0,0,0,7/6/2021,0,0,0,0,0,1,0,1,0,0,0,0,0,0,0,0,0,0,0,0
152176,2021,Netherlands,Serbia,0,0,0,0,2/6/2021,0,0,0,0,0,0,0,0,0,0,0,0,0,0,0,0,0,0,0,0
152176,2021,Serbia,USA,0,0,3,3,31/05/2021,0,0,0,0,1,3,8,12,0,2,1,3,0,0,0,0,2,0,2,4
163967,2021,Japan,Serbia,0,0,0,0,20/06/2021,0,0,0,0,0,0,0,0,0,0,0,0,0,0,0,0,0,0,0,0
163967,2021,Dominican Republic,Serbia,0,0,6,6,19/06/2021,0,0,0,0,0,2,1,3,3,2,1,6,0,0,0,0,4,0,1,5
163967,2021,Germany,Serbia,1,0,3,4,18/06/2021,0,0,0,0,0,0,1,1,1,1,0,2,0,0,0,0,0,0,0,0
163967,2021,Russia,Serbia,0,1,1,2,14/06/2021,0,0,1,1,0,0,1,1,2,1,0,3,0,0,0,0,0,0,0,0
163967,2021,Korea,Serbia,0,0,0,0,13/06/2021,0,0,0,0,0,0,0,0,0,0,0,0,0,0,0,0,0,0,0,0
163967,2021,Canada,Serbia,1,0,5,6,12/6/2021,0,0,1,1,0,0,0,0,0,0,0,0,0,0,0,0,0,1,0,1
163967,2021,Belgium,Serbia,0,0,0,0,8/6/2021,0,0,0,0,0,0,0,0,0,0,0,0,0,0,0,0,0,0,0,0
163967,2021,China,Serbia,0,0,0,0,7/6/2021,0,0,0,0,0,0,0,0,0,0,0,0,0,0,0,0,0,0,0,0
163967,2021,Brazil,Serbia,0,1,2,3,6/6/2021,0,0,0,0,0,0,0,0,0,1,0,1,0,0,0,0,0,0,0,0
163967,2021,Netherlands,Serbia,0,0,0,0,2/6/2021,0,0,0,0,0,0,0,0,0,0,0,0,0,0,0,0,0,0,0,0
163967,2021,Serbia,Thailand,0,0,0,0,1/6/2021,0,0,0,0,0,0,0,0,0,0,0,0,0,0,0,0,0,0,0,0
163967,2021,Serbia,USA,0,0,7,7,31/05/2021,0,0,1,1,0,0,4,4,1,3,2,6,0,0,0,0,1,1,0,2
163967,2021,Serbia,Italy,0,0,0,0,27/05/2021,0,0,0,0,0,0,0,0,0,0,0,0,0,0,0,0,0,0,0,0
163967,2021,Serbia,Poland,0,0,0,0,26/05/2021,0,0,0,0,0,0,0,0,0,0,0,0,0,0,0,0,0,0,0,0
163967,2021,Türkiye,Serbia,0,0,0,0,25/05/2021,0,0,0,0,0,0,0,0,0,0,0,0,0,0,0,0,0,0,0,0
163117,2021,Japan,Serbia,0,0,0,0,20/06/2021,0,0,5,5,0,0,0,0,0,0,0,0,1,0,4,5,6,3,0,9
163117,2021,Dominican Republic,Serbia,0,0,0,0,19/06/2021,0,0,0,0,0,0,0,0,0,0,0,0,0,2,0,2,0,0,0,0
163117,2021,Germany,Serbia,0,0,0,0,18/06/2021,0,0,6,6,0,0,0,0,0,0,0,0,2,1,8,11,12,6,2,20
163117,2021,Russia,Serbia,0,0,0,0,14/06/2021,0,0,3,3,0,0,0,0,0,0,0,0,4,2,12,18,5,2,0,7
163117,2021,Korea,Serbia,0,0,0,0,13/06/2021,0,0,8,8,0,0,0,0,0,0,0,0,4,1,18,23,15,3,4,22
163117,2021,China,Serbia,0,0,0,0,7/6/2021,0,0,12,12,0,0,0,0,0,0,0,0,9,2,11,22,6,5,1,12
163117,2021,Brazil,Serbia,0,0,0,0,6/6/2021,0,0,1,1,0,0,0,0,0,0,0,0,1,0,1,2,2,1,1,4
163117,2021,Netherlands,Serbia,0,0,0,0,2/6/2021,0,0,9,9,0,0,0,0,0,0,0,0,4,4,20,28,22,2,2,26
163117,2021,Serbia,Thailand,0,0,0,0,1/6/2021,0,0,3,3,0,0,0,0,0,0,0,0,1,2,8,11,17,1,3,21
163117,2021,Serbia,USA,0,0,0,0,31/05/2021,0,0,0,0,0,0,0,0,0,0,0,0,0,0,0,0,0,0,0,0
163117,2021,Serbia,Italy,0,0,0,0,27/05/2021,0,0,6,6,0,0,0,0,0,0,0,0,7,1,12,20,5,6,0,11
163117,2021,Serbia,Poland,0,0,0,0,26/05/2021,0,0,4,4,0,0,0,0,0,0,0,0,3,1,13,17,25,3,0,28
163117,2021,Türkiye,Serbia,0,0,0,0,25/05/2021,0,0,3,3,0,0,0,0,0,0,0,0,8,1,12,21,20,3,3,26
173178,2021,Japan,Serbia,0,0,0,0,20/06/2021,0,0,1,1,0,0,0,0,0,0,0,0,2,0,0,2,3,1,0,4
173178,2021,Dominican Republic,Serbia,0,0,0,0,19/06/2021,0,0,5,5,0,0,0,0,0,0,0,0,6,0,11,17,7,4,0,11
173178,2021,Germany,Serbia,0,0,0,0,18/06/2021,0,0,0,0,0,0,0,0,0,0,0,0,0,0,0,0,0,0,0,0
173178,2021,Russia,Serbia,0,0,0,0,14/06/2021,0,0,4,4,0,0,0,0,0,0,0,0,3,3,11,17,2,1,1,4
173178,2021,Korea,Serbia,0,0,0,0,13/06/2021,0,0,0,0,0,0,0,0,0,0,0,0,0,0,0,0,0,0,0,0
173178,2021,Canada,Serbia,0,0,0,0,12/6/2021,0,0,4,4,0,0,0,0,0,0,0,0,10,5,12,27,14,3,1,18
173178,2021,Belgium,Serbia,0,0,0,0,8/6/2021,0,1,11,12,0,0,0,0,0,0,0,0,5,4,26,35,25,2,1,28
173178,2021,China,Serbia,0,0,0,0,7/6/2021,0,0,0,0,0,0,0,0,0,0,0,0,0,0,0,0,0,0,0,0
173178,2021,Brazil,Serbia,0,0,0,0,6/6/2021,0,0,2,2,0,0,0,0,0,0,0,0,6,0,11,17,3,0,1,4
173178,2021,Netherlands,Serbia,0,0,0,0,2/6/2021,0,0,0,0,0,0,0,0,0,0,0,0,0,0,0,0,0,0,0,0
173178,2021,Serbia,Thailand,0,0,0,0,1/6/2021,0,0,0,0,0,0,0,0,0,0,0,0,0,0,0,0,0,0,0,0
173178,2021,Serbia,USA,0,0,0,0,31/05/2021,0,0,6,6,0,0,0,0,0,0,0,0,4,0,6,10,13,3,4,20
173178,2021,Serbia,Italy,0,0,0,0,27/05/2021,0,0,1,1,0,0,0,0,0,0,0,0,0,0,0,0,3,2,0,5
173178,2021,Serbia,Poland,0,0,0,0,26/05/2021,0,0,0,0,0,0,0,0,0,0,0,0,0,0,0,0,0,0,0,0
173178,2021,Türkiye,Serbia,0,0,0,0,25/05/2021,0,0,0,0,0,0,0,0,0,0,0,0,0,0,0,0,0,0,0,0
173979,2021,Japan,Serbia,0,1,1,2,20/06/2021,0,0,0,0,0,0,4,4,0,0,0,0,2,0,6,8,1,0,0,1
173979,2021,Dominican Republic,Serbia,0,1,1,2,19/06/2021,0,0,0,0,0,0,3,3,0,0,0,0,1,0,2,3,0,0,0,0
173979,2021,Germany,Serbia,0,0,3,3,18/06/2021,0,0,7,7,2,1,9,12,0,1,1,2,4,3,5,12,3,2,0,5
173979,2021,Russia,Serbia,0,0,0,0,14/06/2021,0,0,0,0,0,0,0,0,0,0,0,0,0,0,0,0,0,0,0,0
173979,2021,Korea,Serbia,0,1,0,1,13/06/2021,0,0,1,1,0,0,0,0,0,0,0,0,1,0,2,3,0,0,0,0
173979,2021,Canada,Serbia,0,0,0,0,12/6/2021,0,0,1,1,0,0,0,0,0,0,0,0,0,0,3,3,0,1,0,1
173979,2021,Belgium,Serbia,0,0,0,0,8/6/2021,0,0,0,0,0,0,0,0,0,0,0,0,0,0,0,0,0,0,0,0
173979,2021,Serbia,Thailand,0,0,0,0,1/6/2021,0,0,0,0,0,0,0,0,0,0,0,0,0,0,0,0,0,0,0,0
173979,2021,Serbia,USA,0,0,2,2,31/05/2021,0,0,0,0,0,0,0,0,0,0,0,0,0,0,0,0,0,0,0,0
163119,2021,Japan,Serbia,1,0,3,4,20/06/2021,0,0,0,0,0,1,7,8,0,1,1,2,0,1,3,4,0,2,1,3
163119,2021,Dominican Republic,Serbia,0,1,8,9,19/06/2021,0,0,3,3,5,4,13,22,0,1,3,4,5,0,14,19,3,0,0,3
163119,2021,Germany,Serbia,0,0,3,3,18/06/2021,0,0,1,1,7,2,11,20,0,1,0,1,6,1,9,16,4,1,0,5
163119,2021,Russia,Serbia,0,0,6,6,14/06/2021,0,0,2,2,5,5,7,17,1,3,2,6,3,2,7,12,5,2,0,7
163119,2021,Korea,Serbia,3,1,10,14,13/06/2021,0,0,2,2,8,8,24,40,5,3,0,8,7,1,8,16,10,2,1,13
163119,2021,Canada,Serbia,1,0,13,14,12/6/2021,0,0,4,4,15,8,13,36,1,2,0,3,8,0,3,11,9,5,1,15
163119,2021,Belgium,Serbia,0,0,2,2,8/6/2021,0,0,0,0,1,0,1,2,0,0,1,1,0,0,3,3,0,0,0,0
163119,2021,China,Serbia,0,0,1,1,7/6/2021,0,0,0,0,0,0,0,0,0,0,0,0,0,0,0,0,0,0,0,0
163119,2021,Brazil,Serbia,0,2,5,7,6/6/2021,0,0,3,3,8,4,13,25,1,1,1,3,5,0,4,9,3,4,1,8
163119,2021,Netherlands,Serbia,0,1,8,9,2/6/2021,0,0,0,0,11,2,7,20,0,1,1,2,3,0,1,4,6,3,0,9
163119,2021,Serbia,Thailand,0,1,4,5,1/6/2021,0,0,0,0,6,3,9,18,2,0,1,3,8,1,9,18,5,2,0,7
163119,2021,Serbia,USA,0,0,6,6,31/05/2021,0,0,1,1,3,0,6,9,0,1,2,3,3,0,9,12,4,1,0,5
163119,2021,Serbia,Italy,0,1,4,5,27/05/2021,0,0,0,0,6,1,6,13,0,0,0,0,4,0,3,7,3,0,0,3
163119,2021,Serbia,Poland,0,1,0,1,26/05/2021,0,0,0,0,0,0,0,0,0,0,0,0,0,0,0,0,0,0,0,0
163119,2021,Türkiye,Serbia,0,0,4,4,25/05/2021,0,0,0,0,1,1,1,3,0,0,0,0,1,0,3,4,2,1,0,3
131866,2021,Thailand,Italy,0,0,0,0,20/06/2021,0,0,5,5,0,0,0,0,0,0,0,0,12,0,13,25,7,2,0,9
131866,2021,Thailand,Canada,0,0,0,0,19/06/2021,0,0,5,5,0,0,0,0,0,0,0,0,10,1,4,15,6,0,3,9
131866,2021,Thailand,Belgium,0,0,0,0,18/06/2021,0,0,8,8,0,0,0,0,0,0,0,0,14,1,17,32,5,4,0,9
131866,2021,Brazil,Thailand,0,0,0,0,14/06/2021,0,0,8,8,0,0,0,0,0,0,0,0,5,0,8,13,14,5,0,19
131866,2021,Thailand,Poland,0,0,0,0,13/06/2021,0,0,5,5,0,0,0,0,0,0,0,0,4,0,10,14,9,1,1,11
131866,2021,Thailand,Germany,0,0,0,0,12/6/2021,0,0,8,8,0,0,0,0,0,0,0,0,4,0,7,11,7,1,2,10
131866,2021,Thailand,Dominican Republic,0,0,0,0,8/6/2021,0,0,9,9,0,0,0,0,0,0,0,0,20,1,19,40,4,0,0,4
131866,2021,Russia,Thailand,0,0,0,0,7/6/2021,0,0,1,1,0,0,0,0,0,0,0,0,14,3,18,35,4,1,2,7
131866,2021,Türkiye,Thailand,0,0,0,0,6/6/2021,0,0,10,10,0,0,0,0,0,0,0,0,11,2,10,23,10,1,0,11
131866,2021,Thailand,USA,0,0,0,0,2/6/2021,0,0,7,7,0,0,0,0,0,0,0,0,4,1,5,10,5,7,1,13
131866,2021,Serbia,Thailand,0,0,0,0,1/6/2021,0,0,4,4,0,0,0,0,0,0,0,0,6,0,6,12,12,2,1,15
131866,2021,Thailand,Netherlands,0,0,0,0,31/05/2021,0,0,1,1,0,0,0,0,0,0,0,0,4,1,9,14,6,5,0,11
131866,2021,China,Thailand,0,0,0,0,27/05/2021,0,0,6,6,0,0,0,0,0,0,0,0,13,0,7,20,6,2,1,9
131866,2021,Thailand,Korea,0,0,0,0,26/05/2021,0,0,8,8,0,0,0,0,0,0,0,0,11,1,6,18,9,1,1,11
131866,2021,Japan,Thailand,0,0,0,0,25/05/2021,0,0,0,0,0,0,0,0,0,0,0,0,1,3,5,9,6,0,1,7
181410,2021,Thailand,Italy,0,0,0,0,20/06/2021,0,0,0,0,0,0,0,0,0,0,0,0,0,0,0,0,0,0,0,0
181410,2021,Thailand,Canada,0,0,0,0,19/06/2021,0,0,0,0,0,0,0,0,0,0,0,0,0,0,0,0,0,0,0,0
181410,2021,Thailand,Poland,0,0,0,0,13/06/2021,1,0,4,5,0,0,0,0,0,0,0,0,0,0,0,0,0,2,0,2
181410,2021,Thailand,Germany,0,0,0,0,12/6/2021,0,0,0,0,0,0,0,0,0,0,0,0,0,0,0,0,0,0,0,0
181410,2021,Türkiye,Thailand,0,0,7,7,6/6/2021,7,0,50,57,0,0,0,0,0,0,1,1,0,0,0,0,4,0,2,6
181410,2021,Thailand,USA,0,0,2,2,2/6/2021,2,0,26,28,0,0,0,0,0,0,0,0,0,0,0,0,0,2,0,2
181410,2021,Serbia,Thailand,0,0,1,1,1/6/2021,0,0,7,7,1,1,0,2,0,1,1,2,0,0,0,0,0,0,0,0
181410,2021,Thailand,Netherlands,0,0,0,0,31/05/2021,0,0,0,0,0,0,0,0,0,0,0,0,0,0,0,0,0,1,0,1
181410,2021,China,Thailand,0,0,0,0,27/05/2021,0,0,4,4,0,0,0,0,0,0,0,0,0,0,0,0,0,0,0,0
181410,2021,Thailand,Korea,0,0,1,1,26/05/2021,2,0,12,14,0,0,0,0,0,0,0,0,0,0,0,0,3,0,0,3
181410,2021,Japan,Thailand,0,0,0,0,25/05/2021,1,0,7,8,0,0,0,0,0,0,0,0,0,0,0,0,1,0,0,1
113352,2021,Thailand,Italy,1,1,11,13,20/06/2021,0,0,3,3,12,2,15,29,3,5,4,12,0,0,0,0,6,3,1,10
113352,2021,Thailand,Canada,2,1,9,12,19/06/2021,0,0,3,3,10,1,11,22,1,4,7,12,0,0,0,0,2,0,1,3
113352,2021,Thailand,Belgium,0,4,9,13,18/06/2021,0,0,3,3,12,2,15,29,1,2,1,4,0,0,0,0,3,1,0,4
113352,2021,Brazil,Thailand,0,1,4,5,14/06/2021,0,0,2,2,8,2,8,18,0,0,0,0,0,0,0,0,0,0,0,0
113352,2021,Thailand,Poland,0,1,8,9,13/06/2021,0,1,4,5,6,1,8,15,0,2,7,9,0,0,0,0,1,1,1,3
113352,2021,Thailand,Germany,2,2,12,16,12/6/2021,0,0,1,1,12,1,10,23,1,5,4,10,0,0,3,3,10,0,2,12
113352,2021,Thailand,Dominican Republic,0,1,8,9,8/6/2021,0,0,1,1,9,3,16,28,3,2,1,6,0,0,0,0,1,2,1,4
113352,2021,Russia,Thailand,3,0,9,12,7/6/2021,0,0,5,5,15,4,13,32,1,5,4,10,1,0,3,4,5,2,1,8
113352,2021,Türkiye,Thailand,0,0,10,10,6/6/2021,0,0,4,4,6,3,11,20,2,4,1,7,0,0,1,1,2,0,0,2
113352,2021,Thailand,USA,0,0,8,8,2/6/2021,0,0,2,2,4,0,12,16,0,3,0,3,0,0,0,0,2,1,0,3
113352,2021,Serbia,Thailand,1,0,12,13,1/6/2021,0,0,1,1,6,3,18,27,1,3,4,8,1,0,1,2,4,1,0,5
113352,2021,Thailand,Netherlands,2,1,4,7,31/05/2021,0,0,0,0,5,2,6,13,1,2,2,5,0,0,0,0,0,0,0,0
113352,2021,China,Thailand,0,0,6,6,27/05/2021,0,0,1,1,6,2,8,16,2,2,2,6,0,0,0,0,1,1,0,2
113352,2021,Thailand,Korea,1,1,6,8,26/05/2021,0,0,2,2,12,4,26,42,2,7,4,13,0,0,0,0,3,0,1,4
113352,2021,Japan,Thailand,0,2,7,9,25/05/2021,0,0,0,0,9,1,8,18,1,2,2,5,0,0,1,1,2,0,0,2
114638,2021,Thailand,Italy,0,2,15,17,20/06/2021,0,0,7,7,24,4,25,53,0,4,2,6,4,1,7,12,15,3,1,19
114638,2021,Thailand,Canada,0,1,7,8,19/06/2021,0,0,0,0,10,2,6,18,0,1,1,2,0,0,5,5,5,1,0,6
114638,2021,Thailand,Belgium,1,0,12,13,18/06/2021,0,0,6,6,11,8,22,41,0,2,1,3,0,1,2,3,7,6,1,14
114638,2021,Brazil,Thailand,0,1,6,7,14/06/2021,0,1,3,4,8,6,13,27,0,0,0,0,7,0,7,14,3,2,0,5
114638,2021,Thailand,Poland,0,1,11,12,13/06/2021,0,1,1,2,10,5,14,29,0,2,2,4,1,1,1,3,7,2,2,11
114638,2021,Thailand,Germany,0,2,17,19,12/6/2021,0,0,4,4,20,5,25,50,0,0,8,8,2,1,9,12,11,2,2,15
114638,2021,Thailand,Dominican Republic,1,0,5,6,8/6/2021,1,0,0,1,6,6,25,37,0,2,1,3,3,0,0,3,5,2,0,7
114638,2021,Russia,Thailand,0,1,13,14,7/6/2021,0,0,2,2,9,12,17,38,0,4,2,6,4,0,3,7,8,2,2,12
114638,2021,Türkiye,Thailand,0,1,9,10,6/6/2021,0,0,4,4,14,4,13,31,0,2,0,2,2,0,6,8,2,7,1,10
114638,2021,Thailand,USA,0,2,7,9,2/6/2021,0,0,4,4,7,5,12,24,0,0,0,0,3,4,17,24,2,1,0,3
114638,2021,Serbia,Thailand,1,1,10,12,1/6/2021,0,0,4,4,12,4,21,37,0,1,0,1,4,0,11,15,10,3,2,15
114638,2021,Thailand,Netherlands,0,0,7,7,31/05/2021,0,0,0,0,10,4,17,31,0,0,1,1,1,0,3,4,1,3,0,4
114638,2021,China,Thailand,2,1,10,13,27/05/2021,0,0,1,1,11,4,11,26,0,2,0,2,4,3,12,19,5,0,1,6
114638,2021,Thailand,Korea,0,1,8,9,26/05/2021,0,0,2,2,8,4,21,33,0,4,3,7,1,1,6,8,11,0,0,11
114638,2021,Japan,Thailand,0,1,6,7,25/05/2021,0,0,0,0,7,6,16,29,1,0,2,3,2,0,4,6,4,2,0,6
152186,2021,Brazil,Thailand,0,0,0,0,14/06/2021,0,0,0,0,0,0,0,0,0,0,0,0,0,0,0,0,0,0,0,0
152186,2021,Thailand,USA,0,0,0,0,2/6/2021,0,0,0,0,0,0,1,1,0,0,0,0,0,0,0,0,0,0,0,0
152186,2021,Japan,Thailand,0,0,0,0,25/05/2021,0,0,0,0,0,0,0,0,0,0,0,0,0,0,0,0,0,0,0,0
122866,2021,Thailand,Italy,0,0,16,16,20/06/2021,0,0,3,3,12,5,18,35,0,3,2,5,6,2,12,20,11,4,1,16
122866,2021,Thailand,Canada,0,1,9,10,19/06/2021,0,0,2,2,8,4,10,22,0,2,2,4,4,0,7,11,12,1,1,14
122866,2021,Thailand,Belgium,0,0,14,14,18/06/2021,0,0,2,2,12,1,13,26,0,0,0,0,6,1,20,27,4,5,0,9
122866,2021,Brazil,Thailand,0,0,5,5,14/06/2021,0,0,1,1,0,2,6,8,0,0,0,0,2,2,8,12,3,1,0,4
122866,2021,Thailand,Poland,0,0,5,5,13/06/2021,0,0,2,2,3,0,10,13,0,0,2,2,4,0,12,16,3,3,0,6
122866,2021,Thailand,Germany,1,0,15,16,12/6/2021,0,0,2,2,13,1,7,21,0,0,1,1,5,3,15,23,10,2,2,14
122866,2021,Thailand,Dominican Republic,0,0,11,11,8/6/2021,0,0,0,0,4,1,7,12,0,2,0,2,1,1,3,5,3,1,0,4
122866,2021,Russia,Thailand,0,0,4,4,7/6/2021,0,0,3,3,1,2,2,5,0,0,1,1,1,1,7,9,2,2,1,5
122866,2021,Türkiye,Thailand,0,1,9,10,6/6/2021,0,0,2,2,7,5,11,23,0,3,0,3,4,3,12,19,0,0,0,0
122866,2021,Thailand,USA,0,0,5,5,2/6/2021,0,0,1,1,4,1,8,13,0,0,0,0,0,0,8,8,2,1,0,3
122866,2021,Serbia,Thailand,1,0,6,7,1/6/2021,0,0,0,0,5,6,6,17,0,3,0,3,2,0,6,8,5,1,0,6
122866,2021,Thailand,Netherlands,0,0,5,5,31/05/2021,0,0,0,0,2,3,5,10,0,1,0,1,2,2,8,12,1,2,0,3
122866,2021,China,Thailand,0,0,3,3,27/05/2021,0,0,0,0,2,0,7,9,0,1,0,1,1,1,0,2,1,0,0,1
122866,2021,Thailand,Korea,0,0,10,10,26/05/2021,0,0,0,0,8,4,19,31,0,1,1,2,7,2,12,21,13,3,4,20
122866,2021,Japan,Thailand,0,1,4,5,25/05/2021,0,0,0,0,5,4,7,16,0,0,1,1,8,0,13,21,5,1,0,6
113916,2021,Thailand,Italy,0,0,0,0,20/06/2021,0,0,9,9,0,0,0,0,0,0,0,0,4,1,7,12,11,1,1,13
113916,2021,Thailand,Canada,0,0,3,3,19/06/2021,0,0,2,2,0,0,0,0,0,0,0,0,0,0,4,4,4,0,0,4
113916,2021,Thailand,Belgium,0,0,3,3,18/06/2021,0,0,0,0,1,1,2,4,0,0,0,0,2,0,3,5,2,2,1,5
113916,2021,Brazil,Thailand,0,0,3,3,14/06/2021,0,0,1,1,1,3,12,16,0,2,0,2,2,1,11,14,1,1,0,2
113916,2021,Thailand,Poland,0,0,5,5,13/06/2021,0,0,3,3,2,1,10,13,0,3,1,4,3,0,8,11,7,0,3,10
113916,2021,Thailand,Germany,0,0,0,0,12/6/2021,0,0,0,0,0,0,0,0,0,0,0,0,0,0,2,2,0,0,0,0
113916,2021,Thailand,Dominican Republic,0,0,0,0,8/6/2021,0,0,1,1,0,0,0,0,0,0,0,0,0,0,0,0,4,8,0,12
113916,2021,Russia,Thailand,0,0,0,0,7/6/2021,0,0,5,5,0,0,0,0,0,0,0,0,2,0,1,3,10,1,1,12
113916,2021,Türkiye,Thailand,0,0,0,0,6/6/2021,0,0,1,1,0,0,0,0,0,0,0,0,0,0,0,0,4,2,1,7
113916,2021,Thailand,USA,0,0,0,0,2/6/2021,0,0,0,0,0,0,0,0,0,0,0,0,0,0,0,0,1,0,0,1
113916,2021,Serbia,Thailand,0,0,0,0,1/6/2021,0,0,2,2,0,0,0,0,0,0,0,0,0,0,0,0,8,1,1,10
113916,2021,Thailand,Netherlands,0,0,0,0,31/05/2021,0,0,0,0,0,0,0,0,0,0,0,0,0,0,0,0,6,5,1,12
113916,2021,China,Thailand,0,0,5,5,27/05/2021,0,0,2,2,2,1,5,8,1,2,0,3,1,0,6,7,4,2,0,6
113916,2021,Thailand,Korea,0,0,2,2,26/05/2021,0,0,0,0,1,0,0,1,0,0,1,1,3,0,4,7,1,0,1,2
113916,2021,Japan,Thailand,0,0,2,2,25/05/2021,0,0,0,0,1,0,2,3,0,0,0,0,0,1,6,7,0,1,0,1
113358,2021,Thailand,Italy,0,0,1,1,20/06/2021,0,0,1,1,0,1,1,2,0,0,1,1,0,0,0,0,1,0,0,1
113358,2021,Thailand,Canada,0,0,0,0,19/06/2021,0,0,0,0,0,0,0,0,0,0,0,0,0,0,0,0,0,0,0,0
113358,2021,Thailand,Belgium,0,0,0,0,18/06/2021,0,0,0,0,0,0,0,0,0,0,0,0,0,0,0,0,0,0,0,0
113358,2021,Thailand,Poland,0,0,0,0,13/06/2021,0,0,0,0,0,0,0,0,0,0,0,0,0,0,0,0,0,0,0,0
113358,2021,Thailand,Germany,0,0,6,6,12/6/2021,0,0,1,1,0,2,2,4,0,0,3,3,0,0,2,2,1,1,0,2
113358,2021,Thailand,Dominican Republic,0,1,3,4,8/6/2021,0,0,0,0,3,0,5,8,0,2,1,3,0,0,0,0,3,1,0,4
113358,2021,Russia,Thailand,1,0,9,10,7/6/2021,0,0,2,2,2,2,5,9,1,1,0,2,1,1,1,3,2,0,0,2
113358,2021,Türkiye,Thailand,0,0,6,6,6/6/2021,0,0,0,0,1,2,1,4,0,1,1,2,0,0,0,0,2,0,0,2
113358,2021,Serbia,Thailand,0,0,0,0,1/6/2021,0,0,0,0,0,0,0,0,0,0,0,0,0,0,0,0,0,0,0,0
113358,2021,Thailand,Netherlands,0,0,0,0,31/05/2021,0,0,0,0,0,0,0,0,0,0,0,0,0,0,0,0,0,0,0,0
113358,2021,China,Thailand,0,0,2,2,27/05/2021,0,0,0,0,2,0,0,2,0,1,1,2,0,0,0,0,0,0,1,1
113358,2021,Thailand,Korea,4,0,8,12,26/05/2021,0,0,2,2,3,1,5,9,0,1,0,1,0,0,0,0,1,3,0,4
113358,2021,Japan,Thailand,0,0,0,0,25/05/2021,0,0,0,0,0,0,0,0,0,0,0,0,0,0,0,0,0,0,0,0
118998,2021,Thailand,Canada,0,0,0,0,19/06/2021,0,0,2,2,0,0,0,0,0,0,0,0,0,0,0,0,3,1,0,4
118998,2021,Thailand,Belgium,0,0,0,0,18/06/2021,0,0,4,4,0,0,0,0,0,0,0,0,0,0,0,0,8,8,1,17
118998,2021,Brazil,Thailand,0,0,0,0,14/06/2021,0,0,0,0,0,0,0,0,0,0,0,0,0,0,0,0,0,0,0,0
118998,2021,Thailand,Poland,0,0,0,0,13/06/2021,0,0,0,0,0,0,0,0,0,0,0,0,0,0,0,0,4,1,2,7
118998,2021,Thailand,Germany,0,0,0,0,12/6/2021,0,0,4,4,0,0,0,0,0,0,0,0,0,0,0,0,8,0,1,9
118998,2021,Thailand,Dominican Republic,0,0,0,0,8/6/2021,0,0,0,0,0,0,0,0,0,0,0,0,0,0,0,0,2,0,0,2
118998,2021,Russia,Thailand,0,0,1,1,7/6/2021,0,0,1,1,1,0,1,2,0,0,1,1,0,0,4,4,2,0,0,2
118998,2021,Türkiye,Thailand,0,0,1,1,6/6/2021,0,0,1,1,0,0,3,3,0,0,0,0,1,2,6,9,3,0,1,4
118998,2021,Thailand,USA,0,0,2,2,2/6/2021,0,0,1,1,1,2,3,6,0,0,0,0,0,0,4,4,2,2,0,4
118998,2021,Serbia,Thailand,1,0,2,3,1/6/2021,0,0,2,2,0,2,2,4,0,1,0,1,1,0,2,3,5,0,0,5
118998,2021,Thailand,Netherlands,0,0,4,4,31/05/2021,0,0,0,0,2,1,5,8,0,0,0,0,6,0,4,10,0,0,0,0
118998,2021,China,Thailand,0,0,0,0,27/05/2021,0,0,1,1,0,0,0,0,0,0,0,0,0,0,0,0,4,1,4,9
118998,2021,Thailand,Korea,0,0,0,0,26/05/2021,0,0,1,1,0,0,0,0,0,0,0,0,2,0,2,4,4,4,1,9
118998,2021,Japan,Thailand,0,0,0,0,25/05/2021,0,0,1,1,0,0,0,0,0,0,0,0,1,0,7,8,6,2,2,10
113917,2021,Thailand,Italy,1,1,16,18,20/06/2021,22,2,129,153,2,0,3,5,0,1,2,3,0,0,0,0,21,3,3,27
113917,2021,Thailand,Canada,1,1,7,9,19/06/2021,8,0,68,76,0,0,1,1,0,2,3,5,0,0,0,0,4,0,1,5
113917,2021,Thailand,Belgium,1,0,14,15,18/06/2021,16,0,84,100,0,0,5,5,0,0,1,1,0,0,0,0,8,4,0,12
113917,2021,Brazil,Thailand,0,1,2,3,14/06/2021,8,2,71,81,0,0,3,3,0,0,1,1,0,0,0,0,4,2,0,6
113917,2021,Thailand,Poland,1,1,7,9,13/06/2021,24,0,49,73,1,0,2,3,0,2,2,4,0,1,0,1,7,1,3,11
113917,2021,Thailand,Germany,0,1,19,20,12/6/2021,12,2,105,119,2,0,0,2,1,2,3,6,0,0,0,0,14,4,0,18
113917,2021,Thailand,Dominican Republic,0,0,1,1,8/6/2021,12,0,36,48,0,0,3,3,0,1,2,3,0,0,0,0,2,2,0,4
113917,2021,Russia,Thailand,1,0,9,10,7/6/2021,20,0,60,80,1,0,2,3,0,4,3,7,0,0,0,0,12,0,2,14
113917,2021,Türkiye,Thailand,0,0,4,4,6/6/2021,3,0,31,34,0,0,1,1,1,1,0,2,0,0,0,0,7,2,0,9
113917,2021,Thailand,USA,0,0,4,4,2/6/2021,0,0,49,49,0,0,0,0,0,0,0,0,0,0,0,0,0,2,0,2
113917,2021,Serbia,Thailand,0,0,9,9,1/6/2021,10,0,97,107,0,2,1,3,0,1,2,3,0,0,1,1,9,2,0,11
113917,2021,Thailand,Netherlands,0,0,7,7,31/05/2021,6,0,0,6,0,1,2,3,1,0,1,2,0,0,0,0,1,7,0,8
113917,2021,China,Thailand,0,1,8,9,27/05/2021,15,1,63,79,2,2,1,5,0,0,1,1,0,0,1,1,6,2,0,8
113917,2021,Thailand,Korea,0,0,11,11,26/05/2021,21,1,93,115,2,0,1,3,0,2,0,2,0,0,1,1,9,2,2,13
113917,2021,Japan,Thailand,1,1,6,8,25/05/2021,9,4,72,85,0,1,2,3,0,0,0,0,0,0,0,0,7,0,3,10
152206,2021,Thailand,Italy,0,0,0,0,20/06/2021,0,0,0,0,0,0,0,0,0,0,0,0,0,0,0,0,0,0,0,0
152206,2021,Thailand,Canada,0,0,0,0,19/06/2021,0,0,0,0,0,0,0,0,0,0,0,0,0,0,0,0,0,0,0,0
152206,2021,Thailand,Belgium,0,0,0,0,18/06/2021,0,0,0,0,0,0,0,0,0,0,0,0,0,0,0,0,0,0,0,0
152206,2021,Brazil,Thailand,0,0,0,0,14/06/2021,0,0,1,1,0,2,1,3,0,0,0,0,0,0,0,0,0,0,0,0
152206,2021,Thailand,Poland,0,1,0,1,13/06/2021,0,0,0,0,0,1,1,2,0,0,0,0,0,0,0,0,0,0,0,0
152206,2021,Thailand,Germany,0,0,0,0,12/6/2021,0,0,0,0,0,0,0,0,0,0,0,0,0,0,0,0,0,0,0,0
152206,2021,Thailand,Dominican Republic,0,0,3,3,8/6/2021,0,0,0,0,1,2,1,4,0,0,0,0,0,0,2,2,1,1,0,2
152206,2021,Russia,Thailand,0,1,1,2,7/6/2021,0,0,0,0,1,1,0,2,0,0,0,0,0,0,1,1,0,0,0,0
152206,2021,Türkiye,Thailand,0,0,2,2,6/6/2021,0,0,0,0,1,4,4,9,0,0,0,0,1,0,2,3,1,0,2,3
152206,2021,Thailand,USA,0,0,1,1,2/6/2021,0,0,0,0,1,1,0,2,0,0,0,0,0,0,0,0,0,0,0,0
152206,2021,Serbia,Thailand,0,0,3,3,1/6/2021,0,0,0,0,3,1,4,8,0,0,0,0,2,0,2,4,1,1,0,2
152206,2021,Thailand,Netherlands,0,0,0,0,31/05/2021,0,0,0,0,1,2,1,4,0,0,0,0,0,0,0,0,0,0,0,0
152206,2021,China,Thailand,0,0,0,0,27/05/2021,0,0,0,0,0,3,0,3,0,0,0,0,0,0,0,0,0,0,0,0
152206,2021,Japan,Thailand,0,0,0,0,25/05/2021,0,0,0,0,0,1,0,1,0,1,0,1,0,0,0,0,0,0,0,0
114283,2021,Thailand,Italy,1,2,16,19,20/06/2021,0,0,2,2,8,7,24,39,0,6,6,12,6,2,19,27,12,1,1,14
114283,2021,Thailand,Canada,2,0,19,21,19/06/2021,0,0,1,1,13,1,6,20,1,4,6,11,5,0,1,6,11,1,2,14
114283,2021,Thailand,Belgium,0,0,16,16,18/06/2021,0,0,2,2,16,2,13,31,0,2,1,3,7,3,10,20,11,6,2,19
114283,2021,Brazil,Thailand,0,1,3,4,14/06/2021,0,1,0,1,6,2,12,20,0,0,1,1,5,2,8,15,1,2,0,3
114283,2021,Thailand,Poland,1,1,8,10,13/06/2021,0,0,5,5,6,3,11,20,0,2,4,6,5,1,7,13,5,2,1,8
114283,2021,Thailand,Germany,0,2,11,13,12/6/2021,0,0,5,5,9,5,18,32,1,4,4,9,6,0,12,18,7,3,2,12
114283,2021,Thailand,Dominican Republic,0,1,6,7,8/6/2021,0,1,1,2,3,5,11,19,0,2,0,2,7,1,7,15,6,2,0,8
114283,2021,Russia,Thailand,0,1,10,11,7/6/2021,0,0,3,3,6,3,10,19,2,5,4,11,3,0,9,12,3,3,1,7
114283,2021,Türkiye,Thailand,0,1,8,9,6/6/2021,1,0,1,2,4,0,14,18,0,4,2,6,3,3,9,15,7,5,1,13
114283,2021,Thailand,USA,0,0,5,5,2/6/2021,0,0,1,1,3,3,7,13,1,0,0,1,4,2,9,15,4,1,0,5
114283,2021,Serbia,Thailand,0,0,6,6,1/6/2021,0,0,1,1,1,5,9,15,0,0,0,0,1,4,5,10,5,2,3,10
114283,2021,Thailand,Netherlands,0,1,8,9,31/05/2021,0,0,0,0,5,1,7,13,0,0,1,1,7,1,9,17,9,3,1,13
114283,2021,China,Thailand,0,1,7,8,27/05/2021,0,0,0,0,8,4,4,16,0,5,2,7,6,1,11,18,3,1,1,5
114283,2021,Thailand,Korea,0,2,10,12,26/05/2021,0,0,2,2,5,2,13,20,0,2,2,4,6,0,11,17,8,3,0,11
114283,2021,Japan,Thailand,1,0,8,9,25/05/2021,0,0,0,0,7,2,8,17,0,1,3,4,7,1,7,15,3,0,2,5
167829,2021,Brazil,Thailand,0,0,0,0,14/06/2021,0,0,9,9,0,0,0,0,0,0,0,0,0,0,0,0,2,0,0,2
167829,2021,Russia,Thailand,0,0,2,2,7/6/2021,4,0,24,28,0,0,2,2,0,1,0,1,0,0,0,0,0,0,0,0
167829,2021,Thailand,Korea,0,0,0,0,26/05/2021,0,0,0,0,0,0,0,0,0,0,0,0,0,0,0,0,0,0,0,0
119003,2021,Thailand,Italy,1,1,10,12,20/06/2021,,,,,2,2,4,8,0,0,1,1,0,1,0,1,4,0,1,5
119003,2021,Thailand,Canada,0,1,10,11,19/06/2021,,,,,5,0,5,10,0,1,2,3,0,0,1,1,2,0,0,2
119003,2021,Thailand,Belgium,0,0,8,8,18/06/2021,,,,,10,1,5,16,1,0,1,2,0,0,0,0,1,3,0,4
119003,2021,Brazil,Thailand,0,0,6,6,14/06/2021,,,,,2,0,5,7,1,1,0,2,0,0,0,0,0,1,0,1
119003,2021,Thailand,Poland,0,1,7,8,13/06/2021,,,,,9,0,2,11,0,4,5,9,0,0,0,0,5,0,0,5
119003,2021,Thailand,Germany,0,1,7,8,12/6/2021,,,,,4,2,4,10,0,1,2,3,0,0,0,0,3,0,0,3
119003,2021,Thailand,Dominican Republic,0,0,5,5,8/6/2021,,,,,6,1,2,9,0,1,1,2,0,0,0,0,2,0,0,2
119003,2021,Russia,Thailand,0,1,4,5,7/6/2021,,,,,7,0,2,9,0,1,0,1,0,0,0,0,1,0,0,1
119003,2021,Türkiye,Thailand,0,0,5,5,6/6/2021,,,,,1,0,1,2,1,0,1,2,0,1,1,2,4,0,0,4
119003,2021,Thailand,USA,0,2,6,8,2/6/2021,,,,,4,2,4,10,0,1,0,1,0,0,0,0,0,1,0,1
119003,2021,Serbia,Thailand,0,0,6,6,1/6/2021,,,,,3,1,3,7,0,0,2,2,1,0,1,2,1,0,0,1
119003,2021,Thailand,Netherlands,0,1,2,3,31/05/2021,,,,,1,4,1,6,0,0,0,0,0,0,0,0,0,0,0,0
119003,2021,China,Thailand,0,0,8,8,27/05/2021,,,,,4,3,2,9,0,2,2,4,0,0,0,0,0,2,0,2
119003,2021,Thailand,Korea,0,0,6,6,26/05/2021,,,,,4,0,4,8,1,2,2,5,0,0,0,0,0,0,0,0
119003,2021,Japan,Thailand,0,1,8,9,25/05/2021,,,,,5,1,4,10,0,3,1,4,0,0,0,0,1,0,1,2
147188,2021,Thailand,Italy,0,0,0,0,20/06/2021,0,0,0,0,0,0,0,0,0,0,0,0,0,0,0,0,0,0,0,0
147188,2021,Thailand,Belgium,0,0,3,3,18/06/2021,1,0,24,25,0,0,0,0,0,0,0,0,0,0,0,0,1,1,0,2
147188,2021,Thailand,Dominican Republic,0,0,8,8,8/6/2021,10,1,48,59,1,0,4,5,0,1,0,1,0,0,1,1,4,1,0,5
152207,2021,Thailand,Italy,0,0,2,2,20/06/2021,0,0,0,0,0,0,0,0,0,0,0,0,0,0,0,0,0,0,0,0
152207,2021,Thailand,Canada,0,0,0,0,19/06/2021,0,0,0,0,0,0,0,0,0,0,0,0,0,0,0,0,0,0,0,0
152207,2021,Thailand,Belgium,1,0,2,3,18/06/2021,0,0,0,0,0,2,0,2,0,0,0,0,0,0,0,0,0,0,0,0
152207,2021,Brazil,Thailand,0,0,1,1,14/06/2021,0,0,0,0,0,1,0,1,0,0,0,0,0,0,0,0,0,0,0,0
152207,2021,Thailand,Poland,0,0,1,1,13/06/2021,0,0,0,0,2,0,1,3,0,1,0,1,0,0,3,3,0,1,0,1
152207,2021,Thailand,Germany,0,0,0,0,12/6/2021,0,0,0,0,0,0,0,0,0,0,0,0,0,0,0,0,0,0,0,0
152207,2021,Thailand,Dominican Republic,0,0,3,3,8/6/2021,0,0,2,2,0,1,5,6,0,0,0,0,0,0,3,3,0,0,0,0
152207,2021,Russia,Thailand,1,0,2,3,7/6/2021,0,0,0,0,1,1,9,11,0,0,0,0,1,1,0,2,2,1,0,3
152207,2021,Türkiye,Thailand,0,0,2,2,6/6/2021,0,0,1,1,0,0,5,5,0,1,0,1,1,0,5,6,0,0,0,0
152207,2021,Thailand,USA,0,0,1,1,2/6/2021,0,0,1,1,1,1,3,5,0,0,0,0,0,0,2,2,0,0,0,0
152207,2021,Serbia,Thailand,0,1,3,4,1/6/2021,0,0,0,0,0,2,5,7,0,1,0,1,3,0,5,8,1,0,0,1
152207,2021,Thailand,Netherlands,0,0,1,1,31/05/2021,0,0,0,0,0,0,1,1,0,0,0,0,1,0,4,5,2,1,0,3
152207,2021,China,Thailand,0,0,0,0,27/05/2021,0,0,0,0,1,0,2,3,0,0,0,0,0,0,0,0,0,0,0,0
152207,2021,Thailand,Korea,0,1,2,3,26/05/2021,0,0,0,0,0,0,1,1,0,0,0,0,1,1,2,4,1,1,0,2
142178,2021,Thailand,Italy,0,2,2,4,20/06/2021,0,0,0,0,3,2,4,9,0,1,5,6,0,0,1,1,2,0,0,2
142178,2021,Thailand,Canada,0,0,0,0,19/06/2021,0,0,0,0,0,0,0,0,0,0,0,0,0,0,0,0,0,0,0,0
142178,2021,Thailand,Belgium,0,0,0,0,18/06/2021,0,0,1,1,0,0,0,0,0,0,0,0,0,0,0,0,0,0,0,0
142178,2021,Brazil,Thailand,0,0,2,2,14/06/2021,0,0,0,0,1,0,1,2,0,0,0,0,0,0,0,0,0,0,0,0
142178,2021,Thailand,Poland,0,0,0,0,13/06/2021,0,0,0,0,0,0,0,0,0,0,0,0,0,0,0,0,0,0,0,0
142178,2021,Thailand,Germany,0,0,0,0,12/6/2021,0,0,0,0,0,0,0,0,0,0,0,0,0,0,0,0,0,0,0,0
142178,2021,Thailand,Dominican Republic,0,0,0,0,8/6/2021,0,0,0,0,0,0,0,0,0,0,0,0,0,0,0,0,0,0,0,0
142178,2021,Russia,Thailand,0,0,0,0,7/6/2021,0,0,0,0,0,0,0,0,0,0,0,0,0,0,0,0,0,0,0,0
142178,2021,Türkiye,Thailand,0,0,1,1,6/6/2021,0,0,0,0,0,0,2,2,0,0,0,0,0,0,0,0,0,0,0,0
142178,2021,Thailand,USA,0,0,4,4,2/6/2021,0,0,1,1,1,1,2,4,0,0,0,0,0,0,0,0,0,1,0,1
142178,2021,Serbia,Thailand,1,0,2,3,1/6/2021,0,0,0,0,0,2,3,5,0,2,0,2,0,0,1,1,1,0,0,1
142178,2021,Thailand,Netherlands,0,0,5,5,31/05/2021,0,0,0,0,2,1,9,12,1,1,0,2,0,1,0,1,0,0,0,0
142178,2021,China,Thailand,0,0,1,1,27/05/2021,0,0,0,0,0,0,0,0,0,0,0,0,0,0,0,0,1,0,0,1
142178,2021,Thailand,Korea,0,0,0,0,26/05/2021,0,0,0,0,0,0,0,0,0,0,0,0,0,0,0,0,0,0,0,0
142178,2021,Japan,Thailand,0,0,0,0,25/05/2021,0,0,0,0,0,0,0,0,0,0,0,0,0,0,0,0,0,0,0,0
158840,2021,Japan,Türkiye,0,0,0,0,25/06/2021,0,0,5,5,0,0,0,0,0,0,0,0,1,0,1,2,5,1,1,7
158840,2021,USA,Türkiye,0,0,0,0,24/06/2021,0,0,9,9,0,0,0,0,0,0,0,0,9,3,4,16,12,4,0,16
158840,2021,Brazil,Türkiye,0,0,0,0,20/06/2021,0,0,5,5,0,0,0,0,0,0,0,0,1,2,5,8,5,1,1,7
158840,2021,Korea,Türkiye,0,0,0,0,19/06/2021,1,0,4,5,0,0,0,0,0,0,0,0,8,2,12,22,10,2,0,12
158840,2021,Türkiye,Netherlands,0,0,0,0,18/06/2021,0,0,8,8,0,0,0,0,0,0,0,0,6,1,3,10,19,3,1,23
158840,2021,USA,Türkiye,0,0,0,0,14/06/2021,0,0,8,8,0,0,0,0,0,0,0,0,9,1,11,21,14,4,1,19
158840,2021,Türkiye,Belgium,0,0,0,0,13/06/2021,0,0,5,5,0,0,0,0,0,0,0,0,7,0,1,8,10,1,0,11
158840,2021,Japan,Türkiye,0,0,0,0,12/6/2021,0,0,9,9,0,0,0,0,0,0,0,0,4,2,10,16,19,2,3,24
158840,2021,Türkiye,Russia,0,0,0,0,8/6/2021,0,0,8,8,0,0,0,0,0,0,0,0,11,3,5,19,18,7,1,26
158840,2021,Türkiye,Dominican Republic,0,0,0,0,7/6/2021,0,0,8,8,0,0,0,0,0,0,0,0,4,1,1,6,3,2,0,5
158840,2021,Türkiye,Thailand,0,0,0,0,6/6/2021,0,0,8,8,0,0,0,0,0,0,0,0,4,0,11,15,23,3,0,26
158840,2021,China,Türkiye,0,0,0,0,2/6/2021,0,0,0,0,0,0,0,0,0,0,0,0,0,0,0,0,0,0,0,0
158840,2021,Türkiye,Germany,0,0,0,0,1/6/2021,0,0,9,9,0,0,0,0,0,0,0,0,5,2,4,11,15,1,2,18
158840,2021,Canada,Türkiye,0,0,0,0,31/05/2021,0,0,15,15,0,0,0,0,0,0,0,0,6,1,7,14,24,7,4,35
158840,2021,Poland,Türkiye,0,0,0,0,27/05/2021,0,0,4,4,0,0,0,0,0,0,0,0,1,1,5,7,6,1,1,8
158840,2021,Türkiye,Italy,0,0,0,0,26/05/2021,0,0,1,1,0,0,0,0,0,0,0,0,5,0,3,8,7,4,0,11
158840,2021,Türkiye,Serbia,0,0,0,0,25/05/2021,0,0,3,3,0,0,0,0,0,0,0,0,11,2,8,21,25,5,3,33
143590,2021,Japan,Türkiye,0,0,16,16,25/06/2021,18,0,54,72,1,0,1,2,0,3,1,4,0,0,0,0,7,3,0,10
143590,2021,USA,Türkiye,1,2,7,10,24/06/2021,10,0,83,93,3,0,1,4,0,2,2,4,0,0,1,1,15,0,1,16
143590,2021,Brazil,Türkiye,0,0,5,5,20/06/2021,9,0,33,42,1,0,0,1,1,1,2,4,0,0,0,0,8,2,2,12
143590,2021,Korea,Türkiye,1,2,18,21,19/06/2021,22,1,78,101,4,0,5,9,2,4,1,7,0,0,0,0,7,1,0,8
143590,2021,Türkiye,Netherlands,0,3,11,14,18/06/2021,8,1,83,92,1,0,4,5,0,1,4,5,0,0,0,0,7,2,0,9
143590,2021,USA,Türkiye,0,2,7,9,14/06/2021,9,1,78,88,0,0,1,1,0,4,1,5,0,0,0,0,11,2,2,15
143590,2021,Türkiye,Belgium,0,1,3,4,13/06/2021,12,1,73,86,2,0,3,5,1,1,1,3,0,0,0,0,8,2,0,10
143590,2021,Japan,Türkiye,0,4,8,12,12/6/2021,36,2,75,113,1,0,1,2,1,2,5,8,0,0,1,1,7,0,1,8
143590,2021,Türkiye,Russia,2,3,10,15,8/6/2021,32,0,71,103,2,0,3,5,3,3,3,9,0,0,0,0,9,3,0,12
143590,2021,Türkiye,Dominican Republic,0,0,3,3,7/6/2021,5,0,32,37,0,0,1,1,1,0,0,1,0,0,0,0,3,3,0,6
143590,2021,Türkiye,Thailand,2,2,14,18,6/6/2021,42,0,59,101,3,0,0,3,0,2,1,3,0,0,0,0,5,1,0,6
143590,2021,China,Türkiye,0,0,0,0,2/6/2021,2,0,3,5,0,0,0,0,0,0,0,0,0,0,0,0,0,0,0,0
143590,2021,Türkiye,Germany,1,1,5,7,1/6/2021,14,0,32,46,0,0,0,0,0,4,1,5,0,0,0,0,3,3,0,6
143590,2021,Canada,Türkiye,2,1,13,16,31/05/2021,20,2,65,87,1,0,1,2,0,2,1,3,0,0,0,0,14,1,1,16
143590,2021,Poland,Türkiye,0,0,2,2,27/05/2021,8,0,15,23,1,0,0,1,0,0,0,0,0,0,0,0,0,0,0,0
143590,2021,Türkiye,Italy,1,4,9,14,26/05/2021,16,0,52,68,0,0,0,0,0,1,0,1,0,0,0,0,2,2,0,4
143590,2021,Türkiye,Serbia,0,1,6,7,25/05/2021,8,1,46,55,0,0,2,2,1,0,1,2,0,0,0,0,5,0,2,7
152311,2021,Japan,Türkiye,0,2,6,8,25/06/2021,0,0,0,0,4,2,4,10,3,2,1,6,7,0,5,12,4,1,0,5
152311,2021,USA,Türkiye,0,1,10,11,24/06/2021,0,0,0,0,3,3,5,11,0,3,2,5,3,1,8,12,4,0,0,4
152311,2021,Brazil,Türkiye,0,0,12,12,20/06/2021,0,0,1,1,11,5,11,27,0,2,2,4,3,1,11,15,9,3,1,13
152311,2021,Korea,Türkiye,0,0,0,0,19/06/2021,0,0,0,0,0,0,0,0,0,0,0,0,0,0,0,0,0,0,0,0
152311,2021,Türkiye,Netherlands,0,0,0,0,18/06/2021,0,0,0,0,0,0,0,0,0,0,0,0,0,0,0,0,0,0,0,0
152311,2021,USA,Türkiye,0,0,2,2,14/06/2021,0,0,1,1,1,3,3,7,0,1,0,1,3,1,5,9,0,0,0,0
152311,2021,Türkiye,Belgium,0,0,0,0,13/06/2021,0,0,0,0,0,0,0,0,0,0,0,0,0,0,0,0,0,0,0,0
152311,2021,Japan,Türkiye,1,0,4,5,12/6/2021,0,0,0,0,2,4,2,8,0,2,2,4,4,0,7,11,5,0,0,5
152311,2021,Türkiye,Russia,2,0,19,21,8/6/2021,0,0,1,1,12,4,11,27,2,3,5,10,13,2,19,34,8,1,1,10
152311,2021,Türkiye,Dominican Republic,2,2,4,8,7/6/2021,0,0,2,2,10,3,10,23,1,1,0,2,8,0,9,17,4,1,0,5
152311,2021,Türkiye,Thailand,0,1,14,15,6/6/2021,0,0,1,1,10,4,7,21,3,0,2,5,10,0,16,26,17,1,1,19
152311,2021,China,Türkiye,0,1,1,2,2/6/2021,0,0,0,0,1,0,0,1,0,0,0,0,0,0,3,3,2,1,1,4
152311,2021,Türkiye,Germany,0,0,0,0,1/6/2021,0,0,0,0,0,0,0,0,0,0,0,0,0,0,0,0,0,0,0,0
152311,2021,Canada,Türkiye,0,0,13,13,31/05/2021,0,0,0,0,10,3,17,30,2,4,5,11,6,0,28,34,12,4,0,16
152311,2021,Poland,Türkiye,0,0,0,0,27/05/2021,0,0,0,0,2,1,0,3,0,0,0,0,0,0,3,3,1,0,0,1
152311,2021,Türkiye,Italy,0,0,0,0,26/05/2021,0,0,0,0,0,0,0,0,0,0,0,0,0,0,0,0,0,0,0,0
152311,2021,Türkiye,Serbia,1,1,3,5,25/05/2021,0,0,0,0,3,3,4,10,0,1,1,2,1,1,5,7,5,0,0,5
137074,2021,Japan,Türkiye,0,0,0,0,25/06/2021,0,0,0,0,0,0,0,0,0,0,0,0,0,0,0,0,0,0,0,0
137074,2021,USA,Türkiye,0,0,0,0,24/06/2021,0,0,0,0,0,0,0,0,0,0,0,0,0,0,0,0,0,0,0,0
137074,2021,Brazil,Türkiye,0,0,0,0,20/06/2021,0,0,3,3,0,0,0,0,0,0,0,0,6,1,11,18,9,1,2,12
137074,2021,Korea,Türkiye,0,0,2,2,19/06/2021,0,0,0,0,0,0,0,0,0,0,0,0,0,0,0,0,0,0,0,0
137074,2021,Türkiye,Netherlands,0,0,2,2,18/06/2021,0,0,0,0,1,0,2,3,0,0,0,0,2,0,0,2,0,0,0,0
137074,2021,USA,Türkiye,0,0,1,1,14/06/2021,0,0,0,0,1,0,1,2,0,1,0,1,1,0,3,4,0,0,1,1
137074,2021,Türkiye,Belgium,0,0,0,0,13/06/2021,0,0,0,0,0,0,0,0,0,0,0,0,0,0,0,0,0,0,0,0
137074,2021,Japan,Türkiye,1,2,4,7,12/6/2021,0,0,1,1,0,0,3,3,0,0,1,1,6,1,3,10,3,1,1,5
137074,2021,Türkiye,Dominican Republic,0,0,0,0,7/6/2021,0,0,0,0,0,0,0,0,0,0,0,0,0,0,0,0,0,0,0,0
137074,2021,Türkiye,Thailand,1,1,8,10,6/6/2021,0,0,0,0,4,1,2,7,0,0,0,0,5,0,2,7,5,0,0,5
137074,2021,China,Türkiye,0,0,0,0,2/6/2021,0,0,0,0,0,0,0,0,0,0,0,0,0,0,0,0,0,0,0,0
137074,2021,Türkiye,Germany,0,0,3,3,1/6/2021,0,0,0,0,0,1,1,2,0,0,0,0,0,0,2,2,2,1,0,3
137074,2021,Canada,Türkiye,0,0,12,12,31/05/2021,0,0,0,0,0,1,1,2,0,1,0,1,2,0,3,5,1,0,0,1
137074,2021,Poland,Türkiye,0,0,0,0,27/05/2021,0,0,0,0,0,0,0,0,0,0,0,0,0,0,0,0,1,0,0,1
137074,2021,Türkiye,Italy,0,0,3,3,26/05/2021,0,0,0,0,0,0,0,0,0,0,0,0,0,0,0,0,0,0,0,0
137074,2021,Türkiye,Serbia,0,0,3,3,25/05/2021,0,0,0,0,1,1,7,9,0,0,0,0,1,1,8,10,8,0,1,9
137086,2021,Japan,Türkiye,0,2,16,18,25/06/2021,0,0,3,3,2,1,1,4,0,3,6,9,0,0,0,0,3,1,0,4
137086,2021,USA,Türkiye,0,3,10,13,24/06/2021,0,0,2,2,4,1,4,9,1,4,2,7,1,0,1,2,1,0,0,1
137086,2021,Brazil,Türkiye,0,0,0,0,20/06/2021,0,0,0,0,0,0,0,0,0,0,0,0,0,0,0,0,0,0,0,0
137086,2021,Korea,Türkiye,0,1,4,5,19/06/2021,0,0,1,1,2,1,2,5,2,2,2,6,0,0,0,0,0,0,0,0
137086,2021,Türkiye,Netherlands,0,0,0,0,18/06/2021,0,0,0,0,0,0,0,0,0,0,0,0,0,0,0,0,0,0,0,0
137086,2021,USA,Türkiye,1,1,7,9,14/06/2021,0,0,0,0,1,1,1,3,1,3,2,6,0,0,0,0,1,0,0,1
137086,2021,Japan,Türkiye,0,0,0,0,12/6/2021,0,0,0,0,0,0,0,0,0,0,0,0,0,0,0,0,0,0,0,0
137086,2021,Türkiye,Russia,1,1,1,3,8/6/2021,0,0,0,0,0,0,0,0,0,0,0,0,0,0,0,0,0,0,0,0
137086,2021,Türkiye,Dominican Republic,0,1,8,9,7/6/2021,0,0,0,0,1,3,1,5,1,2,2,5,0,0,0,0,0,2,0,2
137086,2021,Türkiye,Thailand,1,1,3,5,6/6/2021,0,0,0,0,0,2,0,2,1,5,2,8,0,0,0,0,0,0,0,0
137086,2021,China,Türkiye,1,1,8,10,2/6/2021,0,0,2,2,3,0,4,7,3,8,9,20,0,0,0,0,1,0,1,2
137086,2021,Türkiye,Germany,0,1,3,4,1/6/2021,0,0,0,0,1,1,0,2,1,0,6,7,0,0,0,0,2,0,1,3
137086,2021,Canada,Türkiye,0,1,7,8,31/05/2021,0,0,4,4,6,4,3,13,2,4,4,10,0,0,0,0,0,0,0,0
137086,2021,Poland,Türkiye,0,1,14,15,27/05/2021,0,0,2,2,8,0,6,14,2,6,1,9,0,1,0,1,1,0,0,1
137086,2021,Türkiye,Italy,0,0,0,0,26/05/2021,0,0,0,0,0,0,0,0,0,0,0,0,0,0,0,0,0,0,0,0
137086,2021,Türkiye,Serbia,0,0,0,0,25/05/2021,0,0,0,0,0,0,0,0,0,0,0,0,0,0,0,0,0,0,0,0
143585,2021,Japan,Türkiye,0,0,0,0,25/06/2021,0,0,0,0,0,0,0,0,0,0,0,0,0,0,0,0,0,0,0,0
143585,2021,USA,Türkiye,1,2,8,11,24/06/2021,0,0,4,4,7,6,7,20,1,2,0,3,11,0,17,28,6,1,0,7
143585,2021,Brazil,Türkiye,0,0,2,2,20/06/2021,0,0,0,0,1,3,6,10,0,2,3,5,2,0,5,7,1,0,0,1
143585,2021,Korea,Türkiye,1,3,11,15,19/06/2021,0,0,0,0,9,6,12,27,0,2,1,3,11,0,16,27,5,4,0,9
143585,2021,Türkiye,Netherlands,0,1,12,13,18/06/2021,0,0,2,2,14,4,11,29,2,0,1,3,6,1,9,16,6,2,0,8
143585,2021,USA,Türkiye,2,2,5,9,14/06/2021,0,0,2,2,10,5,14,29,1,2,0,3,4,1,14,19,4,1,1,6
143585,2021,Türkiye,Belgium,1,2,10,13,13/06/2021,0,0,1,1,16,5,12,33,0,3,0,3,8,1,10,19,6,0,1,7
143585,2021,Japan,Türkiye,1,0,14,15,12/6/2021,0,0,4,4,15,3,10,28,1,1,0,2,9,1,16,26,7,6,1,14
143585,2021,Türkiye,Russia,0,1,4,5,8/6/2021,0,0,0,0,3,1,3,7,0,0,0,0,2,0,3,5,4,1,0,5
143585,2021,Türkiye,Dominican Republic,0,0,4,4,7/6/2021,0,0,0,0,2,2,7,11,0,2,1,3,3,1,5,9,1,2,0,3
143585,2021,Türkiye,Thailand,3,2,9,14,6/6/2021,0,0,2,2,12,5,13,30,1,3,0,4,4,0,12,16,6,1,1,8
143585,2021,China,Türkiye,0,0,11,11,2/6/2021,0,0,0,0,8,5,5,18,2,1,3,6,7,0,13,20,6,0,1,7
143585,2021,Türkiye,Germany,0,0,8,8,1/6/2021,0,0,0,0,9,1,7,17,0,0,3,3,1,0,11,12,9,2,1,12
143585,2021,Canada,Türkiye,0,1,14,15,31/05/2021,0,0,1,1,14,5,12,31,2,2,3,7,3,3,18,24,6,0,1,7
143585,2021,Poland,Türkiye,0,2,14,16,27/05/2021,0,0,0,0,5,5,8,18,1,2,1,4,10,2,24,36,11,2,2,15
143585,2021,Türkiye,Italy,1,1,8,10,26/05/2021,0,0,0,0,9,1,6,16,2,1,0,3,8,1,9,18,0,2,0,2
143585,2021,Türkiye,Serbia,0,0,8,8,25/05/2021,0,0,0,0,6,4,6,16,0,2,0,2,5,5,17,27,10,0,1,11
148070,2021,Japan,Türkiye,0,0,2,2,25/06/2021,0,0,0,0,0,0,0,0,0,0,0,0,0,0,0,0,0,0,0,0
148070,2021,USA,Türkiye,0,0,4,4,24/06/2021,0,0,2,2,0,4,3,7,0,0,1,1,3,0,6,9,5,0,1,6
148070,2021,Brazil,Türkiye,0,0,3,3,20/06/2021,0,0,1,1,1,0,3,4,0,1,0,1,4,1,11,16,1,0,1,2
148070,2021,Korea,Türkiye,1,1,13,15,19/06/2021,0,0,1,1,9,1,6,16,2,1,2,5,7,3,17,27,11,1,1,13
148070,2021,Türkiye,Netherlands,0,1,9,10,18/06/2021,0,0,0,0,0,1,9,10,2,1,1,4,10,2,18,30,10,0,2,12
148070,2021,USA,Türkiye,1,2,13,16,14/06/2021,0,0,0,0,3,4,10,17,1,1,1,3,14,1,17,32,7,4,0,11
148070,2021,Türkiye,Belgium,0,1,10,11,13/06/2021,0,0,1,1,8,2,5,15,0,1,1,2,7,1,11,19,13,1,0,14
148070,2021,Japan,Türkiye,0,1,3,4,12/6/2021,0,0,1,1,3,3,8,14,0,2,1,3,5,1,15,21,3,2,4,9
148070,2021,Türkiye,Russia,0,1,7,8,8/6/2021,0,0,3,3,3,2,13,18,1,2,2,5,8,1,14,23,3,3,1,7
148070,2021,Türkiye,Dominican Republic,0,0,16,16,7/6/2021,0,0,1,1,5,2,9,16,0,2,2,4,14,1,20,35,3,5,0,8
148070,2021,Türkiye,Thailand,0,0,0,0,6/6/2021,0,0,0,0,0,0,0,0,0,0,0,0,0,0,0,0,0,0,0,0
148070,2021,China,Türkiye,2,1,13,16,2/6/2021,0,0,2,2,11,1,9,21,1,2,3,6,4,3,8,15,9,1,1,11
148070,2021,Türkiye,Germany,1,0,14,15,1/6/2021,0,0,3,3,3,0,8,11,1,4,2,7,9,5,11,25,6,0,0,6
148070,2021,Canada,Türkiye,1,0,5,6,31/05/2021,0,0,1,1,1,3,3,7,1,2,0,3,2,2,11,15,5,0,2,7
148070,2021,Poland,Türkiye,0,0,13,13,27/05/2021,0,0,1,1,6,4,8,18,0,1,1,2,8,3,15,26,9,3,0,12
148070,2021,Türkiye,Italy,0,0,10,10,26/05/2021,0,0,1,1,5,0,3,8,1,0,1,2,10,0,6,16,9,3,0,12
148070,2021,Türkiye,Serbia,1,0,11,12,25/05/2021,0,0,1,1,3,5,9,17,2,0,0,2,8,0,19,27,7,0,1,8
153618,2021,Japan,Türkiye,0,0,0,0,25/06/2021,0,0,0,0,0,0,0,0,0,0,0,0,0,0,0,0,0,0,0,0
153618,2021,USA,Türkiye,0,0,1,1,24/06/2021,0,0,0,0,0,0,0,0,0,0,0,0,0,0,0,0,0,0,0,0
153618,2021,Brazil,Türkiye,0,2,4,6,20/06/2021,16,0,56,72,1,0,2,3,1,1,3,5,0,0,0,0,1,1,0,2
153618,2021,Korea,Türkiye,0,0,0,0,19/06/2021,1,0,3,4,0,0,0,0,0,0,0,0,0,0,1,1,1,0,0,1
153618,2021,Türkiye,Netherlands,0,0,2,2,18/06/2021,0,0,2,2,0,0,0,0,0,0,0,0,0,0,0,0,0,0,0,0
153618,2021,USA,Türkiye,0,0,0,0,14/06/2021,2,0,16,18,0,0,0,0,0,0,0,0,0,0,0,0,1,0,0,1
153618,2021,Türkiye,Belgium,0,0,0,0,13/06/2021,0,0,0,0,0,0,0,0,0,0,0,0,0,0,0,0,0,0,0,0
153618,2021,Japan,Türkiye,0,0,1,1,12/6/2021,0,0,1,1,0,0,0,0,0,0,0,0,0,0,0,0,0,0,0,0
151195,2021,Japan,Türkiye,0,0,0,0,25/06/2021,0,0,0,0,0,0,0,0,0,0,0,0,0,0,0,0,0,0,0,0
151195,2021,USA,Türkiye,0,0,0,0,24/06/2021,0,0,0,0,1,0,6,7,0,0,1,1,0,0,0,0,0,0,0,0
151195,2021,Brazil,Türkiye,0,2,4,6,20/06/2021,0,0,0,0,6,2,15,23,0,1,1,2,0,0,0,0,8,0,2,10
151195,2021,Korea,Türkiye,0,0,0,0,19/06/2021,0,0,0,0,1,0,2,3,0,0,0,0,0,0,0,0,0,0,0,0
151195,2021,Türkiye,Netherlands,0,0,0,0,18/06/2021,0,0,0,0,0,0,0,0,0,0,0,0,0,0,0,0,0,0,0,0
151195,2021,USA,Türkiye,0,0,6,6,14/06/2021,0,0,1,1,2,1,5,8,0,0,0,0,0,0,0,0,3,0,0,3
151195,2021,Türkiye,Belgium,1,1,2,4,13/06/2021,0,0,0,0,0,0,0,0,0,0,0,0,0,0,0,0,0,0,0,0
151195,2021,Japan,Türkiye,0,3,3,6,12/6/2021,0,0,0,0,9,4,15,28,0,3,5,8,0,0,0,0,5,0,0,5
151195,2021,Türkiye,Russia,0,0,4,4,8/6/2021,0,1,0,1,5,3,5,13,0,0,1,1,0,0,0,0,2,0,0,2
151195,2021,Türkiye,Dominican Republic,0,2,4,6,7/6/2021,0,0,0,0,9,5,15,29,1,2,0,3,0,0,0,0,0,2,0,2
151195,2021,Türkiye,Thailand,2,2,11,15,6/6/2021,0,1,0,1,22,3,15,40,0,4,6,10,0,0,0,0,8,1,2,11
151195,2021,China,Türkiye,0,0,0,0,2/6/2021,0,0,0,0,0,1,2,3,0,0,0,0,0,0,0,0,0,0,0,0
151195,2021,Türkiye,Germany,0,0,0,0,1/6/2021,0,0,0,0,0,0,0,0,0,0,0,0,0,0,0,0,0,0,0,0
151195,2021,Canada,Türkiye,0,1,6,7,31/05/2021,0,0,0,0,9,5,17,31,2,2,1,5,0,0,1,1,5,0,0,5
151195,2021,Poland,Türkiye,0,0,0,0,27/05/2021,0,0,0,0,2,1,1,4,0,0,1,1,0,0,0,0,0,0,0,0
151195,2021,Türkiye,Italy,0,0,0,0,26/05/2021,0,0,0,0,0,0,0,0,0,0,0,0,0,0,0,0,0,0,0,0
151195,2021,Türkiye,Serbia,0,0,15,15,25/05/2021,1,0,0,1,16,8,17,41,1,1,3,5,0,0,0,0,3,0,0,3
138782,2021,Japan,Türkiye,1,2,9,12,25/06/2021,0,0,1,1,9,2,4,15,3,3,7,13,0,0,0,0,3,0,0,3
138782,2021,USA,Türkiye,1,0,8,9,24/06/2021,0,0,0,0,9,2,7,18,1,3,6,10,0,0,0,0,2,1,0,3
138782,2021,Brazil,Türkiye,3,0,12,15,20/06/2021,0,0,5,5,7,1,8,16,2,13,7,22,0,0,0,0,4,3,1,8
138782,2021,Korea,Türkiye,2,1,12,15,19/06/2021,0,0,3,3,11,1,4,16,3,1,1,5,0,0,1,1,4,4,0,8
138782,2021,Türkiye,Netherlands,2,2,10,14,18/06/2021,0,0,0,0,6,5,2,13,5,1,4,10,0,0,0,0,5,3,1,9
138782,2021,USA,Türkiye,1,1,8,10,14/06/2021,0,0,1,1,7,1,6,14,0,4,4,8,0,0,0,0,2,1,1,4
138782,2021,Türkiye,Belgium,0,2,8,10,13/06/2021,0,0,2,2,8,3,3,14,1,1,3,5,0,0,0,0,4,2,0,6
138782,2021,Japan,Türkiye,0,1,8,9,12/6/2021,0,0,3,3,12,0,8,20,1,7,11,19,0,0,0,0,2,1,0,3
138782,2021,Türkiye,Russia,2,1,10,13,8/6/2021,0,0,5,5,7,2,7,16,8,4,4,16,2,0,1,3,6,1,0,7
138782,2021,Türkiye,Dominican Republic,2,1,9,12,7/6/2021,0,0,0,0,6,5,4,15,2,2,0,4,0,0,1,1,1,0,0,1
138782,2021,Türkiye,Thailand,1,1,3,5,6/6/2021,0,0,2,2,5,2,2,9,5,0,4,9,0,0,0,0,0,0,0,0
138782,2021,China,Türkiye,1,1,7,9,2/6/2021,0,0,4,4,7,1,3,11,5,2,8,15,0,0,1,1,2,0,0,2
138782,2021,Türkiye,Germany,0,1,5,6,1/6/2021,0,0,1,1,10,1,5,16,1,1,3,5,0,0,0,0,1,0,0,1
138782,2021,Canada,Türkiye,0,0,8,8,31/05/2021,0,1,0,1,2,3,6,11,2,7,8,17,1,0,1,2,4,0,0,4
138782,2021,Poland,Türkiye,2,0,11,13,27/05/2021,0,0,0,0,16,2,7,25,2,2,3,7,0,0,0,0,4,2,1,7
138782,2021,Türkiye,Italy,1,2,8,11,26/05/2021,0,0,0,0,11,0,4,15,0,4,1,5,0,0,0,0,0,0,0,0
138782,2021,Türkiye,Serbia,0,2,10,12,25/05/2021,0,0,5,5,10,7,6,23,5,7,15,27,1,0,0,1,0,0,2,2
152312,2021,Brazil,Türkiye,0,0,0,0,20/06/2021,0,0,0,0,0,0,0,0,0,0,0,0,0,0,0,0,0,0,0,0
152312,2021,Türkiye,Netherlands,0,0,0,0,18/06/2021,0,0,0,0,0,0,0,0,0,0,0,0,0,0,0,0,0,0,0,0
152312,2021,USA,Türkiye,0,0,0,0,14/06/2021,0,0,0,0,0,0,0,0,0,0,0,0,0,0,0,0,0,0,0,0
152312,2021,Japan,Türkiye,0,0,0,0,12/6/2021,0,0,0,0,0,0,0,0,0,0,0,0,0,0,0,0,0,0,0,0
152263,2021,Korea,Türkiye,1,0,9,10,19/06/2021,0,0,2,2,8,1,0,9,2,4,3,9,0,0,0,0,1,2,0,3
152263,2021,Türkiye,Netherlands,1,0,9,10,18/06/2021,0,0,1,1,8,1,6,15,2,6,3,11,0,0,0,0,4,1,0,5
152263,2021,USA,Türkiye,0,1,5,6,14/06/2021,0,0,0,0,4,2,2,8,0,2,1,3,0,0,0,0,0,1,0,1
152263,2021,Türkiye,Belgium,1,2,11,14,13/06/2021,0,0,5,5,4,3,1,8,1,1,5,7,0,1,0,1,0,1,0,1
152263,2021,Japan,Türkiye,1,1,13,15,12/6/2021,0,0,1,1,9,2,7,18,3,5,15,23,0,0,0,0,2,3,1,6
152263,2021,Türkiye,Russia,0,4,3,7,8/6/2021,0,0,0,0,6,2,4,12,4,5,4,13,0,0,0,0,3,0,0,3
152263,2021,Türkiye,Dominican Republic,0,1,2,3,7/6/2021,0,0,0,0,4,0,0,4,0,0,0,0,0,0,0,0,0,0,0,0
137087,2021,Japan,Türkiye,0,0,0,0,25/06/2021,0,0,0,0,0,0,0,0,0,0,0,0,0,0,0,0,0,0,0,0
137087,2021,USA,Türkiye,0,0,0,0,24/06/2021,0,0,0,0,1,0,1,2,0,1,0,1,0,0,0,0,0,0,0,0
137087,2021,Brazil,Türkiye,0,1,9,10,20/06/2021,0,0,3,3,2,3,1,6,0,7,8,15,0,0,0,0,0,2,0,2
137087,2021,Korea,Türkiye,0,0,0,0,19/06/2021,0,0,0,0,0,0,0,0,0,0,0,0,0,0,0,0,0,0,0,0
137087,2021,Türkiye,Belgium,0,0,0,0,13/06/2021,0,0,0,0,0,0,0,0,0,0,0,0,0,0,0,0,0,0,0,0
137087,2021,Türkiye,Russia,0,0,4,4,8/6/2021,0,0,0,0,1,1,1,3,0,2,0,2,0,0,0,0,0,0,0,0
137087,2021,Türkiye,Dominican Republic,0,0,7,7,7/6/2021,0,0,0,0,0,0,3,3,1,0,0,1,0,0,0,0,0,1,0,1
137087,2021,Türkiye,Thailand,0,0,0,0,6/6/2021,0,0,0,0,0,0,0,0,0,0,0,0,0,0,0,0,0,0,0,0
137087,2021,China,Türkiye,0,0,0,0,2/6/2021,0,0,0,0,0,0,0,0,0,0,0,0,0,0,0,0,0,0,0,0
137087,2021,Türkiye,Germany,0,1,3,4,1/6/2021,0,0,0,0,0,3,2,5,0,1,1,2,0,0,0,0,0,0,0,0
137087,2021,Canada,Türkiye,0,1,8,9,31/05/2021,0,0,0,0,1,0,1,2,2,3,3,8,0,0,0,0,3,1,0,4
137087,2021,Poland,Türkiye,0,0,0,0,27/05/2021,0,0,0,0,0,0,0,0,0,0,0,0,0,0,0,0,0,0,0,0
137087,2021,Türkiye,Italy,0,2,6,8,26/05/2021,0,0,0,0,11,0,2,13,0,1,0,1,0,0,0,0,0,0,0,0
137087,2021,Türkiye,Serbia,2,0,14,16,25/05/2021,0,0,0,0,5,1,2,8,1,4,6,11,0,0,1,1,4,0,0,4
163094,2021,Japan,Türkiye,0,0,0,0,25/06/2021,0,0,0,0,0,0,0,0,0,0,0,0,0,0,0,0,0,0,0,0
163094,2021,USA,Türkiye,0,0,0,0,24/06/2021,0,0,0,0,0,0,0,0,0,0,0,0,0,0,0,0,0,0,0,0
163094,2021,Korea,Türkiye,0,0,0,0,19/06/2021,0,0,0,0,0,0,0,0,0,0,0,0,0,0,0,0,0,0,0,0
163094,2021,Türkiye,Netherlands,0,0,0,0,18/06/2021,0,0,0,0,0,0,0,0,0,0,0,0,0,0,0,0,0,0,0,0
163094,2021,Türkiye,Belgium,0,0,0,0,13/06/2021,0,0,0,0,0,0,0,0,0,0,0,0,0,0,0,0,0,0,0,0
163094,2021,Japan,Türkiye,0,0,0,0,12/6/2021,0,0,0,0,0,0,0,0,0,0,0,0,0,0,0,0,0,0,0,0
163089,2021,Japan,Türkiye,0,1,9,10,25/06/2021,0,0,1,1,9,2,5,16,0,3,3,6,19,1,14,34,12,1,0,13
163089,2021,USA,Türkiye,0,0,0,0,24/06/2021,0,0,0,0,0,0,0,0,0,0,0,0,0,0,0,0,0,0,0,0
163089,2021,Brazil,Türkiye,0,0,8,8,20/06/2021,0,0,2,2,10,2,6,18,0,1,2,3,7,1,19,27,5,2,3,10
163089,2021,USA,Türkiye,0,0,0,0,14/06/2021,0,0,0,0,0,0,0,0,0,0,0,0,1,0,0,1,0,1,0,1
163089,2021,Türkiye,Belgium,0,0,0,0,13/06/2021,0,0,0,0,0,0,0,0,0,0,0,0,0,0,0,0,0,0,0,0
163982,2021,Japan,Türkiye,1,1,6,8,25/06/2021,0,0,0,0,24,4,9,37,4,3,2,9,0,0,0,0,4,0,2,6
163982,2021,USA,Türkiye,0,3,4,7,24/06/2021,0,0,0,0,14,3,19,36,3,1,9,13,0,0,0,0,7,3,1,11
163982,2021,Brazil,Türkiye,1,1,8,10,20/06/2021,0,1,1,2,11,5,15,31,0,3,1,4,0,0,0,0,7,0,3,10
163982,2021,Korea,Türkiye,0,3,8,11,19/06/2021,0,1,0,1,22,7,17,46,0,4,1,5,0,0,0,0,7,5,0,12
163982,2021,Türkiye,Netherlands,1,0,9,10,18/06/2021,0,0,1,1,20,4,15,39,0,1,2,3,0,0,0,0,4,3,0,7
163982,2021,USA,Türkiye,0,1,7,8,14/06/2021,0,0,2,2,15,4,18,37,3,2,5,10,0,0,0,0,7,0,1,8
163982,2021,Türkiye,Belgium,2,2,14,18,13/06/2021,0,0,1,1,13,7,10,30,1,1,1,3,1,0,0,1,8,0,0,8
163982,2021,Japan,Türkiye,1,2,5,8,12/6/2021,0,0,0,0,1,3,8,12,0,1,0,1,0,0,0,0,5,1,1,7
163982,2021,Türkiye,Russia,3,2,19,24,8/6/2021,0,0,0,0,22,7,17,46,0,0,0,0,0,0,0,0,14,1,1,16
163982,2021,Türkiye,Dominican Republic,1,1,6,8,7/6/2021,0,0,1,1,8,8,14,30,1,5,0,6,0,0,0,0,2,0,0,2
163982,2021,Türkiye,Thailand,0,0,0,0,6/6/2021,0,0,1,1,5,2,2,9,0,1,0,1,0,0,0,0,0,0,0,0
163982,2021,China,Türkiye,1,3,5,9,2/6/2021,0,0,1,1,16,7,19,42,0,3,2,5,0,0,0,0,5,1,2,8
163982,2021,Türkiye,Germany,2,2,11,15,1/6/2021,0,0,2,2,17,4,16,37,2,4,5,11,0,0,0,0,6,3,0,9
163982,2021,Canada,Türkiye,0,1,7,8,31/05/2021,0,0,0,0,19,4,18,41,2,1,2,5,0,0,0,0,8,0,0,8
163982,2021,Poland,Türkiye,2,2,21,25,27/05/2021,0,0,2,2,23,8,19,50,1,4,0,5,0,0,0,0,6,3,1,10
163982,2021,Türkiye,Italy,2,3,12,17,26/05/2021,0,0,0,0,7,2,9,18,2,4,3,9,0,0,0,0,7,1,1,9
163982,2021,Türkiye,Serbia,1,1,6,8,25/05/2021,1,0,0,1,13,6,13,32,2,0,5,7,0,0,0,0,3,1,0,4
132835,2021,Brazil,USA,0,2,1,3,25/06/2021,3,0,10,13,0,0,0,0,0,0,0,0,0,0,0,0,3,1,0,4
132835,2021,USA,Türkiye,0,0,0,0,24/06/2021,0,0,0,0,0,0,0,0,0,0,0,0,0,0,0,0,0,0,0,0
132835,2021,China,USA,1,1,7,9,20/06/2021,8,2,63,73,2,1,1,4,0,2,0,2,0,0,0,0,3,4,1,8
132835,2021,USA,Russia,0,0,0,0,19/06/2021,0,0,0,0,0,0,0,0,0,0,0,0,0,0,0,0,0,0,0,0
132835,2021,Poland,USA,4,5,6,15,18/06/2021,14,0,77,91,1,0,1,2,1,3,1,5,0,0,1,1,8,0,1,9
132835,2021,USA,Türkiye,0,1,7,8,14/06/2021,2,1,12,15,0,0,0,0,0,0,0,0,0,0,0,0,3,0,0,3
132835,2021,USA,Japan,0,3,8,11,13/06/2021,17,1,51,69,0,0,1,1,2,0,3,5,0,0,0,0,10,6,0,16
132835,2021,USA,Belgium,0,0,0,0,12/6/2021,0,0,0,0,0,0,0,0,0,0,0,0,0,0,0,0,0,0,0,0
132835,2021,Italy,USA,0,0,0,0,8/6/2021,0,0,0,0,0,0,0,0,0,0,0,0,0,0,0,0,0,0,0,0
132835,2021,Korea,USA,3,0,11,14,7/6/2021,26,1,40,67,1,0,2,3,1,3,7,11,0,0,0,0,9,1,0,10
132835,2021,Germany,USA,3,3,12,18,6/6/2021,6,1,61,68,1,0,0,1,0,0,2,2,0,0,0,0,5,1,0,6
132835,2021,Thailand,USA,1,2,12,15,2/6/2021,27,1,52,80,1,0,4,5,2,1,1,4,0,0,0,0,1,1,0,2
132835,2021,USA,Netherlands,2,4,7,13,1/6/2021,34,2,58,94,3,0,2,5,0,1,1,2,0,0,0,0,11,3,1,15
132835,2021,Serbia,USA,0,0,0,0,31/05/2021,0,0,0,0,0,0,0,0,0,0,0,0,0,0,0,0,0,0,0,0
132835,2021,Dominican Republic,USA,0,0,0,0,25/05/2021,0,0,0,0,0,0,0,0,0,0,0,0,0,0,0,0,0,0,0,0
143517,2021,Brazil,USA,0,0,15,15,25/06/2021,33,2,85,120,2,0,4,6,4,3,3,10,0,0,0,0,10,3,1,14
143517,2021,USA,Türkiye,1,1,19,21,24/06/2021,13,1,77,91,1,0,2,3,3,3,3,9,0,0,0,0,7,1,0,8
143517,2021,China,USA,0,0,0,0,20/06/2021,0,0,0,0,0,0,0,0,0,0,0,0,0,0,0,0,0,0,0,0
143517,2021,USA,Russia,1,0,15,16,19/06/2021,39,2,62,103,1,0,3,4,0,2,5,7,0,0,0,0,6,1,3,10
143517,2021,Poland,USA,0,0,0,0,18/06/2021,0,0,0,0,0,0,0,0,0,0,0,0,0,0,0,0,0,0,0,0
143517,2021,USA,Türkiye,1,0,15,16,14/06/2021,22,0,61,83,0,0,1,1,1,1,1,3,0,0,0,0,12,1,0,13
143517,2021,USA,Japan,1,0,6,7,13/06/2021,8,0,20,28,0,0,0,0,0,0,0,0,0,0,0,0,3,0,0,3
143517,2021,USA,Belgium,1,1,11,13,12/6/2021,19,1,69,89,1,0,0,1,0,2,4,6,1,1,0,2,8,2,0,10
143517,2021,Italy,USA,1,0,19,20,8/6/2021,16,0,95,111,1,1,3,5,1,0,1,2,0,1,0,1,6,1,0,7
143517,2021,Korea,USA,0,0,0,0,7/6/2021,0,0,0,0,0,0,0,0,0,0,0,0,0,0,0,0,0,0,0,0
143517,2021,Serbia,USA,0,0,11,11,31/05/2021,29,1,52,82,2,0,1,3,1,1,5,7,0,0,0,0,6,0,1,7
143517,2021,Brazil,USA,2,0,15,17,27/05/2021,45,0,91,136,0,0,1,1,0,6,5,11,0,0,2,2,11,1,2,14
143517,2021,USA,Canada,0,0,0,0,26/05/2021,0,0,0,0,0,0,0,0,0,0,0,0,0,0,0,0,0,0,0,0
146722,2021,Korea,USA,0,0,0,0,7/6/2021,0,0,0,0,0,0,0,0,0,0,0,0,0,0,0,0,0,0,0,0
146722,2021,Germany,USA,0,0,0,0,6/6/2021,0,0,0,0,0,0,0,0,0,0,0,0,0,0,0,0,0,0,0,0
146722,2021,Brazil,USA,0,0,0,0,27/05/2021,0,0,0,0,0,0,0,0,0,0,0,0,0,0,0,0,0,0,0,0
146722,2021,USA,Canada,2,3,8,13,26/05/2021,0,0,0,0,8,4,13,25,1,0,0,1,11,0,23,34,3,0,0,3
146722,2021,Dominican Republic,USA,0,3,6,9,25/05/2021,1,0,1,2,14,5,9,28,2,3,1,6,7,1,16,24,4,3,0,7
135564,2021,Brazil,USA,0,0,0,0,25/06/2021,0,0,9,9,0,0,0,0,0,0,0,0,7,0,16,23,14,6,0,20
135564,2021,USA,Türkiye,0,0,0,0,24/06/2021,0,0,7,7,0,0,0,0,0,0,0,0,5,1,12,18,14,3,4,21
135564,2021,China,USA,0,0,0,0,20/06/2021,0,0,0,0,0,0,0,0,0,0,0,0,0,0,0,0,0,0,0,0
135564,2021,USA,Russia,0,0,0,0,19/06/2021,0,0,0,0,0,0,0,0,0,0,0,0,0,0,0,0,0,0,0,0
135564,2021,Poland,USA,0,0,0,0,18/06/2021,0,0,9,9,0,0,0,0,0,0,0,0,5,1,11,17,17,3,1,21
135564,2021,USA,Türkiye,0,0,0,0,14/06/2021,0,0,11,11,0,0,0,0,0,0,0,0,9,1,10,20,13,4,1,18
135564,2021,USA,Japan,0,0,0,0,13/06/2021,1,0,12,13,0,0,0,0,0,0,0,0,5,2,0,7,14,0,0,14
135564,2021,USA,Belgium,0,0,0,0,12/6/2021,0,0,11,11,0,0,0,0,0,0,0,0,13,1,5,19,11,0,1,12
135564,2021,Italy,USA,0,0,0,0,8/6/2021,0,0,5,5,0,0,0,0,0,0,0,0,8,2,19,29,20,6,0,26
135564,2021,Korea,USA,0,0,0,0,7/6/2021,0,0,7,7,0,0,0,0,0,0,0,0,9,1,3,13,9,1,1,11
135564,2021,Germany,USA,0,0,0,0,6/6/2021,0,0,4,4,0,0,0,0,0,0,0,0,7,2,15,24,14,2,0,16
135564,2021,Thailand,USA,0,0,0,0,2/6/2021,0,0,0,0,0,0,0,0,0,0,0,0,0,0,0,0,0,0,0,0
135564,2021,USA,Netherlands,0,0,0,0,1/6/2021,0,0,12,12,0,0,0,0,0,0,0,0,9,0,5,14,14,3,4,21
135564,2021,Serbia,USA,0,0,0,0,31/05/2021,0,0,0,0,0,0,0,0,0,0,0,0,0,0,0,0,0,0,0,0
135564,2021,Brazil,USA,0,0,0,0,27/05/2021,0,0,6,6,0,0,0,0,0,0,0,0,11,0,12,23,25,2,3,30
135564,2021,USA,Canada,0,0,0,0,26/05/2021,0,0,6,6,0,0,0,0,0,0,0,0,3,0,3,6,17,0,0,17
135564,2021,Dominican Republic,USA,0,0,0,0,25/05/2021,0,0,2,2,0,0,0,0,0,0,0,0,9,0,6,15,10,5,1,16
145702,2021,China,USA,0,0,0,0,20/06/2021,0,0,0,0,0,0,0,0,0,0,0,0,0,0,0,0,0,0,0,0
145702,2021,USA,Russia,0,0,0,0,19/06/2021,0,0,0,0,0,0,0,0,0,0,0,0,0,0,0,0,0,0,0,0
145702,2021,Poland,USA,0,2,8,10,18/06/2021,0,1,0,1,3,2,4,9,3,3,2,8,0,0,0,0,2,0,1,3
145702,2021,USA,Japan,0,0,0,0,13/06/2021,0,0,0,0,0,0,0,0,0,0,0,0,0,0,0,0,0,0,0,0
145702,2021,Italy,USA,0,0,0,0,8/6/2021,0,0,0,0,0,0,0,0,0,0,0,0,0,0,0,0,0,0,0,0
145702,2021,Korea,USA,0,0,0,0,7/6/2021,0,0,0,0,0,0,0,0,0,0,0,0,0,0,0,0,0,0,0,0
145702,2021,Germany,USA,0,0,0,0,6/6/2021,0,0,0,0,0,0,0,0,0,0,0,0,0,0,0,0,0,0,0,0
145702,2021,Thailand,USA,0,0,0,0,2/6/2021,0,0,0,0,0,0,0,0,0,0,0,0,0,0,0,0,0,0,0,0
145702,2021,USA,Netherlands,2,1,8,11,1/6/2021,0,0,0,0,3,1,7,11,0,3,4,7,0,0,0,0,3,1,0,4
145702,2021,Serbia,USA,0,0,0,0,31/05/2021,0,0,0,0,0,0,0,0,0,0,0,0,0,0,0,0,0,0,0,0
145702,2021,Brazil,USA,0,0,0,0,27/05/2021,0,0,0,0,0,0,0,0,0,0,0,0,0,0,0,0,0,0,0,0
145702,2021,USA,Canada,0,3,9,12,26/05/2021,0,0,0,0,5,0,6,11,2,1,2,5,0,0,0,0,1,0,0,1
145702,2021,Dominican Republic,USA,0,1,9,10,25/05/2021,0,0,0,0,6,1,6,13,0,1,2,3,0,0,0,0,0,1,0,1
132500,2021,Germany,USA,0,0,0,0,6/6/2021,0,0,0,0,0,0,0,0,0,0,0,0,0,0,0,0,0,0,0,0
132500,2021,Thailand,USA,0,0,0,0,2/6/2021,0,0,0,0,0,0,0,0,0,0,0,0,0,0,0,0,0,0,0,0
132500,2021,USA,Netherlands,0,0,0,0,1/6/2021,0,0,0,0,0,0,0,0,0,0,0,0,0,0,0,0,0,0,0,0
132500,2021,Brazil,USA,0,0,0,0,27/05/2021,0,0,0,0,0,0,0,0,0,0,0,0,0,0,0,0,0,0,0,0
132500,2021,USA,Canada,2,0,14,16,26/05/2021,3,0,92,95,2,0,1,3,2,2,0,4,0,0,0,0,1,0,0,1
132500,2021,Dominican Republic,USA,1,0,10,11,25/05/2021,0,0,0,0,1,0,1,2,1,1,0,2,0,0,0,0,2,2,0,4
160909,2021,China,USA,0,0,4,4,20/06/2021,0,0,0,0,0,1,1,2,1,0,2,3,0,0,0,0,0,2,0,2
160909,2021,USA,Russia,0,0,0,0,19/06/2021,0,0,0,0,0,0,0,0,0,0,0,0,0,0,0,0,0,0,0,0
160909,2021,USA,Türkiye,0,0,0,0,14/06/2021,0,0,0,0,0,0,0,0,0,0,0,0,0,0,0,0,0,0,0,0
160909,2021,USA,Belgium,0,0,0,0,12/6/2021,0,0,0,0,0,0,0,0,0,0,0,0,0,0,0,0,0,0,0,0
160909,2021,Italy,USA,0,0,0,0,8/6/2021,0,0,0,0,0,0,0,0,0,0,0,0,0,0,0,0,0,0,0,0
160909,2021,Korea,USA,0,0,0,0,7/6/2021,0,0,0,0,0,0,0,0,0,0,0,0,0,0,0,0,0,0,0,0
160909,2021,Germany,USA,0,0,0,0,6/6/2021,0,0,0,0,0,0,0,0,0,0,0,0,0,0,0,0,0,0,0,0
160909,2021,Thailand,USA,1,2,8,11,2/6/2021,0,0,1,1,6,1,2,9,0,3,0,3,1,0,0,1,3,0,0,3
160909,2021,USA,Netherlands,0,0,0,0,1/6/2021,0,0,0,0,0,0,0,0,0,0,0,0,0,0,0,0,0,0,0,0
160909,2021,Brazil,USA,0,0,0,0,27/05/2021,0,0,0,0,0,0,0,0,0,0,0,0,0,0,0,0,0,0,0,0
160909,2021,USA,Canada,0,0,11,11,26/05/2021,0,0,0,0,6,0,4,10,1,0,0,1,0,0,0,0,0,0,0,0
160909,2021,Dominican Republic,USA,0,1,13,14,25/05/2021,0,0,0,0,3,0,3,6,4,3,2,9,0,0,0,0,0,1,0,1
114051,2021,Brazil,USA,0,0,14,14,25/06/2021,0,0,8,8,10,3,16,29,1,3,1,5,7,0,7,14,10,2,1,13
114051,2021,USA,Türkiye,0,0,4,4,24/06/2021,0,0,2,2,2,2,11,15,0,1,1,2,1,1,8,10,6,1,0,7
114051,2021,China,USA,0,0,0,0,20/06/2021,0,0,0,0,0,0,0,0,0,0,0,0,0,0,0,0,0,0,0,0
114051,2021,USA,Russia,4,0,11,15,19/06/2021,0,0,2,2,15,3,13,31,0,2,1,3,7,1,15,23,12,1,1,14
114051,2021,Poland,USA,0,0,0,0,18/06/2021,0,0,0,0,0,0,0,0,0,0,0,0,0,0,0,0,0,0,0,0
114051,2021,USA,Türkiye,0,2,16,18,14/06/2021,0,0,6,6,13,0,14,27,0,3,1,4,9,3,15,27,11,3,0,14
114051,2021,USA,Japan,0,0,0,0,13/06/2021,0,0,0,0,0,0,0,0,0,0,0,0,0,0,0,0,0,0,0,0
114051,2021,USA,Belgium,0,5,16,21,12/6/2021,0,0,3,3,10,4,7,21,0,2,2,4,5,1,12,18,13,1,0,14
114051,2021,Italy,USA,0,0,0,0,8/6/2021,0,0,0,0,0,0,0,0,0,0,0,0,0,0,0,0,0,0,0,0
114051,2021,Korea,USA,1,1,7,9,7/6/2021,0,0,1,1,6,2,4,12,0,1,1,2,3,0,2,5,3,0,0,3
114051,2021,Germany,USA,2,1,14,17,6/6/2021,0,0,6,6,8,2,7,17,0,2,1,3,3,1,3,7,3,1,0,4
114051,2021,Thailand,USA,0,0,0,0,2/6/2021,0,0,0,0,0,0,0,0,0,0,0,0,0,0,0,0,0,0,0,0
114051,2021,USA,Netherlands,1,2,7,10,1/6/2021,0,0,2,2,8,2,21,31,1,1,2,4,7,0,5,12,14,2,0,16
114051,2021,Serbia,USA,0,0,0,0,31/05/2021,0,0,0,0,0,0,0,0,0,0,0,0,0,0,0,0,0,0,0,0
114051,2021,Brazil,USA,0,0,17,17,27/05/2021,0,0,5,5,15,3,20,38,1,3,1,5,5,0,8,13,14,4,0,18
114051,2021,USA,Canada,0,0,0,0,26/05/2021,0,0,0,0,0,0,0,0,0,0,0,0,0,0,0,0,0,0,0,0
114051,2021,Dominican Republic,USA,0,1,14,15,25/05/2021,1,1,2,4,14,1,13,28,1,4,0,5,5,0,5,10,2,2,0,4
155307,2021,Brazil,USA,0,1,4,5,25/06/2021,0,0,0,0,12,5,8,25,0,0,2,2,0,0,0,0,5,0,0,5
155307,2021,USA,Türkiye,2,0,4,6,24/06/2021,0,0,0,0,7,2,2,11,0,2,1,3,0,0,0,0,5,1,1,7
155307,2021,China,USA,0,0,9,9,20/06/2021,0,0,2,2,9,3,7,19,2,1,0,3,0,0,0,0,1,5,0,6
155307,2021,USA,Russia,3,2,13,18,19/06/2021,0,0,2,2,13,5,14,32,1,7,4,12,0,0,0,0,7,4,3,14
155307,2021,Poland,USA,0,0,0,0,18/06/2021,0,0,0,0,0,0,0,0,0,0,0,0,0,0,0,0,0,0,0,0
155307,2021,USA,Türkiye,0,0,0,0,14/06/2021,0,0,0,0,5,1,3,9,0,1,1,2,0,0,0,0,2,0,0,2
155307,2021,USA,Japan,1,1,3,5,13/06/2021,0,0,2,2,9,2,15,26,0,3,7,10,0,0,0,0,5,1,2,8
155307,2021,USA,Belgium,0,0,0,0,12/6/2021,0,0,0,0,0,0,0,0,0,0,0,0,0,0,0,0,0,0,0,0
155307,2021,Italy,USA,2,1,15,18,8/6/2021,0,0,0,0,18,3,9,30,0,3,1,4,0,0,0,0,9,1,1,11
155307,2021,Korea,USA,0,0,0,0,7/6/2021,0,0,0,0,0,0,0,0,0,0,0,0,0,0,0,0,0,0,0,0
155307,2021,Germany,USA,0,1,6,7,6/6/2021,0,0,1,1,17,0,9,26,0,2,0,2,0,0,0,0,3,1,0,4
155307,2021,Thailand,USA,0,0,0,0,2/6/2021,0,0,0,0,0,0,0,0,0,0,0,0,0,0,0,0,0,0,0,0
155307,2021,USA,Netherlands,0,2,11,13,1/6/2021,0,0,0,0,9,4,12,25,2,2,5,9,0,0,0,0,12,1,0,13
155307,2021,Serbia,USA,0,0,0,0,31/05/2021,0,0,0,0,0,0,0,0,0,0,0,0,0,0,0,0,0,0,0,0
155307,2021,Brazil,USA,1,0,16,17,27/05/2021,0,1,1,2,15,7,15,37,0,3,5,8,0,0,0,0,9,2,2,13
155307,2021,USA,Canada,0,1,13,14,26/05/2021,0,1,0,1,19,4,14,37,1,1,2,4,0,0,0,0,4,0,0,4
155307,2021,Dominican Republic,USA,0,0,0,0,25/05/2021,0,0,0,0,0,0,0,0,0,0,0,0,0,0,0,0,0,0,0,0
172978,2021,Brazil,USA,2,1,10,13,25/06/2021,0,0,1,1,12,8,11,31,2,5,2,9,0,0,0,0,8,3,1,12
172978,2021,USA,Türkiye,0,2,2,4,24/06/2021,0,0,0,0,4,3,10,17,1,1,1,3,0,0,0,0,1,2,0,3
172978,2021,China,USA,0,0,0,0,20/06/2021,0,0,0,0,0,0,0,0,0,0,0,0,0,0,0,0,0,0,0,0
172978,2021,USA,Russia,0,0,0,0,19/06/2021,0,0,0,0,0,0,0,0,0,0,0,0,0,0,0,0,0,0,0,0
172978,2021,Poland,USA,0,1,12,13,18/06/2021,0,0,1,1,14,1,15,30,3,4,3,10,0,0,0,0,6,2,2,10
172978,2021,USA,Türkiye,0,1,5,6,14/06/2021,0,0,1,1,14,7,15,36,5,4,5,14,0,0,0,0,7,2,1,10
172978,2021,USA,Japan,0,1,0,1,13/06/2021,0,0,1,1,7,0,4,11,0,0,3,3,0,0,0,0,0,0,0,0
172978,2021,USA,Belgium,0,3,6,9,12/6/2021,0,0,3,3,18,3,16,37,3,2,5,10,0,0,0,0,7,3,0,10
172978,2021,Italy,USA,0,0,0,0,8/6/2021,0,0,0,0,0,0,0,0,0,0,0,0,0,0,0,0,0,0,0,0
172978,2021,Korea,USA,1,1,12,14,7/6/2021,0,0,1,1,7,3,11,21,1,3,2,6,0,0,0,0,7,1,0,8
172978,2021,Germany,USA,0,0,0,0,6/6/2021,0,0,0,0,0,0,0,0,0,0,0,0,0,0,0,0,0,0,0,0
172978,2021,Thailand,USA,0,3,4,7,2/6/2021,0,0,0,0,14,2,9,25,3,2,1,6,0,0,0,0,5,1,0,6
172978,2021,USA,Netherlands,0,0,0,0,1/6/2021,0,0,0,0,0,0,0,0,0,0,0,0,0,0,0,0,0,0,0,0
172978,2021,Serbia,USA,2,1,11,14,31/05/2021,0,0,5,5,15,1,12,28,0,2,3,5,0,0,0,0,9,3,2,14
172978,2021,Brazil,USA,0,0,0,0,27/05/2021,0,0,0,0,0,0,0,0,0,0,0,0,0,0,0,0,0,0,0,0
172978,2021,USA,Canada,0,0,0,0,26/05/2021,0,0,0,0,0,0,0,0,0,0,0,0,0,0,0,0,0,0,0,0
172978,2021,Dominican Republic,USA,1,1,12,14,25/05/2021,3,0,1,4,13,3,17,33,1,4,3,8,0,0,0,0,6,2,0,8
162942,2021,China,USA,0,0,0,0,20/06/2021,0,0,0,0,0,0,0,0,0,0,0,0,0,0,0,0,0,0,0,0
162942,2021,USA,Russia,0,0,0,0,19/06/2021,0,0,0,0,0,0,0,0,0,0,0,0,0,0,0,0,0,0,0,0
162942,2021,Poland,USA,0,0,0,0,18/06/2021,0,0,0,0,0,0,0,0,0,0,0,0,0,0,0,0,0,0,0,0
162942,2021,USA,Japan,0,0,0,0,13/06/2021,0,0,0,0,0,0,0,0,0,0,0,0,0,0,0,0,0,0,0,0
162942,2021,USA,Belgium,0,0,0,0,12/6/2021,0,0,0,0,0,0,0,0,0,0,0,0,0,0,0,0,0,0,0,0
162942,2021,Italy,USA,0,0,0,0,8/6/2021,0,0,0,0,0,0,0,0,0,0,0,0,0,0,0,0,0,0,0,0
162942,2021,Korea,USA,0,0,0,0,7/6/2021,0,0,0,0,0,0,0,0,0,0,0,0,0,0,0,0,0,0,0,0
162942,2021,Germany,USA,0,0,0,0,6/6/2021,0,0,0,0,0,0,0,0,0,0,0,0,0,0,0,0,0,0,0,0
162942,2021,Brazil,USA,2,1,18,21,27/05/2021,0,0,0,0,21,5,17,43,2,1,2,5,10,1,23,34,4,0,1,5
162942,2021,USA,Canada,0,1,8,9,26/05/2021,0,0,4,4,8,2,13,23,3,0,0,3,4,0,2,6,2,0,0,2
162942,2021,Dominican Republic,USA,0,0,0,0,25/05/2021,0,0,0,0,0,0,0,0,0,0,0,0,0,0,0,0,0,0,0,0
119550,2021,Brazil,USA,1,1,21,23,25/06/2021,0,0,4,4,18,5,21,44,3,4,2,9,23,0,30,53,11,2,1,14
119550,2021,USA,Türkiye,0,1,10,11,24/06/2021,0,0,3,3,7,2,14,23,1,5,3,9,11,1,12,24,11,1,2,14
119550,2021,China,USA,0,1,8,9,20/06/2021,0,0,2,2,7,3,9,19,0,0,0,0,8,1,12,21,2,4,1,7
119550,2021,USA,Russia,0,0,0,0,19/06/2021,0,0,0,0,0,0,0,0,0,0,0,0,0,0,0,0,0,0,0,0
119550,2021,Poland,USA,1,0,16,17,18/06/2021,0,0,3,3,14,3,16,33,2,2,2,6,11,1,17,29,10,1,1,12
119550,2021,USA,Türkiye,1,3,7,11,14/06/2021,0,0,6,6,12,3,11,26,1,1,6,8,7,1,11,19,6,1,1,8
119550,2021,USA,Japan,1,1,13,15,13/06/2021,0,0,4,4,12,0,15,27,1,3,3,7,14,1,14,29,10,2,1,13
119550,2021,USA,Belgium,0,0,0,0,12/6/2021,0,0,0,0,0,0,0,0,0,0,0,0,0,0,0,0,0,0,0,0
119550,2021,Italy,USA,1,2,9,12,8/6/2021,0,0,2,2,16,2,15,33,2,0,2,4,6,3,20,29,7,4,1,12
119550,2021,Korea,USA,0,1,8,9,7/6/2021,0,0,2,2,7,3,10,20,1,3,4,8,6,3,5,14,11,1,2,14
119550,2021,Thailand,USA,4,1,17,22,2/6/2021,0,0,2,2,11,1,8,20,3,4,0,7,9,0,8,17,3,4,0,7
119550,2021,USA,Netherlands,0,0,0,0,1/6/2021,0,0,0,0,0,0,0,0,0,0,0,0,0,0,0,0,0,0,0,0
119550,2021,Serbia,USA,1,2,9,12,31/05/2021,0,0,2,2,9,4,9,22,1,0,1,2,5,2,15,22,3,0,1,4
119550,2021,USA,Canada,0,0,0,0,26/05/2021,0,0,0,0,0,0,0,0,0,0,0,0,0,0,0,0,0,0,0,0
142658,2021,USA,Türkiye,0,1,3,4,24/06/2021,0,0,0,0,0,0,0,0,0,0,0,0,0,0,0,0,0,0,0,0
142658,2021,China,USA,0,0,0,0,20/06/2021,0,0,1,1,0,0,0,0,0,0,0,0,15,5,22,42,7,6,1,14
142658,2021,USA,Russia,0,0,0,0,19/06/2021,0,0,3,3,0,0,0,0,0,0,0,0,8,2,20,30,11,6,3,20
142658,2021,Poland,USA,0,1,15,16,18/06/2021,0,0,2,2,8,3,13,24,5,4,2,11,3,1,10,14,9,2,3,14
142658,2021,USA,Türkiye,0,1,14,15,14/06/2021,0,0,1,1,0,0,0,0,0,0,0,0,0,0,0,0,2,1,1,4
142658,2021,USA,Japan,0,1,3,4,13/06/2021,0,0,1,1,0,0,0,0,0,0,0,0,0,0,0,0,0,0,0,0
142658,2021,USA,Belgium,0,1,6,7,12/6/2021,0,0,0,0,0,0,0,0,0,0,0,0,0,0,0,0,0,0,0,0
142658,2021,Italy,USA,0,0,0,0,8/6/2021,0,0,0,0,0,0,0,0,0,0,0,0,0,0,0,0,0,0,0,0
142658,2021,Korea,USA,0,0,2,2,7/6/2021,0,0,0,0,4,3,3,10,0,0,1,1,4,0,2,6,4,0,0,4
142658,2021,Germany,USA,0,0,0,0,6/6/2021,0,0,0,0,0,0,0,0,0,0,0,0,0,0,0,0,0,0,0,0
142658,2021,Thailand,USA,0,1,8,9,2/6/2021,0,0,0,0,9,4,12,25,2,0,2,4,6,0,4,10,5,4,0,9
142658,2021,USA,Netherlands,0,0,0,0,1/6/2021,0,0,0,0,0,0,0,0,0,0,0,0,0,0,0,0,0,0,0,0
142658,2021,Serbia,USA,0,1,12,13,31/05/2021,0,0,1,1,5,2,16,23,0,2,1,3,2,0,4,6,11,0,1,12
142658,2021,Brazil,USA,0,0,0,0,27/05/2021,0,0,0,0,0,0,0,0,0,0,0,0,0,0,0,0,0,0,0,0
142658,2021,Dominican Republic,USA,0,0,0,0,25/05/2021,0,0,0,0,0,0,0,0,0,0,0,0,0,0,0,0,0,0,0,0
115495,2021,Brazil,USA,0,1,11,12,25/06/2021,0,0,0,0,5,2,5,12,2,7,1,10,0,0,0,0,4,0,1,5
115495,2021,USA,Türkiye,0,0,7,7,24/06/2021,0,0,0,0,6,1,3,10,2,4,5,11,0,0,0,0,3,0,1,4
115495,2021,China,USA,0,1,5,6,20/06/2021,0,0,0,0,7,2,2,11,0,1,0,1,0,0,1,1,0,0,0,0
115495,2021,Poland,USA,0,0,11,11,18/06/2021,0,0,1,1,5,1,5,11,0,6,4,10,0,0,0,0,1,0,0,1
115495,2021,USA,Türkiye,0,2,3,5,14/06/2021,0,0,0,0,9,1,3,13,1,5,3,9,0,0,0,0,5,1,3,9
115495,2021,USA,Japan,0,0,0,0,13/06/2021,0,0,0,0,0,0,0,0,0,0,0,0,0,0,0,0,0,0,0,0
115495,2021,USA,Belgium,0,2,5,7,12/6/2021,0,0,1,1,8,0,4,12,1,1,2,4,0,0,0,0,4,1,0,5
115495,2021,Italy,USA,0,3,14,17,8/6/2021,0,0,1,1,7,2,4,13,4,8,10,22,0,0,0,0,5,2,0,7
115495,2021,Germany,USA,0,1,4,5,6/6/2021,0,0,0,0,2,0,5,7,1,2,0,3,0,0,0,0,3,1,0,4
115495,2021,USA,Netherlands,0,0,10,10,1/6/2021,0,0,0,0,8,3,3,14,1,4,2,7,0,0,0,0,2,1,0,3
115495,2021,Serbia,USA,0,0,0,0,31/05/2021,0,0,0,0,0,0,0,0,0,0,0,0,0,0,0,0,0,0,0,0
115495,2021,Brazil,USA,1,0,12,13,27/05/2021,0,1,0,1,7,2,6,15,2,8,7,17,1,1,1,3,2,0,2,4
115495,2021,USA,Canada,0,0,0,0,26/05/2021,0,0,0,0,0,0,0,0,0,0,0,0,0,0,0,0,0,0,0,0
115495,2021,Dominican Republic,USA,0,0,0,0,25/05/2021,0,0,0,0,0,0,0,0,0,0,0,0,0,0,0,0,0,0,0,0
155415,2021,USA,Türkiye,0,0,0,0,14/06/2021,0,0,0,0,0,0,0,0,0,0,0,0,0,0,0,0,0,0,0,0
155415,2021,Thailand,USA,0,0,0,0,2/6/2021,0,0,4,4,0,0,0,0,0,0,0,0,9,0,7,16,5,4,0,9
155415,2021,USA,Netherlands,0,0,0,0,1/6/2021,0,0,0,0,0,0,0,0,0,0,0,0,0,0,0,0,0,0,0,0
155415,2021,Serbia,USA,0,0,0,0,31/05/2021,0,0,4,4,0,0,0,0,0,0,0,0,5,1,13,19,22,0,1,23
155415,2021,Brazil,USA,0,0,0,0,27/05/2021,0,0,0,0,0,0,0,0,0,0,0,0,0,0,0,0,0,0,0,0
155415,2021,USA,Canada,0,0,0,0,26/05/2021,0,0,0,0,0,0,0,0,0,0,0,0,0,0,0,0,0,0,0,0
155415,2021,Dominican Republic,USA,0,0,0,0,25/05/2021,0,0,0,0,0,0,0,0,0,0,0,0,0,0,0,0,0,0,0,0
140052,2021,Brazil,USA,0,2,11,13,25/06/2021,0,0,0,0,7,2,5,14,1,5,5,11,0,0,0,0,3,2,0,5
140052,2021,USA,Türkiye,1,0,10,11,24/06/2021,0,0,1,1,6,0,4,10,0,4,3,7,0,0,0,0,2,2,0,4
140052,2021,China,USA,0,1,2,3,20/06/2021,0,0,0,0,2,0,0,2,1,1,0,2,0,0,0,0,0,0,0,0
140052,2021,USA,Russia,1,1,13,15,19/06/2021,0,0,1,1,13,1,6,20,4,5,9,18,0,0,0,0,0,1,2,3
140052,2021,Poland,USA,0,0,0,0,18/06/2021,0,0,0,0,0,0,0,0,0,0,0,0,0,0,0,0,0,0,0,0
140052,2021,USA,Türkiye,2,1,15,18,14/06/2021,0,0,0,0,8,0,2,10,2,6,5,13,0,0,0,0,1,0,0,1
140052,2021,USA,Japan,0,0,6,6,13/06/2021,0,0,0,0,7,0,6,13,1,4,4,9,0,0,0,0,0,2,0,2
140052,2021,USA,Belgium,0,0,0,0,12/6/2021,0,0,0,0,0,0,0,0,0,0,0,0,0,0,0,0,0,0,0,0
140052,2021,Italy,USA,2,2,10,14,8/6/2021,0,0,0,0,6,1,5,12,1,6,7,14,0,0,0,0,2,0,1,3
140052,2021,Korea,USA,5,1,9,15,7/6/2021,0,0,3,3,7,0,3,10,3,4,5,12,0,0,1,1,4,0,0,4
140052,2021,Thailand,USA,1,1,7,9,2/6/2021,0,0,0,0,6,0,4,10,1,3,2,6,0,0,1,1,0,1,0,1
140052,2021,USA,Netherlands,0,0,0,0,1/6/2021,0,0,0,0,0,0,0,0,0,0,0,0,0,0,0,0,0,0,0,0
140052,2021,Serbia,USA,1,3,10,14,31/05/2021,0,0,0,0,6,1,5,12,4,4,5,13,0,0,0,0,4,1,0,5
140052,2021,Brazil,USA,0,2,10,12,27/05/2021,0,0,0,0,9,1,5,15,1,5,9,15,0,0,0,0,3,0,0,3
140052,2021,USA,Canada,0,0,0,0,26/05/2021,0,0,0,0,0,0,0,0,0,0,0,0,0,0,0,0,0,0,0,0
140052,2021,Dominican Republic,USA,0,0,0,0,25/05/2021,0,0,0,0,0,0,0,0,0,0,0,0,0,0,0,0,0,0,0,0
141933,2021,Brazil,USA,0,0,2,2,25/06/2021,0,0,0,0,0,0,0,0,0,0,0,0,0,0,0,0,0,0,0,0
141933,2021,USA,Türkiye,0,0,5,5,24/06/2021,0,0,1,1,7,3,5,15,0,0,0,0,1,0,2,3,4,1,0,5
141933,2021,China,USA,0,1,7,8,20/06/2021,0,0,3,3,9,4,12,25,0,2,0,2,3,1,1,5,5,2,1,8
141933,2021,USA,Russia,2,1,15,18,19/06/2021,0,0,9,9,11,3,17,31,3,3,3,9,13,0,10,23,10,2,4,16
141933,2021,Poland,USA,0,0,0,0,18/06/2021,0,0,0,0,0,0,0,0,0,0,0,0,0,0,0,0,0,0,0,0
141933,2021,USA,Türkiye,0,0,0,0,14/06/2021,0,0,0,0,0,0,0,0,0,0,0,0,0,0,0,0,0,0,0,0
141933,2021,USA,Japan,2,3,11,16,13/06/2021,0,1,0,1,11,3,14,28,1,2,5,8,14,1,13,28,15,1,0,16
141933,2021,USA,Belgium,1,1,9,11,12/6/2021,0,0,1,1,12,2,16,30,1,2,3,6,3,1,7,11,16,3,0,19
141933,2021,Italy,USA,1,3,9,13,8/6/2021,0,0,7,7,9,6,17,32,1,3,2,6,5,0,4,9,14,1,1,16
141933,2021,Germany,USA,3,2,10,15,6/6/2021,0,0,4,4,12,6,8,26,2,0,1,3,5,0,8,13,4,2,0,6
141933,2021,Thailand,USA,0,0,0,0,2/6/2021,0,0,0,0,0,0,0,0,0,0,0,0,0,0,0,0,0,0,0,0
141933,2021,USA,Netherlands,2,0,14,16,1/6/2021,0,0,4,4,10,5,13,28,1,2,0,3,9,0,10,19,15,0,1,16
141933,2021,Serbia,USA,0,0,0,0,31/05/2021,0,0,0,0,0,0,0,0,0,0,0,0,0,0,0,0,0,0,0,0
166638,2021,Brazil,USA,0,0,0,0,25/06/2021,0,0,0,0,0,0,0,0,0,0,0,0,0,0,0,0,0,0,0,0
166638,2021,USA,Türkiye,0,0,0,0,24/06/2021,0,0,0,0,0,0,0,0,0,0,0,0,0,0,0,0,0,0,0,0
166638,2021,USA,Russia,2,5,10,17,19/06/2021,0,0,0,0,7,0,1,8,2,7,6,15,0,0,1,1,0,0,1,1
166638,2021,Poland,USA,0,0,0,0,18/06/2021,0,0,0,0,0,0,0,0,0,0,0,0,0,0,0,0,0,0,0,0
166638,2021,USA,Türkiye,0,0,0,0,14/06/2021,0,0,0,0,0,0,0,0,0,0,0,0,0,0,0,0,0,0,0,0
166638,2021,USA,Japan,0,2,5,7,13/06/2021,0,0,0,0,3,1,5,9,4,3,11,18,0,0,0,0,2,0,1,3
166638,2021,USA,Belgium,0,2,4,6,12/6/2021,0,1,0,1,4,0,3,7,2,2,4,8,0,0,0,0,1,0,0,1
166638,2021,Korea,USA,0,1,9,10,7/6/2021,0,0,0,0,5,1,1,7,4,1,7,12,0,0,0,0,1,0,1,2
166638,2021,Germany,USA,0,2,9,11,6/6/2021,0,0,1,1,5,0,2,7,1,3,4,8,0,0,0,0,0,1,0,1
166638,2021,Thailand,USA,0,0,0,0,2/6/2021,0,0,0,0,0,0,0,0,0,0,0,0,0,0,0,0,0,0,0,0
166638,2021,Serbia,USA,1,5,2,8,31/05/2021,0,0,0,0,6,0,8,14,2,7,6,15,0,0,0,0,2,1,0,3
160209,2022,Belgium,Japan,0,0,0,0,3/7/2022,0,0,2,2,0,0,0,0,0,0,0,0,0,0,0,0,0,0,0,0
160209,2022,Belgium,Netherlands,0,0,0,0,1/7/2022,0,0,0,0,0,0,0,0,0,1,0,1,0,0,0,0,0,0,0,0
160209,2022,Germany,Belgium,0,0,0,0,30/06/2022,0,0,1,1,0,0,0,0,0,0,0,0,0,0,0,0,0,0,0,0
160209,2022,Belgium,USA,0,0,1,1,30/06/2022,1,0,11,12,0,0,0,0,0,1,0,1,0,0,0,0,1,0,0,1
160209,2022,Türkiye,Belgium,0,0,1,1,5/6/2022,7,1,14,22,0,0,1,1,0,2,2,4,0,0,0,0,2,0,1,3
160209,2022,Thailand,Belgium,0,0,0,0,4/6/2022,0,0,2,2,0,0,0,0,0,0,2,2,0,0,0,0,0,0,0,0
160209,2022,Belgium,Italy,0,0,3,3,2/6/2022,1,0,14,15,0,0,1,1,0,0,0,0,0,0,0,0,1,0,0,1
160209,2022,Belgium,Serbia,0,0,0,0,1/6/2022,1,0,0,1,0,0,0,0,0,1,0,1,0,0,0,0,0,0,0,0
152042,2022,Belgium,Japan,0,3,14,17,3/7/2022,0,0,7,7,29,3,35,67,0,2,1,3,8,0,7,15,11,1,0,12
152042,2022,Belgium,Netherlands,2,2,12,16,1/7/2022,0,1,4,5,28,11,47,86,1,3,0,4,16,1,19,36,6,1,0,7
152042,2022,Germany,Belgium,0,1,13,14,30/06/2022,0,0,6,6,33,6,43,82,1,2,1,4,2,0,9,11,8,2,0,10
152042,2022,Belgium,USA,1,0,11,12,30/06/2022,0,0,3,3,16,5,16,37,1,4,0,5,5,0,8,13,2,3,0,5
152042,2022,Bulgaria,Belgium,0,3,21,24,19/06/2022,0,0,2,2,23,11,50,84,3,4,5,12,7,1,27,35,12,3,1,16
152042,2022,Belgium,Poland,0,2,14,16,18/06/2022,1,0,2,3,33,8,43,84,0,0,6,6,4,1,9,14,7,0,1,8
152042,2022,Canada,Belgium,1,0,11,12,16/06/2022,0,0,1,1,24,4,31,59,4,1,2,7,1,0,7,8,7,5,0,12
152042,2022,China,Belgium,1,0,4,5,15/06/2022,0,0,1,1,5,4,2,11,0,0,0,0,0,0,0,0,0,1,0,1
152042,2022,Türkiye,Belgium,1,1,12,14,5/6/2022,0,0,2,2,18,9,32,59,1,1,2,4,6,0,20,26,11,2,2,15
152042,2022,Thailand,Belgium,0,1,21,22,4/6/2022,0,0,3,3,22,10,34,66,1,3,5,9,4,0,15,19,14,4,1,19
152042,2022,Belgium,Italy,0,4,10,14,2/6/2022,0,0,1,1,24,6,25,55,2,4,1,7,2,1,23,26,7,4,1,12
152042,2022,Belgium,Serbia,3,2,10,15,1/6/2022,0,0,2,2,27,6,42,75,1,3,4,8,5,1,18,24,4,1,1,6
135880,2022,Belgium,Japan,0,0,16,16,3/7/2022,0,0,2,2,6,2,3,11,2,9,4,15,0,0,0,0,2,0,0,2
135880,2022,Belgium,Netherlands,0,1,11,12,1/7/2022,0,0,1,1,0,0,5,5,2,3,3,8,0,0,0,0,0,1,0,1
135880,2022,Germany,Belgium,0,2,8,10,30/06/2022,0,0,1,1,5,1,4,10,1,5,1,7,0,0,0,0,3,1,0,4
135880,2022,Belgium,USA,0,0,0,0,30/06/2022,0,0,0,0,0,0,0,0,0,0,0,0,0,0,0,0,0,0,0,0
135880,2022,Bulgaria,Belgium,0,1,8,9,19/06/2022,0,0,6,6,5,3,4,12,3,1,7,11,0,0,0,0,1,0,0,1
135880,2022,Belgium,Poland,0,1,15,16,18/06/2022,0,0,2,2,6,0,5,11,2,4,4,10,0,0,1,1,3,1,0,4
135880,2022,Canada,Belgium,1,0,18,19,16/06/2022,0,0,2,2,1,1,4,6,0,3,5,8,0,0,0,0,3,0,0,3
135880,2022,China,Belgium,0,0,0,0,15/06/2022,0,0,0,0,0,0,0,0,0,0,0,0,0,0,0,0,0,0,0,0
135880,2022,Türkiye,Belgium,2,0,10,12,5/6/2022,1,0,2,3,5,0,6,11,2,6,9,17,0,0,0,0,2,0,2,4
135880,2022,Thailand,Belgium,0,1,10,11,4/6/2022,0,0,2,2,10,0,1,11,0,8,7,15,0,0,0,0,2,1,0,3
135880,2022,Belgium,Italy,0,1,9,10,2/6/2022,0,0,3,3,4,2,4,10,4,3,8,15,0,0,0,0,2,2,1,5
135880,2022,Belgium,Serbia,0,0,4,4,1/6/2022,0,0,2,2,1,0,2,3,1,3,4,8,0,0,0,0,0,1,0,1
156326,2022,Belgium,Japan,0,0,6,6,3/7/2022,0,0,1,1,3,5,10,18,0,2,1,3,12,0,12,24,5,1,1,7
156326,2022,Belgium,Netherlands,0,2,12,14,1/7/2022,0,0,3,3,12,4,16,32,1,1,2,4,14,3,25,42,16,1,1,18
156326,2022,Germany,Belgium,0,2,15,17,30/06/2022,0,0,4,4,8,2,8,18,0,1,0,1,9,2,16,27,12,1,0,13
156326,2022,Belgium,USA,2,0,8,10,30/06/2022,0,0,0,0,4,4,14,22,0,3,0,3,7,0,17,24,2,0,0,2
156326,2022,Bulgaria,Belgium,1,1,13,15,19/06/2022,1,0,3,4,5,8,10,23,0,2,2,4,7,0,29,36,10,4,3,17
156326,2022,Belgium,Poland,0,1,12,13,18/06/2022,0,0,3,3,3,5,4,12,0,4,0,4,4,2,17,23,15,4,0,19
156326,2022,Canada,Belgium,1,1,9,11,16/06/2022,0,0,1,1,5,2,10,17,1,3,4,8,4,1,13,18,6,3,0,9
156326,2022,China,Belgium,0,1,11,12,15/06/2022,0,0,2,2,7,3,9,19,0,1,2,3,5,1,10,16,4,3,1,8
181274,2022,,,-,-,-,-,-,-,-,-,-,-,-,-,-,-,-,-,-,-,-,-,-,-,-,-,-
151117,2022,Belgium,Japan,0,0,0,0,3/7/2022,0,0,0,0,0,0,0,0,0,0,0,0,0,0,0,0,0,0,0,0
151117,2022,Belgium,Netherlands,0,0,0,0,1/7/2022,0,0,0,0,0,0,0,0,0,0,0,0,0,0,0,0,0,0,0,0
151117,2022,Germany,Belgium,0,0,0,0,30/06/2022,0,0,0,0,0,0,0,0,0,0,0,0,0,0,0,0,0,0,0,0
151117,2022,Belgium,USA,0,0,0,0,30/06/2022,0,0,0,0,0,0,0,0,0,0,0,0,0,0,0,0,0,0,0,0
151117,2022,Bulgaria,Belgium,0,0,4,4,19/06/2022,0,0,0,0,0,0,3,3,0,1,2,3,2,0,6,8,7,4,0,11
151117,2022,Belgium,Poland,1,0,19,20,18/06/2022,0,0,6,6,5,3,17,25,1,5,4,10,2,0,14,16,11,0,0,11
151117,2022,Canada,Belgium,2,1,16,19,16/06/2022,0,0,3,3,12,2,8,22,2,4,1,7,4,1,24,29,11,7,0,18
151117,2022,China,Belgium,1,2,5,8,15/06/2022,0,0,1,1,10,5,13,28,0,0,1,1,7,1,36,44,8,0,0,8
151117,2022,Türkiye,Belgium,0,1,9,10,5/6/2022,0,0,3,3,8,9,14,31,1,0,3,4,8,1,17,26,15,3,5,23
151117,2022,Thailand,Belgium,0,0,12,12,4/6/2022,0,1,2,3,12,3,29,44,1,3,5,9,11,1,22,34,24,3,1,28
151117,2022,Belgium,Italy,0,1,14,15,2/6/2022,0,0,0,0,8,7,17,32,1,2,1,4,10,2,20,32,6,5,1,12
151117,2022,Belgium,Serbia,1,1,14,16,1/6/2022,0,0,3,3,8,6,21,35,0,4,4,8,5,1,24,30,10,3,5,18
146631,2022,,,-,-,-,-,-,-,-,-,-,-,-,-,-,-,-,-,-,-,-,-,-,-,-,-,-
181275,2022,Belgium,Japan,0,0,0,0,3/7/2022,0,0,0,0,0,0,0,0,0,0,0,0,0,0,0,0,1,0,0,1
181275,2022,Belgium,Netherlands,0,0,0,0,1/7/2022,0,0,7,7,0,0,0,0,0,0,0,0,0,0,1,1,10,4,0,14
181275,2022,Germany,Belgium,0,0,0,0,30/06/2022,0,0,2,2,0,0,0,0,0,0,0,0,0,0,3,3,5,1,0,6
181275,2022,Belgium,USA,0,0,0,0,30/06/2022,0,0,4,4,0,0,0,0,0,0,0,0,0,0,0,0,3,4,0,7
181275,2022,Bulgaria,Belgium,0,0,0,0,19/06/2022,0,0,6,6,0,0,0,0,0,0,0,0,0,0,2,2,12,3,4,19
181275,2022,Belgium,Poland,0,0,0,0,18/06/2022,0,1,4,5,0,0,0,0,0,0,0,0,0,0,0,0,13,3,0,16
181275,2022,Türkiye,Belgium,0,0,0,0,5/6/2022,0,0,0,0,0,0,0,0,0,0,0,0,0,0,0,0,0,0,0,0
181275,2022,Thailand,Belgium,0,0,0,0,4/6/2022,0,0,0,0,0,0,0,0,0,0,0,0,1,0,2,3,2,0,0,2
181275,2022,Belgium,Italy,0,0,0,0,2/6/2022,0,0,0,0,0,0,0,0,0,0,0,0,0,0,0,0,0,0,0,0
181275,2022,Belgium,Serbia,0,0,0,0,1/6/2022,0,0,3,3,0,0,0,0,0,0,0,0,1,1,5,7,5,4,1,10
177099,2022,Belgium,Japan,0,0,0,0,3/7/2022,0,0,0,0,0,0,0,0,0,0,0,0,0,0,0,0,0,0,0,0
177099,2022,Belgium,Netherlands,0,0,0,0,1/7/2022,0,0,0,0,0,0,0,0,0,0,0,0,0,0,0,0,0,0,0,0
177099,2022,Germany,Belgium,0,0,0,0,30/06/2022,0,0,0,0,0,0,0,0,0,0,0,0,0,0,0,0,0,0,0,0
177099,2022,Belgium,USA,0,2,2,4,30/06/2022,0,0,0,0,5,4,6,15,0,2,1,3,0,0,0,0,4,0,1,5
177099,2022,Bulgaria,Belgium,1,0,4,5,19/06/2022,0,0,2,2,4,3,2,9,0,0,2,2,0,0,0,0,5,1,0,6
177099,2022,Belgium,Poland,0,0,0,0,18/06/2022,0,0,0,0,0,0,0,0,0,0,0,0,0,0,0,0,0,0,0,0
177099,2022,Canada,Belgium,0,1,0,1,16/06/2022,0,0,0,0,2,3,0,5,2,1,1,4,1,0,0,1,1,0,0,1
177099,2022,China,Belgium,0,1,5,6,15/06/2022,0,0,2,2,11,4,8,23,0,0,1,1,0,0,0,0,5,2,0,7
177099,2022,Türkiye,Belgium,0,2,7,9,5/6/2022,0,0,1,1,12,3,10,25,1,1,1,3,0,0,0,0,3,4,1,8
177099,2022,Thailand,Belgium,0,0,0,0,4/6/2022,0,0,0,0,0,0,0,0,0,0,0,0,0,0,0,0,0,0,0,0
177099,2022,Belgium,Italy,2,1,13,16,2/6/2022,1,1,1,3,9,4,10,23,0,1,2,3,0,0,0,0,4,2,3,9
177099,2022,Belgium,Serbia,0,0,0,0,1/6/2022,0,0,0,0,0,0,0,0,0,0,0,0,0,0,0,0,0,0,0,0
166072,2022,Bulgaria,Belgium,0,0,0,0,19/06/2022,0,0,0,0,0,0,0,0,0,0,0,0,0,0,0,0,0,0,0,0
166072,2022,Belgium,Poland,0,0,0,0,18/06/2022,0,0,0,0,0,0,0,0,0,0,0,0,0,0,0,0,0,0,0,0
166072,2022,Canada,Belgium,0,0,0,0,16/06/2022,0,0,0,0,0,0,0,0,0,0,0,0,0,0,0,0,0,0,0,0
166072,2022,China,Belgium,0,1,6,7,15/06/2022,0,0,1,1,4,1,5,10,0,3,4,7,0,0,0,0,3,4,0,7
166072,2022,Türkiye,Belgium,0,0,2,2,5/6/2022,0,0,1,1,1,0,1,2,0,0,0,0,0,1,0,1,0,0,1,1
166072,2022,Thailand,Belgium,0,0,0,0,4/6/2022,0,0,0,0,0,0,0,0,0,0,0,0,0,0,0,0,0,0,0,0
166072,2022,Belgium,Italy,0,0,0,0,2/6/2022,0,0,0,0,0,0,0,0,0,0,0,0,0,0,0,0,0,0,0,0
166072,2022,Belgium,Serbia,0,0,0,0,1/6/2022,0,0,0,0,0,0,0,0,0,0,0,0,0,0,0,0,0,0,0,0
160479,2022,Belgium,Japan,0,0,1,1,3/7/2022,0,0,8,8,0,1,0,1,1,0,0,1,0,0,0,0,0,0,0,0
160479,2022,Belgium,Netherlands,0,0,1,1,1/7/2022,0,0,13,13,0,0,1,1,0,0,0,0,0,0,0,0,0,2,0,2
160479,2022,Germany,Belgium,0,1,2,3,30/06/2022,1,0,39,40,1,0,1,2,0,1,0,1,0,0,0,0,2,1,0,3
160479,2022,Belgium,USA,0,0,0,0,30/06/2022,0,0,0,0,0,0,0,0,0,0,0,0,0,0,0,0,0,0,0,0
160479,2022,Bulgaria,Belgium,1,2,6,9,19/06/2022,10,1,47,58,1,0,1,2,1,1,6,8,0,0,0,0,6,2,2,10
160479,2022,Belgium,Poland,0,0,9,9,18/06/2022,13,0,66,79,1,0,0,1,0,4,3,7,0,0,0,0,9,2,1,12
160479,2022,Canada,Belgium,0,0,4,4,16/06/2022,2,0,26,28,1,0,0,1,0,1,1,2,0,0,0,0,1,1,0,2
160479,2022,China,Belgium,0,0,6,6,15/06/2022,11,2,45,58,1,0,0,1,0,0,0,0,0,0,0,0,10,0,1,11
160479,2022,Türkiye,Belgium,0,0,0,0,5/6/2022,0,0,0,0,0,0,0,0,0,0,0,0,0,0,0,0,0,0,0,0
160479,2022,Thailand,Belgium,0,0,0,0,4/6/2022,0,1,1,2,1,0,0,1,0,0,0,0,0,0,0,0,0,0,0,0
160479,2022,Belgium,Italy,0,0,0,0,2/6/2022,0,0,0,0,0,0,0,0,0,0,0,0,0,0,0,0,0,0,0,0
160479,2022,Belgium,Serbia,0,0,0,0,1/6/2022,2,0,2,4,1,0,0,1,0,0,0,0,0,0,0,0,0,0,0,0
156325,2022,Belgium,Japan,0,3,10,13,3/7/2022,0,0,2,2,7,2,16,25,4,7,3,14,0,0,0,0,3,0,0,3
156325,2022,Belgium,Netherlands,1,2,8,11,1/7/2022,0,0,2,2,8,1,8,17,4,3,6,13,0,0,0,0,2,0,0,2
156325,2022,Germany,Belgium,2,2,10,14,30/06/2022,0,0,3,3,6,1,6,13,3,2,1,6,0,0,1,1,3,0,0,3
156325,2022,Belgium,USA,1,3,6,10,30/06/2022,0,0,1,1,4,3,7,14,2,1,1,4,1,0,0,1,2,1,0,3
156325,2022,Bulgaria,Belgium,1,5,10,16,19/06/2022,0,0,0,0,8,0,8,16,1,2,5,8,0,0,0,0,5,0,0,5
156325,2022,Belgium,Poland,1,2,10,13,18/06/2022,1,0,0,1,6,4,7,17,5,6,7,18,0,0,0,0,7,3,0,10
156325,2022,Canada,Belgium,0,2,9,11,16/06/2022,2,0,6,8,5,3,4,12,3,3,1,7,0,0,0,0,1,0,1,2
156325,2022,China,Belgium,0,0,0,0,15/06/2022,0,0,0,0,0,0,0,0,0,0,0,0,0,0,0,0,0,0,0,0
156325,2022,Türkiye,Belgium,0,0,0,0,5/6/2022,0,0,0,0,0,0,0,0,0,0,0,0,0,0,0,0,0,0,0,0
156325,2022,Thailand,Belgium,1,2,11,14,4/6/2022,0,0,1,1,9,3,4,16,4,4,9,17,0,0,0,0,4,2,0,6
156325,2022,Belgium,Italy,0,0,0,0,2/6/2022,0,0,0,0,0,0,0,0,0,0,0,0,0,0,0,0,0,0,0,0
156325,2022,Belgium,Serbia,1,1,11,13,1/6/2022,0,0,3,3,10,0,14,24,6,1,3,10,0,0,1,1,1,1,1,3
189124,2022,,,-,-,-,-,-,-,-,-,-,-,-,-,-,-,-,-,-,-,-,-,-,-,-,-,-
160208,2022,Belgium,Japan,2,2,10,14,3/7/2022,9,0,117,126,1,0,1,2,0,1,2,3,0,0,0,0,11,0,0,11
160208,2022,Belgium,Netherlands,0,2,16,18,1/7/2022,5,0,127,132,1,0,1,2,0,0,1,1,0,0,1,1,14,5,0,19
160208,2022,Germany,Belgium,0,0,10,10,30/06/2022,6,1,82,89,0,0,4,4,0,2,0,2,0,0,1,1,2,1,0,3
160208,2022,Belgium,USA,0,0,8,8,30/06/2022,0,1,81,82,1,0,0,1,1,0,0,1,0,0,1,1,7,2,0,9
160208,2022,Bulgaria,Belgium,2,1,10,13,19/06/2022,19,1,70,90,2,0,0,2,0,0,2,2,0,0,0,0,11,1,0,12
160208,2022,Belgium,Poland,0,0,4,4,18/06/2022,8,0,47,55,0,0,2,2,0,1,0,1,0,0,0,0,5,3,0,8
160208,2022,Canada,Belgium,0,2,12,14,16/06/2022,4,2,57,63,0,0,1,1,1,0,0,1,0,0,0,0,9,3,3,15
160208,2022,China,Belgium,0,0,3,3,15/06/2022,6,1,21,28,0,0,0,0,0,2,0,2,0,0,0,0,0,2,1,3
160208,2022,Türkiye,Belgium,1,2,14,17,5/6/2022,38,1,56,95,0,0,0,0,0,1,1,2,0,0,0,0,5,1,3,9
160208,2022,Thailand,Belgium,1,2,19,22,4/6/2022,43,2,93,138,2,0,2,4,0,2,2,4,0,0,1,1,11,2,4,17
160208,2022,Belgium,Italy,1,2,11,14,2/6/2022,7,1,95,103,0,0,1,1,0,3,2,5,0,0,0,0,8,0,1,9
160208,2022,Belgium,Serbia,0,1,12,13,1/6/2022,27,1,106,134,0,0,1,1,0,1,4,5,0,0,0,0,5,2,2,9
152046,2022,,,-,-,-,-,-,-,-,-,-,-,-,-,-,-,-,-,-,-,-,-,-,-,-,-,-
168160,2022,Belgium,Japan,0,0,0,0,3/7/2022,0,0,5,5,0,0,0,0,0,0,1,1,9,0,7,16,15,2,0,17
168160,2022,Belgium,Netherlands,0,0,0,0,1/7/2022,0,0,7,7,0,0,0,0,0,0,0,0,4,0,4,8,14,1,0,15
168160,2022,Germany,Belgium,0,0,0,0,30/06/2022,0,0,9,9,0,0,0,0,0,0,0,0,14,2,26,42,14,3,1,18
168160,2022,Belgium,USA,0,0,0,0,30/06/2022,0,0,4,4,0,0,0,0,0,0,0,0,9,2,16,27,5,1,0,6
168160,2022,Bulgaria,Belgium,0,0,0,0,19/06/2022,0,1,6,7,0,0,0,0,0,0,0,0,3,0,14,17,7,1,1,9
168160,2022,Belgium,Poland,0,0,0,0,18/06/2022,0,0,11,11,0,0,0,0,0,0,0,0,5,3,29,37,13,3,1,17
168160,2022,Canada,Belgium,0,0,0,0,16/06/2022,0,0,12,12,0,0,0,0,0,0,0,0,6,2,19,27,7,9,1,17
168160,2022,China,Belgium,0,0,0,0,15/06/2022,0,0,10,10,0,0,0,0,0,0,0,0,4,0,5,9,13,6,1,20
168160,2022,Türkiye,Belgium,0,0,0,0,5/6/2022,0,0,9,9,0,0,0,0,0,0,0,0,5,1,21,27,12,1,1,14
168160,2022,Thailand,Belgium,0,0,0,0,4/6/2022,1,0,12,13,0,0,0,0,0,0,0,0,9,1,27,37,11,7,2,20
168160,2022,Belgium,Italy,0,0,0,0,2/6/2022,0,0,5,5,0,0,0,0,0,0,0,0,6,1,17,24,9,4,2,15
168160,2022,Belgium,Serbia,0,0,0,0,1/6/2022,0,0,3,3,0,0,0,0,0,0,0,0,3,0,11,14,7,1,0,8
152040,2022,Belgium,Japan,0,0,8,8,3/7/2022,0,0,0,0,6,0,12,18,2,3,0,5,0,0,0,0,4,2,0,6
152040,2022,Belgium,Netherlands,0,0,12,12,1/7/2022,0,0,3,3,11,3,9,23,1,2,3,6,0,0,0,0,11,2,0,13
152040,2022,Germany,Belgium,1,2,13,16,30/06/2022,0,0,1,1,8,0,15,23,0,2,0,2,0,0,0,0,11,4,0,15
152040,2022,Belgium,USA,0,1,8,9,30/06/2022,0,0,0,0,6,0,7,13,1,2,0,3,0,0,1,1,2,0,0,2
152040,2022,Bulgaria,Belgium,1,1,6,8,19/06/2022,0,0,1,1,9,3,14,26,3,8,8,19,0,0,0,0,9,1,2,12
152040,2022,Belgium,Poland,1,1,2,4,18/06/2022,0,0,0,0,4,0,3,7,0,3,5,8,0,0,0,0,1,0,0,1
152040,2022,Türkiye,Belgium,0,2,11,13,5/6/2022,1,1,1,3,6,1,7,14,1,2,4,7,1,0,0,1,6,0,1,7
152040,2022,Thailand,Belgium,3,1,15,19,4/6/2022,1,0,2,3,11,3,8,22,2,1,6,9,0,0,0,0,6,1,4,11
152040,2022,Belgium,Italy,1,0,12,13,2/6/2022,0,0,0,0,7,3,9,19,2,8,4,14,0,0,1,1,1,1,0,2
152040,2022,Belgium,Serbia,0,1,8,9,1/6/2022,0,0,0,0,3,1,14,18,0,5,4,9,0,0,0,0,3,0,0,3
170706,2022,,,-,-,-,-,-,-,-,-,-,-,-,-,-,-,-,-,-,-,-,-,-,-,-,-,-
152057,2022,Belgium,Japan,3,1,13,17,3/7/2022,0,0,1,1,7,0,9,16,2,2,2,6,17,3,11,31,9,3,0,12
152057,2022,Belgium,Netherlands,0,1,3,4,1/7/2022,0,1,0,1,0,0,0,0,0,0,0,0,0,0,0,0,1,1,0,2
152057,2022,Germany,Belgium,1,0,1,2,30/06/2022,0,0,0,0,0,0,0,0,0,0,0,0,0,0,0,0,0,0,0,0
152057,2022,Belgium,USA,0,0,4,4,30/06/2022,0,0,1,1,0,0,1,1,0,0,0,0,1,0,0,1,1,0,0,1
152057,2022,Bulgaria,Belgium,1,1,2,4,19/06/2022,0,0,0,0,0,0,1,1,0,0,0,0,0,0,0,0,2,0,0,2
152057,2022,Belgium,Poland,2,0,5,7,18/06/2022,0,0,0,0,0,0,0,0,0,0,0,0,0,0,0,0,0,1,0,1
152057,2022,Türkiye,Belgium,0,1,4,5,5/6/2022,0,0,0,0,0,0,0,0,0,0,0,0,0,0,0,0,2,2,1,5
152057,2022,Thailand,Belgium,1,1,4,6,4/6/2022,0,0,1,1,0,1,1,2,0,1,2,3,0,0,2,2,5,2,1,8
152057,2022,Belgium,Italy,0,1,1,2,2/6/2022,0,0,1,1,0,0,0,0,0,0,0,0,0,1,0,1,0,0,0,0
152057,2022,Belgium,Serbia,0,2,9,11,1/6/2022,0,0,0,0,4,1,6,11,1,1,2,4,3,0,5,8,0,1,0,1
170698,2022,Belgium,Japan,0,0,1,1,3/7/2022,0,0,0,0,0,0,0,0,0,0,0,0,0,0,0,0,0,0,0,0
170698,2022,Belgium,Netherlands,0,0,3,3,1/7/2022,0,0,0,0,0,0,1,1,0,0,0,0,0,0,1,1,0,0,0,0
170698,2022,Germany,Belgium,0,0,0,0,30/06/2022,0,0,0,0,0,0,0,0,0,0,0,0,0,0,0,0,0,0,0,0
170698,2022,Belgium,USA,0,0,0,0,30/06/2022,0,0,0,0,0,0,0,0,0,0,0,0,0,0,0,0,0,0,0,0
170698,2022,Bulgaria,Belgium,0,0,0,0,19/06/2022,0,0,0,0,0,0,0,0,0,0,0,0,0,0,0,0,0,0,0,0
170698,2022,Belgium,Poland,0,0,0,0,18/06/2022,0,0,0,0,0,0,0,0,0,0,0,0,0,0,0,0,0,0,0,0
170698,2022,Canada,Belgium,0,0,0,0,16/06/2022,0,0,0,0,0,0,0,0,0,0,1,1,0,0,0,0,0,0,0,0
170698,2022,China,Belgium,0,1,8,9,15/06/2022,0,0,0,0,6,2,3,11,0,1,2,3,0,0,1,1,1,2,0,3
170698,2022,Türkiye,Belgium,0,0,0,0,5/6/2022,0,0,0,0,0,0,0,0,0,0,0,0,0,0,0,0,0,0,0,0
170698,2022,Thailand,Belgium,0,0,0,0,4/6/2022,0,0,0,0,0,0,0,0,0,0,0,0,0,0,0,0,0,0,0,0
170698,2022,Belgium,Italy,0,0,1,1,2/6/2022,0,0,0,0,0,0,0,0,0,0,0,0,0,0,0,0,0,0,0,0
170698,2022,Belgium,Serbia,0,0,0,0,1/6/2022,0,0,0,0,0,0,0,0,0,0,0,0,0,0,0,0,0,0,0,0
152088,2022,,,-,-,-,-,-,-,-,-,-,-,-,-,-,-,-,-,-,-,-,-,-,-,-,-,-
186026,2022,,,-,-,-,-,-,-,-,-,-,-,-,-,-,-,-,-,-,-,-,-,-,-,-,-,-
168161,2022,,,-,-,-,-,-,-,-,-,-,-,-,-,-,-,-,-,-,-,-,-,-,-,-,-,-
181681,2022,,,-,-,-,-,-,-,-,-,-,-,-,-,-,-,-,-,-,-,-,-,-,-,-,-,-
123728,2022,,,-,-,-,-,-,-,-,-,-,-,-,-,-,-,-,-,-,-,-,-,-,-,-,-,-
140418,2022,,,-,-,-,-,-,-,-,-,-,-,-,-,-,-,-,-,-,-,-,-,-,-,-,-,-
152119,2022,Brazil,Serbia,0,0,9,9,19/06/2022,0,0,0,0,2,1,4,7,3,2,6,11,0,0,0,0,2,0,0,2
152119,2022,Italy,Brazil,2,2,10,14,18/06/2022,0,0,0,0,1,2,3,6,2,3,0,5,1,0,0,1,2,0,0,2
152119,2022,Netherlands,Brazil,0,0,7,7,17/06/2022,0,0,2,2,2,2,2,6,3,1,5,9,0,0,0,0,1,0,0,1
152119,2022,Brazil,Türkiye,3,1,13,17,16/06/2022,0,0,3,3,4,0,5,9,2,0,0,2,0,0,0,0,1,1,1,3
152119,2022,USA,Brazil,0,0,0,0,5/6/2022,0,0,0,0,0,0,0,0,0,0,0,0,0,0,0,0,0,0,0,0
152119,2022,Dominican Republic,Brazil,0,0,0,0,3/6/2022,0,0,0,0,0,0,0,0,0,0,0,0,0,0,0,0,0,0,0,0
152119,2022,Brazil,Poland,0,1,8,9,2/6/2022,0,0,1,1,6,1,2,9,2,2,2,6,0,0,0,0,4,0,0,4
152119,2022,Germany,Brazil,0,0,8,8,31/05/2022,0,0,2,2,7,1,2,10,4,4,5,13,0,0,0,0,7,1,0,8
173848,2022,Italy,Brazil,0,0,6,6,17/07/2022,0,0,1,1,1,0,4,5,0,2,3,5,0,0,0,0,0,0,0,0
173848,2022,Serbia,Brazil,0,1,6,7,16/07/2022,0,0,2,2,3,1,2,6,3,3,2,8,1,0,1,2,1,0,0,1
173848,2022,Brazil,Japan,1,2,11,14,13/07/2022,0,0,1,1,1,1,4,6,3,3,5,11,0,0,0,0,2,0,2,4
173848,2022,Brazil,Thailand,0,0,12,12,2/7/2022,0,0,0,0,10,1,6,17,2,4,2,8,0,0,0,0,3,2,1,6
173848,2022,Brazil,Bulgaria,0,1,9,10,1/7/2022,0,0,2,2,8,1,0,9,3,2,1,6,0,0,0,0,3,0,0,3
173848,2022,Korea,Brazil,1,0,8,9,30/06/2022,2,0,0,2,7,0,3,10,2,4,4,10,0,0,0,0,5,0,0,5
173848,2022,China,Brazil,0,1,7,8,28/06/2022,1,0,1,2,5,2,3,10,1,6,5,12,0,0,0,0,3,0,1,4
173848,2022,Brazil,Serbia,0,0,0,0,19/06/2022,0,0,0,0,0,0,0,0,0,0,0,0,0,0,0,0,0,0,0,0
173848,2022,Italy,Brazil,0,0,0,0,18/06/2022,0,0,0,0,0,0,0,0,0,0,0,0,0,0,0,0,0,0,0,0
173848,2022,Netherlands,Brazil,0,1,0,1,17/06/2022,0,0,1,1,0,0,0,0,0,1,2,3,0,0,0,0,0,0,0,0
173848,2022,Brazil,Türkiye,0,0,0,0,16/06/2022,0,0,0,0,0,0,0,0,0,0,0,0,0,0,0,0,0,0,0,0
144866,2022,Italy,Brazil,1,1,10,12,17/07/2022,0,0,1,1,6,0,2,8,1,6,4,11,0,0,0,0,0,1,1,2
144866,2022,Serbia,Brazil,0,1,17,18,16/07/2022,0,0,3,3,7,2,2,11,6,10,10,26,0,0,0,0,2,1,1,4
144866,2022,Brazil,Japan,0,1,13,14,13/07/2022,0,0,4,4,6,1,9,16,4,6,13,23,0,0,0,0,3,0,2,5
144866,2022,Brazil,Thailand,0,1,15,16,2/7/2022,0,0,0,0,12,2,5,19,4,8,2,14,0,0,0,0,1,0,0,1
144866,2022,Brazil,Bulgaria,1,1,16,18,1/7/2022,0,0,2,2,5,0,4,9,2,4,4,10,0,0,0,0,1,0,1,2
144866,2022,Korea,Brazil,3,0,12,15,30/06/2022,1,0,0,1,1,0,3,4,2,1,0,3,0,0,0,0,0,0,0,0
144866,2022,China,Brazil,1,2,13,16,28/06/2022,0,1,1,2,9,3,3,15,4,4,2,10,0,0,0,0,0,0,3,3
144866,2022,Brazil,Serbia,1,1,11,13,19/06/2022,0,0,2,2,6,0,2,8,6,4,5,15,0,0,0,0,1,2,2,5
144866,2022,Italy,Brazil,1,1,11,13,18/06/2022,0,0,1,1,6,3,2,11,2,6,4,12,1,0,1,2,2,0,0,2
144866,2022,Netherlands,Brazil,1,0,7,8,17/06/2022,0,0,3,3,4,2,1,7,2,1,6,9,0,0,0,0,0,0,0,0
144866,2022,Brazil,Türkiye,0,1,11,12,16/06/2022,0,1,2,3,8,1,3,12,6,5,4,15,0,0,0,0,0,1,1,2
144866,2022,USA,Brazil,0,1,8,9,5/6/2022,0,0,2,2,3,1,4,8,5,5,5,15,0,0,0,0,3,0,0,3
144866,2022,Dominican Republic,Brazil,0,1,11,12,3/6/2022,0,0,1,1,5,3,7,15,6,7,8,21,0,0,0,0,3,0,0,3
144866,2022,Brazil,Poland,3,2,7,12,2/6/2022,0,0,2,2,5,1,2,8,7,8,4,19,0,0,0,0,2,1,0,3
144866,2022,Germany,Brazil,1,1,21,23,31/05/2022,0,0,4,4,9,3,4,16,6,3,6,15,0,0,0,0,5,0,1,6
115970,2022,Italy,Brazil,0,0,5,5,17/07/2022,0,0,0,0,1,1,1,3,0,0,0,0,4,1,7,12,1,1,1,3
115970,2022,Serbia,Brazil,0,0,0,0,16/07/2022,0,0,0,0,0,0,0,0,0,0,0,0,0,0,0,0,0,0,0,0
115970,2022,Brazil,Japan,0,0,0,0,13/07/2022,0,0,0,0,0,0,0,0,0,0,0,0,0,0,0,0,0,0,0,0
115970,2022,Brazil,Thailand,0,0,0,0,2/7/2022,0,0,0,0,0,0,0,0,0,0,0,0,0,0,0,0,0,0,0,0
115970,2022,Brazil,Bulgaria,0,3,3,6,1/7/2022,0,0,1,1,5,5,7,17,2,3,2,7,4,1,21,26,7,2,0,9
115970,2022,Korea,Brazil,0,0,3,3,30/06/2022,1,0,0,1,7,1,4,12,1,1,2,4,2,1,3,6,3,1,0,4
115970,2022,China,Brazil,0,0,11,11,28/06/2022,0,0,5,5,8,6,5,19,1,1,1,3,4,1,19,24,7,2,5,14
115970,2022,Brazil,Serbia,0,0,7,7,19/06/2022,0,0,0,0,9,3,14,26,5,3,7,15,13,0,13,26,8,1,1,10
115970,2022,Italy,Brazil,2,0,2,4,18/06/2022,0,0,0,0,2,3,2,7,0,0,0,0,1,0,2,3,1,0,0,1
115970,2022,Netherlands,Brazil,0,1,12,13,17/06/2022,0,0,1,1,12,3,10,25,1,0,1,2,9,0,10,19,4,4,3,11
115970,2022,Brazil,Türkiye,1,1,3,5,16/06/2022,0,0,0,0,6,2,5,13,1,0,0,1,4,1,16,21,1,0,1,2
115970,2022,USA,Brazil,0,1,10,11,5/6/2022,0,0,0,0,6,1,13,20,1,3,2,6,10,0,5,15,3,3,1,7
115970,2022,Dominican Republic,Brazil,0,0,14,14,3/6/2022,0,0,0,0,8,0,10,18,0,0,1,1,7,3,1,11,5,2,0,7
115970,2022,Brazil,Poland,0,0,12,12,2/6/2022,0,0,0,0,5,4,10,19,0,1,3,4,11,1,16,28,7,2,0,9
115970,2022,Germany,Brazil,1,2,20,23,31/05/2022,0,0,2,2,11,3,16,30,1,4,3,8,6,1,3,10,9,5,0,14
152135,2022,Italy,Brazil,0,0,0,0,17/07/2022,0,0,2,2,0,0,0,0,0,0,0,0,13,1,18,32,10,3,6,19
152135,2022,Serbia,Brazil,0,0,0,0,16/07/2022,0,0,6,6,0,0,0,0,0,0,0,0,4,1,6,11,5,1,4,10
152135,2022,Brazil,Japan,0,0,0,0,13/07/2022,0,0,0,0,0,0,0,0,0,0,0,0,0,0,0,0,0,0,0,0
152135,2022,Brazil,Thailand,0,0,0,0,2/7/2022,0,0,0,0,0,0,0,0,0,0,0,0,0,0,0,0,0,0,0,0
152135,2022,Brazil,Bulgaria,0,0,0,0,1/7/2022,0,0,0,0,0,0,0,0,0,0,0,0,0,0,0,0,0,0,1,1
152135,2022,Korea,Brazil,0,0,0,0,30/06/2022,1,0,0,1,0,0,0,0,0,0,0,0,1,0,3,4,1,0,0,1
152135,2022,China,Brazil,0,0,0,0,28/06/2022,0,0,0,0,0,0,0,0,0,0,0,0,0,0,0,0,0,0,0,0
152135,2022,Brazil,Serbia,0,0,0,0,19/06/2022,0,0,7,7,0,0,0,0,0,0,0,0,10,0,4,14,15,1,1,17
152135,2022,Italy,Brazil,0,0,0,0,18/06/2022,0,0,5,5,0,0,0,0,0,0,0,0,11,0,16,27,6,5,1,12
152135,2022,Netherlands,Brazil,0,0,0,0,17/06/2022,0,0,5,5,0,0,0,0,0,0,0,0,2,2,12,16,13,1,2,16
152135,2022,Brazil,Türkiye,0,0,0,0,16/06/2022,0,0,12,12,0,0,0,0,0,0,0,0,9,1,8,18,12,7,0,19
152135,2022,USA,Brazil,0,0,0,0,5/6/2022,0,0,3,3,0,0,0,0,0,0,0,0,4,0,4,8,5,0,1,6
152135,2022,Dominican Republic,Brazil,0,0,0,0,3/6/2022,0,0,7,7,0,0,0,0,0,0,0,0,17,1,1,19,21,5,1,27
152135,2022,Brazil,Poland,0,0,0,0,2/6/2022,0,0,10,10,0,0,0,0,0,0,0,0,12,0,5,17,9,4,0,13
152135,2022,Germany,Brazil,0,0,0,0,31/05/2022,0,0,18,18,0,0,0,0,0,0,0,0,10,2,5,17,25,4,2,31
136897,2022,Italy,Brazil,0,0,2,2,17/07/2022,0,0,0,0,0,0,0,0,0,0,0,0,0,0,0,0,0,1,0,1
136897,2022,Serbia,Brazil,0,2,0,2,16/07/2022,0,0,0,0,0,0,0,0,0,0,0,0,0,0,0,0,0,0,0,0
136897,2022,Brazil,Japan,1,0,10,11,13/07/2022,0,0,1,1,0,0,0,0,0,0,0,0,0,0,0,0,1,0,0,1
136897,2022,Brazil,Thailand,0,0,1,1,2/7/2022,0,0,0,0,0,0,0,0,0,0,0,0,0,0,0,0,0,0,0,0
136897,2022,Brazil,Bulgaria,0,0,0,0,1/7/2022,0,0,0,0,0,0,0,0,0,0,0,0,0,0,0,0,0,0,0,0
136897,2022,Korea,Brazil,0,0,6,6,30/06/2022,0,0,0,0,2,0,3,5,0,0,0,0,1,0,3,4,2,1,1,4
136897,2022,China,Brazil,0,0,3,3,28/06/2022,0,0,0,0,0,0,0,0,0,0,0,0,0,0,0,0,0,1,0,1
136897,2022,Brazil,Serbia,0,0,0,0,19/06/2022,0,0,0,0,0,0,4,4,0,0,1,1,0,0,0,0,0,0,0,0
136897,2022,Italy,Brazil,0,0,2,2,18/06/2022,0,0,0,0,1,1,3,5,0,0,0,0,0,0,0,0,1,0,0,1
136897,2022,Netherlands,Brazil,0,0,2,2,17/06/2022,0,0,0,0,0,0,0,0,0,0,0,0,0,0,0,0,0,0,0,0
136897,2022,Brazil,Türkiye,0,0,2,2,16/06/2022,0,0,0,0,0,0,0,0,0,0,0,0,0,0,0,0,0,0,0,0
151187,2022,Italy,Brazil,0,0,7,7,17/07/2022,13,0,55,68,1,0,0,1,1,0,1,2,0,0,0,0,1,2,1,4
151187,2022,Serbia,Brazil,0,0,12,12,16/07/2022,24,0,69,93,1,0,2,3,0,4,3,7,0,0,0,0,7,4,4,15
151187,2022,Brazil,Japan,0,0,13,13,13/07/2022,31,3,68,102,2,0,1,3,2,4,5,11,0,0,0,0,8,3,1,12
151187,2022,Brazil,Thailand,0,0,8,8,2/7/2022,5,2,73,80,0,0,0,0,0,0,1,1,0,0,0,0,2,0,0,2
151187,2022,Brazil,Bulgaria,0,1,11,12,1/7/2022,4,0,65,69,2,0,0,2,2,3,2,7,0,1,0,1,4,0,1,5
151187,2022,Korea,Brazil,0,0,4,4,30/06/2022,31,0,0,31,0,1,0,1,1,0,0,1,0,0,0,0,2,0,1,3
151187,2022,China,Brazil,0,3,17,20,28/06/2022,36,1,76,113,1,0,4,5,0,1,1,2,0,0,0,0,4,2,2,8
151187,2022,Brazil,Serbia,0,2,9,11,19/06/2022,20,0,65,85,0,0,1,1,0,3,5,8,0,0,0,0,2,2,0,4
151187,2022,Italy,Brazil,0,1,6,7,18/06/2022,26,1,54,81,0,1,0,1,1,2,1,4,0,0,1,1,1,2,0,3
151187,2022,Netherlands,Brazil,0,0,14,14,17/06/2022,17,0,47,64,0,0,1,1,0,2,1,3,0,0,0,0,3,2,1,6
151187,2022,Brazil,Türkiye,0,1,20,21,16/06/2022,35,0,64,99,0,0,1,1,1,2,1,4,0,0,0,0,4,1,1,6
151187,2022,USA,Brazil,0,1,11,12,5/6/2022,13,0,49,62,1,1,1,3,0,1,1,2,0,0,0,0,8,1,1,10
151187,2022,Dominican Republic,Brazil,1,1,8,10,3/6/2022,26,1,61,88,0,0,2,2,0,3,1,4,0,0,0,0,8,1,0,9
151187,2022,Brazil,Poland,1,1,13,15,2/6/2022,12,0,52,64,0,1,0,1,0,1,0,1,0,0,0,0,7,1,0,8
151187,2022,Germany,Brazil,0,1,13,14,31/05/2022,23,0,95,118,1,0,0,1,0,0,0,0,0,0,1,1,17,1,0,18
119575,2022,Italy,Brazil,0,1,4,5,17/07/2022,2,0,19,21,0,0,0,0,0,0,0,0,0,0,0,0,2,0,0,2
119575,2022,Serbia,Brazil,0,0,5,5,16/07/2022,3,0,10,13,0,0,0,0,0,0,0,0,0,0,0,0,1,1,0,2
119575,2022,Brazil,Japan,0,0,5,5,13/07/2022,5,0,9,14,0,0,1,1,0,0,0,0,0,0,0,0,0,1,0,1
119575,2022,Brazil,Thailand,0,1,7,8,2/7/2022,5,0,45,50,0,0,0,0,0,1,3,4,0,0,0,0,2,0,1,3
119575,2022,Brazil,Bulgaria,0,0,3,3,1/7/2022,1,0,4,5,0,0,0,0,0,0,0,0,0,0,0,0,1,0,0,1
119575,2022,Korea,Brazil,0,0,6,6,30/06/2022,35,1,0,36,0,0,0,0,0,0,2,2,0,0,0,0,0,1,0,1
119575,2022,China,Brazil,0,0,5,5,28/06/2022,5,0,12,17,0,0,0,0,0,0,1,1,0,0,0,0,2,0,0,2
119575,2022,Brazil,Serbia,0,0,2,2,19/06/2022,2,0,4,6,0,0,0,0,0,0,0,0,0,0,0,0,0,0,0,0
119575,2022,Italy,Brazil,0,0,1,1,18/06/2022,5,0,9,14,0,0,0,0,0,0,0,0,0,0,0,0,1,1,0,2
119575,2022,Netherlands,Brazil,0,0,0,0,17/06/2022,4,0,10,14,0,0,0,0,0,0,0,0,0,0,0,0,2,0,0,2
119575,2022,Brazil,Türkiye,0,0,1,1,16/06/2022,6,0,7,13,0,0,0,0,0,0,0,0,0,0,0,0,2,1,0,3
119575,2022,USA,Brazil,1,0,3,4,5/6/2022,2,0,9,11,0,0,0,0,0,0,0,0,0,0,0,0,0,0,0,0
119575,2022,Dominican Republic,Brazil,0,0,3,3,3/6/2022,2,0,7,9,0,0,0,0,0,0,0,0,0,0,0,0,0,0,0,0
119575,2022,Brazil,Poland,0,0,0,0,2/6/2022,0,0,3,3,0,0,0,0,0,0,0,0,0,0,0,0,0,0,0,0
119575,2022,Germany,Brazil,0,0,1,1,31/05/2022,1,0,9,10,0,0,1,1,0,0,0,0,0,0,0,0,0,0,0,0
136896,2022,Italy,Brazil,1,0,11,12,17/07/2022,0,0,2,2,9,7,10,26,1,0,2,3,3,0,3,6,9,2,1,12
136896,2022,Serbia,Brazil,0,0,17,17,16/07/2022,0,0,3,3,15,5,10,30,0,1,6,7,4,0,8,12,7,6,3,16
136896,2022,Brazil,Japan,0,1,18,19,13/07/2022,0,0,4,4,22,5,20,47,1,2,3,6,11,1,23,35,12,2,2,16
136896,2022,Brazil,Thailand,0,1,21,22,2/7/2022,0,0,1,1,14,4,16,34,0,7,1,8,13,0,23,36,8,6,4,18
136896,2022,Brazil,Bulgaria,0,1,8,9,1/7/2022,0,0,0,0,12,4,11,27,0,2,1,3,3,2,12,17,6,1,0,7
136896,2022,Korea,Brazil,0,0,3,3,30/06/2022,2,0,0,2,0,1,1,2,0,4,3,7,3,0,4,7,3,1,2,6
136896,2022,China,Brazil,1,0,21,22,28/06/2022,0,0,2,2,25,9,21,55,2,3,2,7,13,1,32,46,9,2,3,14
136896,2022,Brazil,Serbia,0,1,23,24,19/06/2022,0,0,1,1,14,7,14,35,0,0,3,3,4,0,2,6,7,1,1,9
136896,2022,Italy,Brazil,0,2,8,10,18/06/2022,0,0,1,1,8,6,10,24,0,2,2,4,10,1,10,21,4,0,1,5
136896,2022,Netherlands,Brazil,0,1,11,12,17/06/2022,0,0,1,1,13,4,12,29,0,1,1,2,10,1,2,13,10,2,0,12
136896,2022,Brazil,Türkiye,2,1,17,20,16/06/2022,0,0,1,1,16,11,9,36,2,1,4,7,8,0,7,15,7,1,0,8
152128,2022,USA,Brazil,0,0,3,3,5/6/2022,0,0,0,0,1,1,0,2,0,0,0,0,2,2,3,7,0,0,1,1
152128,2022,Dominican Republic,Brazil,0,0,7,7,3/6/2022,0,0,0,0,0,0,0,0,0,0,0,0,0,0,0,0,2,0,0,2
152128,2022,Brazil,Poland,1,0,9,10,2/6/2022,0,0,2,2,1,0,0,1,0,0,0,0,0,0,0,0,1,0,0,1
152128,2022,Germany,Brazil,0,0,4,4,31/05/2022,0,0,0,0,0,0,0,0,0,0,0,0,0,0,0,0,0,1,0,1
173849,2022,Italy,Brazil,0,0,1,1,17/07/2022,0,0,1,1,6,1,4,11,0,1,1,2,0,0,0,0,1,0,0,1
173849,2022,Serbia,Brazil,0,0,0,0,16/07/2022,0,0,0,0,0,0,0,0,0,0,0,0,0,0,0,0,0,0,0,0
173849,2022,Brazil,Japan,0,0,0,0,13/07/2022,0,0,0,0,0,0,0,0,0,0,0,0,0,0,0,0,0,0,0,0
173849,2022,Brazil,Serbia,0,0,0,0,19/06/2022,0,0,0,0,0,0,0,0,0,0,0,0,0,0,0,0,0,0,0,0
173849,2022,Italy,Brazil,0,0,1,1,18/06/2022,0,1,1,2,2,2,0,4,0,0,0,0,0,0,0,0,0,0,1,1
173849,2022,Netherlands,Brazil,0,0,2,2,17/06/2022,0,0,0,0,1,1,2,4,0,0,0,0,0,0,0,0,0,0,0,0
173849,2022,Brazil,Türkiye,0,1,2,3,16/06/2022,0,0,0,0,1,2,9,12,0,0,2,2,0,0,0,0,0,0,0,0
173849,2022,USA,Brazil,0,0,4,4,5/6/2022,0,0,0,0,7,3,4,14,0,0,1,1,0,0,0,0,1,0,0,1
173849,2022,Dominican Republic,Brazil,1,0,6,7,3/6/2022,0,0,0,0,3,4,2,9,0,0,0,0,3,1,2,6,2,1,0,3
173849,2022,Brazil,Poland,0,0,0,0,2/6/2022,0,0,0,0,0,0,0,0,0,0,0,0,0,0,0,0,0,0,0,0
173849,2022,Germany,Brazil,0,1,0,1,31/05/2022,0,0,0,0,2,0,2,4,0,0,0,0,0,0,0,0,0,0,0,0
144843,2022,,,-,-,-,-,-,-,-,-,-,-,-,-,-,-,-,-,-,-,-,-,-,-,-,-,-
164674,2022,Italy,Brazil,0,0,0,0,17/07/2022,0,0,0,0,0,0,0,0,0,0,0,0,0,0,0,0,1,0,0,1
164674,2022,Serbia,Brazil,0,0,0,0,16/07/2022,0,0,7,7,0,0,0,0,0,0,0,0,3,2,6,11,4,7,2,13
164674,2022,Brazil,Japan,0,0,0,0,13/07/2022,0,0,8,8,0,0,0,0,0,0,0,0,4,1,12,17,17,7,3,27
164674,2022,Brazil,Thailand,0,0,0,0,2/7/2022,0,0,4,4,0,0,0,0,0,0,0,0,7,3,9,19,13,3,1,17
164674,2022,Brazil,Bulgaria,0,0,0,0,1/7/2022,0,0,3,3,0,0,0,0,0,0,0,0,1,0,6,7,8,1,0,9
164674,2022,Korea,Brazil,0,0,0,0,30/06/2022,3,1,0,4,0,0,0,0,0,0,0,0,1,1,6,8,7,3,0,10
164674,2022,China,Brazil,0,0,0,0,28/06/2022,2,0,11,13,0,0,0,0,0,0,0,0,4,0,12,16,17,2,2,21
164674,2022,Brazil,Serbia,0,0,0,0,19/06/2022,0,0,0,0,0,0,0,0,0,0,0,0,0,0,0,0,0,0,0,0
164674,2022,Italy,Brazil,0,0,0,0,18/06/2022,0,0,0,0,0,0,0,0,0,0,0,0,0,0,0,0,0,0,0,0
164674,2022,Netherlands,Brazil,0,0,0,0,17/06/2022,0,0,0,0,0,0,0,0,0,0,0,0,0,0,0,0,0,0,0,0
164674,2022,Brazil,Türkiye,0,0,0,0,16/06/2022,0,0,0,0,0,0,0,0,0,0,0,0,0,0,0,0,0,0,0,0
164674,2022,USA,Brazil,0,0,0,0,5/6/2022,0,0,7,7,0,0,0,0,0,0,0,0,7,1,2,10,4,1,0,5
164674,2022,Dominican Republic,Brazil,0,0,0,0,3/6/2022,0,0,0,0,0,0,0,0,0,0,0,0,0,0,0,0,0,0,0,0
164674,2022,Brazil,Poland,0,0,0,0,2/6/2022,0,0,0,0,0,0,0,0,0,0,0,0,0,0,0,0,0,0,0,0
164674,2022,Germany,Brazil,0,0,0,0,31/05/2022,0,0,0,0,0,0,0,0,0,0,0,0,0,0,0,0,0,0,0,0
152130,2022,Italy,Brazil,0,0,2,2,17/07/2022,0,0,0,0,1,0,0,1,0,0,0,0,0,0,1,1,0,0,0,0
152130,2022,Serbia,Brazil,0,0,0,0,16/07/2022,0,0,0,0,0,0,0,0,0,0,0,0,0,0,0,0,0,0,0,0
152130,2022,Brazil,Japan,0,0,0,0,13/07/2022,0,0,0,0,0,0,0,0,0,0,0,0,0,0,0,0,0,0,0,0
152130,2022,Brazil,Thailand,0,0,0,0,2/7/2022,0,0,0,0,0,0,0,0,0,0,0,0,0,0,0,0,0,0,0,0
152130,2022,Brazil,Bulgaria,0,0,0,0,1/7/2022,0,0,0,0,0,0,0,0,0,0,0,0,0,0,0,0,0,0,0,0
152130,2022,Korea,Brazil,0,1,2,3,30/06/2022,0,0,0,0,3,0,2,5,1,1,1,3,0,0,0,0,1,1,0,2
152130,2022,China,Brazil,0,0,0,0,28/06/2022,0,0,0,0,0,0,0,0,0,0,0,0,0,0,0,0,0,0,0,0
152130,2022,Brazil,Serbia,0,0,0,0,19/06/2022,0,0,0,0,0,0,0,0,0,0,0,0,0,0,0,0,0,0,0,0
152130,2022,Italy,Brazil,0,0,4,4,18/06/2022,0,0,0,0,0,1,1,2,0,1,1,2,0,0,0,0,0,0,0,0
152130,2022,Netherlands,Brazil,0,0,0,0,17/06/2022,0,0,0,0,0,1,0,1,0,0,0,0,0,0,0,0,0,0,0,0
152130,2022,Brazil,Türkiye,0,0,0,0,16/06/2022,0,0,0,0,0,0,0,0,0,0,0,0,0,0,0,0,0,0,0,0
152130,2022,USA,Brazil,1,0,4,5,5/6/2022,0,0,0,0,1,1,3,5,1,3,4,8,0,0,0,0,0,1,0,1
152130,2022,Dominican Republic,Brazil,1,0,6,7,3/6/2022,0,0,0,0,4,0,5,9,2,4,3,9,0,0,0,0,1,0,0,1
152130,2022,Brazil,Poland,0,0,0,0,2/6/2022,0,0,0,0,0,0,0,0,0,0,0,0,0,0,0,0,0,0,0,0
152130,2022,Germany,Brazil,0,0,0,0,31/05/2022,0,0,0,0,0,0,0,0,0,0,0,0,0,0,0,0,0,0,0,0
171260,2022,Italy,Brazil,1,0,7,8,17/07/2022,0,0,0,0,12,4,11,27,1,6,1,8,0,0,0,0,2,5,0,7
171260,2022,Serbia,Brazil,1,0,11,12,16/07/2022,0,0,1,1,17,5,16,38,1,0,2,3,0,0,0,0,9,1,2,12
171260,2022,Brazil,Japan,0,3,5,8,13/07/2022,0,0,1,1,16,4,16,36,4,3,1,8,0,0,1,1,4,4,2,10
171260,2022,Brazil,Thailand,0,1,12,13,2/7/2022,0,0,0,0,9,4,14,27,2,5,1,8,0,0,0,0,9,1,0,10
171260,2022,Brazil,Bulgaria,1,1,7,9,1/7/2022,1,0,1,2,5,3,9,17,2,2,4,8,0,0,0,0,3,2,1,6
171260,2022,Korea,Brazil,0,0,0,0,30/06/2022,0,0,0,0,0,0,0,0,0,0,0,0,0,0,0,0,0,0,0,0
171260,2022,China,Brazil,0,4,8,12,28/06/2022,0,0,4,4,22,5,24,51,3,4,4,11,0,0,0,0,8,3,6,17
171260,2022,Brazil,Serbia,0,0,7,7,19/06/2022,0,0,1,1,9,4,11,24,5,2,6,13,1,0,1,2,10,0,1,11
171260,2022,Italy,Brazil,0,2,5,7,18/06/2022,0,0,0,0,12,4,6,22,0,3,0,3,0,0,0,0,3,0,0,3
171260,2022,Netherlands,Brazil,1,4,9,14,17/06/2022,0,0,0,0,8,2,9,19,4,1,0,5,0,0,0,0,5,0,0,5
171260,2022,Brazil,Türkiye,0,0,6,6,16/06/2022,0,1,1,2,13,4,15,32,5,2,4,11,0,0,0,0,4,2,0,6
171260,2022,USA,Brazil,0,0,3,3,5/6/2022,0,0,1,1,5,5,10,20,0,2,0,2,0,0,0,0,4,1,0,5
171260,2022,Dominican Republic,Brazil,1,1,11,13,3/6/2022,0,0,4,4,18,5,12,35,1,1,2,4,0,0,0,0,9,2,0,11
171260,2022,Brazil,Poland,0,0,0,0,2/6/2022,0,0,0,0,1,1,0,2,0,0,0,0,0,0,0,0,0,0,0,0
171260,2022,Germany,Brazil,0,1,4,5,31/05/2022,0,0,2,2,9,1,13,23,1,0,0,1,0,0,0,0,4,0,0,4
162999,2022,Italy,Brazil,0,1,7,8,17/07/2022,0,0,0,0,3,4,6,13,0,1,1,2,8,0,5,13,5,3,0,8
162999,2022,Serbia,Brazil,1,1,13,15,16/07/2022,0,0,2,2,15,6,15,36,0,4,1,5,18,2,25,45,7,4,1,12
162999,2022,Brazil,Japan,1,2,13,16,13/07/2022,0,0,0,0,14,4,12,30,2,1,1,4,5,3,22,30,12,3,1,16
162999,2022,Brazil,Thailand,1,0,17,18,2/7/2022,0,0,0,0,15,6,19,40,1,1,1,3,4,1,20,25,11,2,2,15
162999,2022,Brazil,Bulgaria,1,1,3,5,1/7/2022,0,0,0,0,3,1,1,5,0,0,0,0,0,0,3,3,1,0,0,1
162999,2022,Korea,Brazil,0,0,7,7,30/06/2022,0,0,0,0,11,3,8,22,5,1,0,6,1,1,12,14,1,0,1,2
162999,2022,China,Brazil,1,2,3,6,28/06/2022,0,0,1,1,2,1,1,4,0,0,1,1,1,1,11,13,3,0,3,6
162999,2022,Brazil,Serbia,0,0,0,0,19/06/2022,0,0,0,0,0,0,0,0,0,0,0,0,0,0,0,0,0,0,0,0
162999,2022,Italy,Brazil,0,3,6,9,18/06/2022,0,0,0,0,8,3,4,15,0,1,1,2,9,0,12,21,2,0,2,4
162999,2022,Netherlands,Brazil,0,0,0,0,17/06/2022,0,0,0,0,0,0,0,0,0,0,0,0,0,0,0,0,0,0,0,0
162999,2022,Brazil,Türkiye,0,2,4,6,16/06/2022,0,0,1,1,8,4,7,19,0,1,1,2,14,1,19,34,4,1,0,5
162999,2022,USA,Brazil,0,0,5,5,5/6/2022,0,0,0,0,6,5,5,16,1,4,1,6,17,3,9,29,7,1,0,8
162999,2022,Dominican Republic,Brazil,2,1,13,16,3/6/2022,0,0,1,1,10,4,15,29,1,3,0,4,18,0,5,23,14,4,0,18
162999,2022,Brazil,Poland,0,0,8,8,2/6/2022,0,0,2,2,8,1,13,22,0,1,2,3,5,1,4,10,3,0,2,5
162999,2022,Germany,Brazil,0,1,11,12,31/05/2022,0,0,0,0,18,8,22,48,1,4,2,7,37,2,21,60,10,3,0,13
164673,2022,Brazil,Thailand,0,0,0,0,2/7/2022,0,0,0,0,0,0,0,0,0,0,0,0,0,0,0,0,0,0,0,0
164673,2022,Brazil,Bulgaria,0,0,0,0,1/7/2022,0,0,0,0,0,0,0,0,0,0,0,0,0,0,0,0,0,0,0,0
164673,2022,Korea,Brazil,0,0,1,1,30/06/2022,0,0,0,0,1,1,1,3,2,3,0,5,0,0,0,0,0,0,0,0
164673,2022,China,Brazil,0,0,0,0,28/06/2022,0,0,0,0,0,0,0,0,0,0,0,0,0,0,0,0,0,0,0,0
164673,2022,USA,Brazil,0,1,2,3,5/6/2022,0,0,2,2,1,0,3,4,0,3,3,6,0,0,0,0,0,0,0,0
164673,2022,Dominican Republic,Brazil,0,0,0,0,3/6/2022,0,0,0,0,0,0,0,0,0,0,0,0,0,0,0,0,0,0,0,0
164673,2022,Brazil,Poland,0,0,0,0,2/6/2022,0,0,0,0,0,0,0,0,0,0,0,0,0,0,0,0,0,0,0,0
164673,2022,Germany,Brazil,0,0,0,0,31/05/2022,0,0,0,0,0,0,0,0,0,0,0,0,0,0,0,0,0,0,0,0
163000,2022,,,-,-,-,-,-,-,-,-,-,-,-,-,-,-,-,-,-,-,-,-,-,-,-,-,-
152125,2022,Brazil,Thailand,0,0,0,0,2/7/2022,0,0,0,0,0,0,0,0,0,0,0,0,0,0,0,0,0,0,0,0
152125,2022,Brazil,Bulgaria,0,1,0,1,1/7/2022,0,0,0,0,0,0,1,1,0,0,0,0,0,0,0,0,0,0,0,0
152125,2022,Korea,Brazil,0,2,14,16,30/06/2022,0,0,0,0,7,5,11,23,0,1,2,3,0,0,0,0,10,2,3,15
152125,2022,China,Brazil,0,0,0,0,28/06/2022,0,0,0,0,0,0,2,2,0,0,0,0,0,0,0,0,0,0,0,0
152131,2022,,,-,-,-,-,-,-,-,-,-,-,-,-,-,-,-,-,-,-,-,-,-,-,-,-,-
138832,2022,,,-,-,-,-,-,-,-,-,-,-,-,-,-,-,-,-,-,-,-,-,-,-,-,-,-
144865,2022,,,-,-,-,-,-,-,-,-,-,-,-,-,-,-,-,-,-,-,-,-,-,-,-,-,-
141658,2022,Italy,Brazil,0,0,0,0,17/07/2022,0,0,0,0,1,1,3,5,0,1,1,2,0,0,0,0,0,0,0,0
141658,2022,Serbia,Brazil,0,0,1,1,16/07/2022,0,0,0,0,1,3,2,6,0,1,0,1,0,0,0,0,1,1,0,2
141658,2022,Brazil,Japan,0,0,1,1,13/07/2022,0,1,0,1,3,0,4,7,0,2,0,2,0,0,0,0,0,0,0,0
141658,2022,USA,Brazil,0,0,1,1,5/6/2022,0,0,0,0,1,2,1,4,0,1,0,1,0,0,0,0,0,1,0,1
141658,2022,Dominican Republic,Brazil,0,0,1,1,3/6/2022,0,0,0,0,0,0,3,3,0,0,0,0,0,0,0,0,0,0,1,1
141658,2022,Brazil,Poland,0,1,7,8,2/6/2022,0,0,0,0,6,1,17,24,3,0,1,4,0,0,0,0,5,3,0,8
141658,2022,Germany,Brazil,1,0,10,11,31/05/2022,0,0,1,1,7,4,15,26,0,1,0,1,0,0,0,0,2,3,0,5
141661,2022,,,-,-,-,-,-,-,-,-,-,-,-,-,-,-,-,-,-,-,-,-,-,-,-,-,-
142341,2022,Bulgaria,Türkiye,0,0,10,10,4/6/2022,0,0,1,1,8,7,13,28,0,2,1,3,3,0,15,18,5,0,0,5
142341,2022,Serbia,Bulgaria,1,0,10,11,3/6/2022,0,0,1,1,7,8,12,27,1,2,1,4,2,1,13,16,6,3,0,9
142341,2022,Bulgaria,Netherlands,1,1,16,18,2/6/2022,0,0,2,2,17,1,27,45,2,1,3,6,9,2,28,39,19,5,1,25
142341,2022,Thailand,Bulgaria,0,0,6,6,31/05/2022,0,0,2,2,12,1,8,21,1,1,3,5,5,0,18,23,7,4,2,13
124202,2022,Poland,Bulgaria,1,1,16,18,3/7/2022,0,0,4,4,10,1,7,18,4,4,1,9,0,0,0,0,1,1,0,2
124202,2022,Italy,Bulgaria,3,0,13,16,2/7/2022,0,0,1,1,5,1,5,11,0,6,0,6,0,0,0,0,2,2,1,5
124202,2022,Brazil,Bulgaria,1,0,10,11,1/7/2022,0,1,0,1,7,0,3,10,1,5,0,6,0,0,1,1,3,1,2,6
124202,2022,Dominican Republic,Bulgaria,0,2,9,11,28/06/2022,2,0,0,2,6,0,2,8,4,3,0,7,0,0,0,0,1,0,1,2
124202,2022,Bulgaria,Belgium,0,1,14,15,19/06/2022,0,0,7,7,5,2,13,20,9,6,6,21,0,0,0,0,8,1,1,10
124202,2022,Bulgaria,Canada,0,1,11,12,18/06/2022,0,0,1,1,8,0,2,10,3,4,13,20,0,1,0,1,3,0,0,3
124202,2022,Bulgaria,Japan,0,0,1,1,16/06/2022,1,0,1,2,1,1,2,4,1,2,0,3,0,0,1,1,1,0,0,1
124202,2022,Bulgaria,USA,1,1,7,9,15/06/2022,0,0,0,0,3,0,7,10,1,3,0,4,0,2,0,2,1,0,0,1
124202,2022,Bulgaria,Türkiye,0,0,1,1,4/6/2022,0,0,1,1,2,2,0,4,2,1,2,5,0,0,0,0,1,0,0,1
124202,2022,Serbia,Bulgaria,1,0,6,7,3/6/2022,0,0,0,0,6,2,6,14,0,5,3,8,1,1,2,4,2,1,3,6
124202,2022,Bulgaria,Netherlands,0,1,10,11,2/6/2022,0,0,2,2,10,4,5,19,4,6,12,22,0,0,1,1,4,1,1,6
124202,2022,Thailand,Bulgaria,0,1,10,11,31/05/2022,0,0,1,1,9,2,4,15,1,5,3,9,0,0,0,0,1,3,0,4
153422,2022,Poland,Bulgaria,0,0,0,0,3/7/2022,0,0,0,0,0,0,0,0,0,0,0,0,0,0,0,0,0,0,0,0
153422,2022,Italy,Bulgaria,0,0,0,0,2/7/2022,0,0,0,0,0,0,0,0,0,0,0,0,0,0,0,0,0,0,0,0
153422,2022,Brazil,Bulgaria,0,0,0,0,1/7/2022,0,0,0,0,0,0,0,0,0,0,0,0,0,0,0,0,0,0,0,0
153422,2022,Dominican Republic,Bulgaria,0,0,0,0,28/06/2022,0,0,0,0,0,0,0,0,0,0,0,0,0,0,1,1,0,0,0,0
122460,2022,,,-,-,-,-,-,-,-,-,-,-,-,-,-,-,-,-,-,-,-,-,-,-,-,-,-
174474,2022,Poland,Bulgaria,0,1,10,11,3/7/2022,0,0,2,2,20,8,14,42,2,1,1,4,3,1,24,28,8,2,0,10
174474,2022,Italy,Bulgaria,0,0,6,6,2/7/2022,0,1,0,1,9,6,7,22,0,3,1,4,2,2,24,28,1,2,1,4
174474,2022,Brazil,Bulgaria,0,1,4,5,1/7/2022,0,0,0,0,5,6,5,16,1,2,0,3,4,1,19,24,3,1,1,5
174474,2022,Dominican Republic,Bulgaria,1,1,9,11,28/06/2022,0,0,0,0,19,5,17,41,2,0,0,2,2,0,12,14,5,1,1,7
174474,2022,Bulgaria,Belgium,0,3,15,18,19/06/2022,0,1,5,6,17,7,18,42,2,5,4,11,5,5,43,53,14,3,2,19
174474,2022,Bulgaria,Canada,1,0,9,10,18/06/2022,1,0,4,5,13,4,8,25,1,1,0,2,3,2,13,18,9,1,0,10
174474,2022,Bulgaria,Japan,0,2,7,9,16/06/2022,0,0,0,0,10,5,11,26,0,1,5,6,9,3,16,28,9,1,1,11
174474,2022,Bulgaria,USA,1,4,2,7,15/06/2022,0,0,1,1,6,3,7,16,1,0,2,3,7,3,20,30,5,2,0,7
142347,2022,Poland,Bulgaria,1,2,19,22,3/7/2022,0,0,2,2,7,3,12,22,0,3,0,3,1,0,20,21,11,0,0,11
142347,2022,Italy,Bulgaria,0,2,7,9,2/7/2022,0,0,0,0,7,2,11,20,0,3,1,4,1,1,20,22,9,1,3,13
142347,2022,Brazil,Bulgaria,1,0,8,9,1/7/2022,0,0,0,0,6,2,9,17,0,0,0,0,5,0,12,17,3,2,0,5
142347,2022,Dominican Republic,Bulgaria,0,0,12,12,28/06/2022,0,0,0,0,10,4,11,25,0,0,1,1,4,0,16,20,4,0,0,4
142347,2022,Bulgaria,Belgium,0,1,19,20,19/06/2022,0,0,5,5,13,11,27,51,0,3,3,6,2,2,17,21,12,3,1,16
142347,2022,Bulgaria,Canada,1,2,11,14,18/06/2022,0,0,0,0,12,2,10,24,1,3,3,7,8,2,16,26,8,2,1,11
142347,2022,Bulgaria,Japan,0,0,14,14,16/06/2022,0,0,4,4,4,4,14,22,0,2,2,4,2,1,15,18,9,4,0,13
142347,2022,Bulgaria,USA,1,1,9,11,15/06/2022,0,0,3,3,11,5,14,30,2,4,0,6,1,1,6,8,6,2,0,8
142347,2022,Bulgaria,Türkiye,0,0,9,9,4/6/2022,1,0,0,1,7,2,11,20,0,2,2,4,4,1,15,20,4,1,1,6
142347,2022,Serbia,Bulgaria,0,3,5,8,3/6/2022,0,0,1,1,8,1,10,19,0,3,5,8,4,1,29,34,6,3,4,13
142347,2022,Bulgaria,Netherlands,1,3,10,14,2/6/2022,1,0,5,6,16,3,21,40,2,6,3,11,4,0,19,23,10,6,2,18
142347,2022,Thailand,Bulgaria,0,2,11,13,31/05/2022,0,0,2,2,3,5,11,19,1,6,4,11,1,1,11,13,5,4,1,10
138283,2022,Poland,Bulgaria,0,2,14,16,3/7/2022,10,0,95,105,4,0,2,6,0,2,1,3,0,0,0,0,10,1,3,14
138283,2022,Italy,Bulgaria,0,2,1,3,2/7/2022,3,1,34,38,0,0,1,1,0,0,0,0,0,0,0,0,1,1,0,2
138283,2022,Brazil,Bulgaria,1,1,10,12,1/7/2022,11,1,67,79,0,0,2,2,0,4,1,5,0,0,0,0,3,1,0,4
138283,2022,Dominican Republic,Bulgaria,0,1,11,12,28/06/2022,51,2,3,56,0,0,0,0,0,0,1,1,0,0,0,0,4,2,0,6
138283,2022,Bulgaria,Belgium,0,4,20,24,19/06/2022,36,0,87,123,5,0,1,6,2,5,4,11,0,0,0,0,19,3,2,24
138283,2022,Bulgaria,Canada,0,1,16,17,18/06/2022,8,0,70,78,3,0,2,5,0,5,1,6,0,0,0,0,8,1,1,10
138283,2022,Bulgaria,Japan,0,0,7,7,16/06/2022,18,0,48,66,1,0,0,1,0,5,1,6,0,0,0,0,3,0,0,3
138283,2022,Bulgaria,USA,2,0,8,10,15/06/2022,5,1,68,74,3,0,1,4,0,0,0,0,0,0,1,1,2,2,0,4
138283,2022,Bulgaria,Türkiye,1,1,14,16,4/6/2022,33,3,37,73,1,0,1,2,1,1,1,3,0,0,1,1,7,3,5,15
138283,2022,Serbia,Bulgaria,1,1,10,12,3/6/2022,12,0,68,80,1,0,4,5,0,6,3,9,0,0,0,0,2,1,1,4
138283,2022,Bulgaria,Netherlands,0,2,8,10,2/6/2022,27,0,88,115,0,0,1,1,1,3,2,6,0,0,0,0,3,4,6,13
138283,2022,Thailand,Bulgaria,0,1,8,9,31/05/2022,24,0,50,74,1,0,2,3,0,3,1,4,0,0,0,0,1,2,2,5
142348,2022,Poland,Bulgaria,0,0,0,0,3/7/2022,0,0,0,0,0,0,0,0,0,0,0,0,0,0,0,0,0,0,0,0
142348,2022,Italy,Bulgaria,0,1,3,4,2/7/2022,4,0,42,46,0,0,2,2,0,1,3,4,0,0,0,0,1,3,1,5
142348,2022,Brazil,Bulgaria,0,0,1,1,1/7/2022,1,1,14,16,0,0,0,0,0,0,0,0,0,0,0,0,0,0,0,0
142348,2022,Dominican Republic,Bulgaria,0,0,0,0,28/06/2022,0,0,0,0,0,0,0,0,0,0,0,0,0,0,0,0,0,0,0,0
142348,2022,Bulgaria,Belgium,0,0,0,0,19/06/2022,0,0,2,2,0,0,0,0,0,0,0,0,0,0,0,0,0,0,0,0
142348,2022,Bulgaria,Canada,0,0,0,0,18/06/2022,0,0,0,0,0,0,0,0,0,0,0,0,0,0,0,0,0,0,0,0
142348,2022,Bulgaria,Japan,0,0,3,3,16/06/2022,8,0,16,24,1,0,0,1,0,0,1,1,0,0,0,0,3,0,0,3
142348,2022,Bulgaria,USA,0,0,1,1,15/06/2022,1,0,3,4,0,0,0,0,0,0,0,0,0,0,0,0,0,0,0,0
142348,2022,Bulgaria,Türkiye,0,0,0,0,4/6/2022,0,0,0,0,0,0,0,0,0,0,0,0,0,0,0,0,0,0,0,0
142348,2022,Serbia,Bulgaria,0,0,2,2,3/6/2022,5,0,11,16,0,0,0,0,0,0,0,0,0,0,0,0,1,0,1,2
142348,2022,Bulgaria,Netherlands,0,0,2,2,2/6/2022,4,1,16,21,0,0,1,1,0,0,1,1,0,0,0,0,1,0,0,1
142348,2022,Thailand,Bulgaria,0,1,1,2,31/05/2022,2,0,2,4,0,0,0,0,0,1,0,1,0,0,0,0,0,0,0,0
163261,2022,Poland,Bulgaria,0,0,0,0,3/7/2022,0,0,0,0,0,0,0,0,0,0,0,0,0,0,0,0,0,0,0,0
163261,2022,Italy,Bulgaria,1,0,4,5,2/7/2022,0,0,0,0,1,0,0,1,0,2,0,2,0,0,0,0,0,0,0,0
163261,2022,Brazil,Bulgaria,0,1,1,2,1/7/2022,0,0,0,0,0,0,0,0,0,0,0,0,0,0,0,0,0,0,0,0
163261,2022,Dominican Republic,Bulgaria,0,0,0,0,28/06/2022,0,0,0,0,0,0,0,0,0,0,0,0,0,0,0,0,0,0,0,0
163261,2022,Bulgaria,Belgium,0,1,0,1,19/06/2022,0,0,0,0,0,0,0,0,0,0,0,0,0,0,0,0,0,0,0,0
163261,2022,Bulgaria,Canada,0,0,0,0,18/06/2022,0,0,0,0,0,0,0,0,0,0,0,0,0,0,0,0,0,0,0,0
163261,2022,Bulgaria,Japan,0,2,6,8,16/06/2022,1,0,1,2,0,0,4,4,0,1,6,7,0,0,2,2,1,0,0,1
163261,2022,Bulgaria,USA,0,0,2,2,15/06/2022,0,0,0,0,0,0,0,0,0,0,0,0,0,0,0,0,0,0,0,0
163261,2022,Bulgaria,Türkiye,0,0,2,2,4/6/2022,0,0,0,0,0,0,0,0,1,0,0,1,0,0,0,0,0,0,0,0
163261,2022,Serbia,Bulgaria,0,0,2,2,3/6/2022,0,0,0,0,0,0,0,0,0,0,1,1,0,0,0,0,0,0,0,0
163261,2022,Bulgaria,Netherlands,0,1,0,1,2/6/2022,0,0,0,0,0,0,0,0,0,0,0,0,0,0,0,0,0,0,0,0
163261,2022,Thailand,Bulgaria,0,2,2,4,31/05/2022,0,0,0,0,0,0,0,0,0,0,0,0,0,0,0,0,0,1,0,1
142337,2022,Poland,Bulgaria,0,3,7,10,3/7/2022,0,0,0,0,8,1,3,12,1,7,3,11,0,0,0,0,3,1,0,4
142337,2022,Italy,Bulgaria,0,0,3,3,2/7/2022,0,0,0,0,2,0,3,5,0,5,0,5,0,0,0,0,0,0,0,0
142337,2022,Brazil,Bulgaria,0,2,6,8,1/7/2022,0,0,0,0,5,1,4,10,1,1,2,4,0,0,1,1,4,1,0,5
142337,2022,Dominican Republic,Bulgaria,1,1,5,7,28/06/2022,0,0,0,0,4,0,6,10,3,3,1,7,0,0,1,1,3,0,0,3
142337,2022,Bulgaria,Belgium,0,0,15,15,19/06/2022,0,0,1,1,9,1,4,14,2,0,2,4,0,0,0,0,12,0,0,12
142337,2022,Bulgaria,Canada,0,1,10,11,18/06/2022,1,0,2,3,4,0,2,6,1,6,5,12,0,0,0,0,3,0,0,3
142337,2022,Bulgaria,Japan,0,1,8,9,16/06/2022,0,0,0,0,5,0,4,9,1,4,3,8,0,0,2,2,3,0,0,3
142337,2022,Bulgaria,USA,0,1,7,8,15/06/2022,0,0,0,0,1,1,2,4,1,6,1,8,0,0,0,0,1,0,0,1
142337,2022,Bulgaria,Türkiye,0,2,2,4,4/6/2022,0,0,0,0,3,1,1,5,0,3,1,4,0,0,0,0,0,0,0,0
142337,2022,Serbia,Bulgaria,0,0,0,0,3/6/2022,0,0,0,0,0,0,0,0,0,0,0,0,0,0,0,0,0,0,0,0
142337,2022,Bulgaria,Netherlands,0,1,0,1,2/6/2022,0,0,0,0,2,0,2,4,1,0,1,2,0,0,0,0,0,0,0,0
142337,2022,Thailand,Bulgaria,0,1,3,4,31/05/2022,0,0,1,1,4,1,0,5,0,1,4,5,0,0,0,0,1,0,0,1
124201,2022,Bulgaria,Türkiye,0,1,6,7,4/6/2022,0,0,0,0,5,1,3,9,3,3,5,11,0,0,0,0,1,0,1,2
124201,2022,Serbia,Bulgaria,0,0,9,9,3/6/2022,0,0,2,2,5,0,3,8,2,5,3,10,0,0,0,0,0,1,2,3
124201,2022,Bulgaria,Netherlands,2,0,17,19,2/6/2022,0,0,1,1,8,3,7,18,1,6,5,12,0,0,0,0,2,1,2,5
124201,2022,Thailand,Bulgaria,0,0,3,3,31/05/2022,0,0,0,0,3,0,2,5,0,1,1,2,0,0,0,0,0,0,0,0
172904,2022,,,-,-,-,-,-,-,-,-,-,-,-,-,-,-,-,-,-,-,-,-,-,-,-,-,-
174467,2022,,,-,-,-,-,-,-,-,-,-,-,-,-,-,-,-,-,-,-,-,-,-,-,-,-,-
142351,2022,Poland,Bulgaria,0,0,0,0,3/7/2022,0,0,6,6,0,0,0,0,0,0,0,0,4,1,13,18,7,4,3,14
142351,2022,Italy,Bulgaria,0,0,0,0,2/7/2022,0,0,6,6,0,0,0,0,0,0,0,0,2,0,7,9,4,1,1,6
142351,2022,Brazil,Bulgaria,0,0,0,0,1/7/2022,0,0,1,1,0,0,0,0,0,0,0,0,1,2,7,10,7,2,3,12
142351,2022,Dominican Republic,Bulgaria,0,0,0,0,28/06/2022,5,0,0,5,0,0,0,0,0,0,0,0,2,0,7,9,3,3,1,7
142351,2022,Bulgaria,Belgium,0,0,0,0,19/06/2022,1,0,26,27,0,0,0,0,0,0,0,0,8,1,9,18,29,1,1,31
142351,2022,Bulgaria,Canada,0,0,0,0,18/06/2022,0,0,11,11,0,0,0,0,0,0,0,0,6,2,9,17,15,3,1,19
142351,2022,Bulgaria,Japan,0,0,0,0,16/06/2022,0,1,4,5,0,0,0,0,0,0,0,0,4,0,6,10,11,3,0,14
142351,2022,Bulgaria,USA,0,0,0,0,15/06/2022,0,0,10,10,0,0,0,0,0,0,0,0,3,0,8,11,8,4,2,14
142351,2022,Bulgaria,Türkiye,0,0,0,0,4/6/2022,1,0,8,9,0,0,0,0,0,0,0,0,4,2,5,11,6,1,1,8
142351,2022,Serbia,Bulgaria,0,0,0,0,3/6/2022,0,3,7,10,0,0,0,0,0,0,0,0,3,1,7,11,10,4,7,21
142351,2022,Bulgaria,Netherlands,0,0,0,0,2/6/2022,0,0,7,7,0,0,0,0,0,0,0,0,8,0,6,14,14,3,12,29
142351,2022,Thailand,Bulgaria,0,0,0,0,31/05/2022,0,0,1,1,0,0,0,0,0,0,0,0,5,1,12,18,7,4,9,20
122541,2022,,,-,-,-,-,-,-,-,-,-,-,-,-,-,-,-,-,-,-,-,-,-,-,-,-,-
163141,2022,Poland,Bulgaria,0,0,0,0,3/7/2022,0,0,0,0,0,0,0,0,0,0,0,0,0,0,0,0,0,0,0,0
163141,2022,Italy,Bulgaria,0,0,5,5,2/7/2022,0,0,0,0,2,0,14,16,1,1,0,2,0,0,0,0,1,0,4,5
163141,2022,Brazil,Bulgaria,0,0,2,2,1/7/2022,0,0,0,0,4,3,6,13,0,1,0,1,0,0,0,0,0,0,0,0
163141,2022,Dominican Republic,Bulgaria,3,1,16,20,28/06/2022,1,0,0,1,4,3,4,11,0,0,0,0,0,0,0,0,1,0,0,1
163141,2022,Bulgaria,Belgium,0,0,0,0,19/06/2022,0,0,0,0,0,0,0,0,0,0,0,0,0,0,0,0,0,0,0,0
163141,2022,Bulgaria,Canada,0,0,0,0,18/06/2022,0,0,0,0,0,0,0,0,0,0,0,0,0,0,0,0,0,0,0,0
163141,2022,Bulgaria,Japan,0,0,2,2,16/06/2022,0,0,0,0,2,0,3,5,0,0,1,1,0,0,0,0,1,1,0,2
163141,2022,Bulgaria,USA,0,0,0,0,15/06/2022,0,0,0,0,0,0,0,0,0,0,0,0,0,0,0,0,0,0,0,0
163141,2022,Bulgaria,Türkiye,0,1,0,1,4/6/2022,0,0,0,0,1,0,1,2,0,0,0,0,0,0,0,0,0,2,0,2
163141,2022,Serbia,Bulgaria,0,1,1,2,3/6/2022,0,0,0,0,2,0,7,9,0,1,1,2,0,0,0,0,0,0,0,0
163141,2022,Bulgaria,Netherlands,0,0,0,0,2/6/2022,0,0,0,0,0,0,0,0,0,0,0,0,0,0,0,0,0,0,0,0
163141,2022,Thailand,Bulgaria,0,0,0,0,31/05/2022,0,0,0,0,0,0,0,0,0,0,0,0,0,0,0,0,0,0,0,0
142333,2022,Poland,Bulgaria,0,1,18,19,3/7/2022,0,0,4,4,10,3,17,30,1,4,3,8,0,0,1,1,5,1,0,6
142333,2022,Italy,Bulgaria,0,1,1,2,2/7/2022,0,0,1,1,7,1,7,15,0,0,0,0,0,0,0,0,0,1,0,1
142333,2022,Brazil,Bulgaria,0,1,3,4,1/7/2022,0,0,0,0,2,5,7,14,2,2,0,4,0,0,0,0,3,0,0,3
142333,2022,Dominican Republic,Bulgaria,0,0,0,0,28/06/2022,0,0,0,0,0,0,0,0,0,0,0,0,0,0,0,0,0,0,0,0
142333,2022,Bulgaria,Belgium,1,2,14,17,19/06/2022,0,0,2,2,12,7,29,48,1,4,10,15,0,0,0,0,11,2,0,13
142333,2022,Bulgaria,Canada,1,1,9,11,18/06/2022,0,0,1,1,10,3,19,32,1,3,3,7,0,0,1,1,3,1,0,4
142333,2022,Bulgaria,Japan,0,0,7,7,16/06/2022,0,0,5,5,13,4,10,27,0,4,3,7,0,0,0,0,2,2,1,5
142333,2022,Bulgaria,USA,1,0,12,13,15/06/2022,0,0,1,1,8,3,11,22,0,2,1,3,0,0,0,0,6,2,2,10
142333,2022,Bulgaria,Türkiye,0,0,4,4,4/6/2022,0,0,0,0,2,5,7,14,0,0,4,4,0,0,0,0,4,0,0,4
142333,2022,Serbia,Bulgaria,0,0,10,10,3/6/2022,0,0,0,0,8,4,15,27,1,3,1,5,1,0,0,1,7,2,0,9
142333,2022,Bulgaria,Netherlands,2,0,15,17,2/6/2022,0,0,4,4,10,5,12,27,0,4,2,6,0,0,0,0,8,2,2,12
142333,2022,Thailand,Bulgaria,0,0,7,7,31/05/2022,0,0,1,1,8,3,6,17,0,0,1,1,0,0,0,0,4,1,0,5
163142,2022,Poland,Bulgaria,0,0,0,0,3/7/2022,0,0,0,0,0,0,0,0,0,0,0,0,0,0,0,0,0,0,0,0
163142,2022,Italy,Bulgaria,0,0,0,0,2/7/2022,0,0,1,1,1,0,2,3,0,1,0,1,1,0,2,3,0,0,0,0
163142,2022,Brazil,Bulgaria,1,1,5,7,1/7/2022,0,0,0,0,2,4,4,10,0,1,0,1,3,0,7,10,4,1,1,6
163142,2022,Dominican Republic,Bulgaria,0,0,0,0,28/06/2022,0,0,0,0,0,0,0,0,0,0,0,0,0,0,0,0,0,0,0,0
163142,2022,Bulgaria,Belgium,0,0,0,0,19/06/2022,0,0,0,0,0,0,0,0,0,0,0,0,0,0,0,0,0,0,0,0
163142,2022,Bulgaria,Canada,0,0,0,0,18/06/2022,0,0,0,0,0,0,0,0,0,0,0,0,0,0,0,0,0,0,0,0
163142,2022,Bulgaria,Japan,0,0,1,1,16/06/2022,0,0,0,0,3,1,2,6,0,0,0,0,0,0,0,0,0,1,0,1
163142,2022,Bulgaria,USA,0,1,1,2,15/06/2022,0,0,0,0,5,1,1,7,0,0,1,1,1,1,12,14,1,1,0,2
163142,2022,Bulgaria,Türkiye,0,1,2,3,4/6/2022,0,0,0,0,2,0,6,8,1,0,0,1,1,0,13,14,3,0,0,3
163142,2022,Serbia,Bulgaria,0,0,1,1,3/6/2022,0,0,0,0,2,0,0,2,0,1,1,2,0,0,2,2,0,1,0,1
163142,2022,Bulgaria,Netherlands,0,1,1,2,2/6/2022,0,0,0,0,1,2,2,5,0,0,0,0,2,0,2,4,2,1,1,4
163142,2022,Thailand,Bulgaria,1,3,1,5,31/05/2022,0,0,0,0,4,0,0,4,0,0,0,0,2,3,6,11,1,0,1,2
151857,2022,,,-,-,-,-,-,-,-,-,-,-,-,-,-,-,-,-,-,-,-,-,-,-,-,-,-
163144,2022,,,-,-,-,-,-,-,-,-,-,-,-,-,-,-,-,-,-,-,-,-,-,-,-,-,-
164804,2022,,,-,-,-,-,-,-,-,-,-,-,-,-,-,-,-,-,-,-,-,-,-,-,-,-,-
153425,2022,Bulgaria,Belgium,0,0,0,0,19/06/2022,0,0,0,0,0,0,0,0,0,0,0,0,0,0,0,0,0,0,0,0
153425,2022,Bulgaria,Canada,0,0,0,0,18/06/2022,0,0,0,0,0,0,0,0,0,0,0,0,0,0,0,0,0,0,0,0
153425,2022,Bulgaria,Japan,0,0,0,0,16/06/2022,0,0,0,0,0,0,0,0,0,0,0,0,0,0,0,0,0,0,0,0
153425,2022,Bulgaria,USA,0,0,0,0,15/06/2022,0,0,0,0,0,0,0,0,0,0,0,0,0,0,0,0,0,0,0,0
153425,2022,Bulgaria,Türkiye,0,0,0,0,4/6/2022,4,0,5,9,0,0,0,0,0,0,0,0,0,0,0,0,1,1,0,2
153425,2022,Serbia,Bulgaria,0,0,0,0,3/6/2022,0,0,0,0,0,0,0,0,0,0,0,0,0,0,0,0,0,0,0,0
153425,2022,Bulgaria,Netherlands,0,0,0,0,2/6/2022,0,0,0,0,0,0,0,0,0,0,0,0,0,0,0,0,0,0,0,0
153425,2022,Thailand,Bulgaria,0,0,0,0,31/05/2022,0,0,0,0,0,0,0,0,0,0,0,0,0,0,0,0,0,0,0,0
183413,2022,,,-,-,-,-,-,-,-,-,-,-,-,-,-,-,-,-,-,-,-,-,-,-,-,-,-
164660,2022,Poland,Bulgaria,0,0,0,0,3/7/2022,0,0,0,0,0,0,0,0,0,0,0,0,0,0,0,0,0,0,0,0
164660,2022,Italy,Bulgaria,0,0,0,0,2/7/2022,0,0,0,0,0,0,0,0,0,0,0,0,0,0,0,0,0,0,0,0
164660,2022,Brazil,Bulgaria,0,0,0,0,1/7/2022,0,0,0,0,0,0,0,0,0,0,0,0,0,0,0,0,0,0,0,0
164660,2022,Dominican Republic,Bulgaria,0,0,0,0,28/06/2022,0,0,0,0,0,0,0,0,0,0,0,0,0,0,0,0,0,0,0,0
164660,2022,Bulgaria,Belgium,0,0,0,0,19/06/2022,0,0,0,0,0,0,0,0,0,0,0,0,0,0,0,0,0,0,0,0
164660,2022,Bulgaria,Canada,0,0,0,0,18/06/2022,0,0,0,0,0,0,0,0,0,0,0,0,0,0,0,0,0,0,0,0
164660,2022,Bulgaria,Japan,0,0,0,0,16/06/2022,0,0,0,0,0,0,0,0,0,0,0,0,0,0,0,0,0,0,0,0
164660,2022,Bulgaria,USA,0,0,0,0,15/06/2022,0,0,0,0,0,0,0,0,0,0,0,0,0,0,0,0,0,0,0,0
140907,2022,Poland,Bulgaria,0,0,0,0,3/7/2022,0,0,0,0,0,0,0,0,0,0,0,0,0,0,0,0,0,0,0,0
140907,2022,Italy,Bulgaria,0,0,0,0,2/7/2022,0,0,0,0,1,1,0,2,0,0,0,0,0,1,3,4,0,0,0,0
140907,2022,Brazil,Bulgaria,0,0,0,0,1/7/2022,0,0,0,0,0,0,0,0,0,0,0,0,0,0,0,0,0,0,0,0
140907,2022,Dominican Republic,Bulgaria,0,0,0,0,28/06/2022,0,0,0,0,0,0,0,0,0,0,0,0,0,0,0,0,0,0,0,0
140907,2022,Bulgaria,Belgium,0,0,0,0,19/06/2022,0,0,0,0,0,0,0,0,0,0,0,0,0,0,0,0,0,0,0,0
140907,2022,Bulgaria,Canada,0,0,0,0,18/06/2022,0,0,0,0,0,0,0,0,0,0,0,0,0,0,0,0,0,0,0,0
140907,2022,Bulgaria,Japan,0,0,0,0,16/06/2022,0,0,0,0,1,2,2,5,0,0,2,2,0,0,4,4,0,0,0,0
140907,2022,Bulgaria,USA,0,0,1,1,15/06/2022,0,0,0,0,0,1,0,1,0,0,0,0,0,0,0,0,0,0,0,0
140907,2022,Bulgaria,Türkiye,0,0,0,0,4/6/2022,0,0,0,0,0,2,0,2,0,0,0,0,1,0,2,3,1,0,1,2
140907,2022,Serbia,Bulgaria,0,0,0,0,3/6/2022,0,0,0,0,0,0,1,1,0,0,0,0,1,0,1,2,0,0,0,0
140907,2022,Bulgaria,Netherlands,0,0,1,1,2/6/2022,0,0,3,3,1,1,1,3,0,2,2,4,0,0,0,0,1,0,0,1
140907,2022,Thailand,Bulgaria,0,0,0,0,31/05/2022,0,0,0,0,0,0,0,0,0,0,0,0,0,0,0,0,0,0,0,0
175276,2022,Korea,Canada,0,0,0,0,5/6/2022,0,0,0,0,0,0,0,0,0,0,0,0,0,0,0,0,0,0,0,0
175276,2022,USA,Canada,0,0,0,0,4/6/2022,0,0,0,0,0,0,0,0,0,0,0,0,0,0,0,0,0,0,0,0
175276,2022,Canada,Dominican Republic,0,0,0,0,3/6/2022,0,0,0,0,0,0,0,0,0,0,0,0,0,0,0,0,0,0,0,0
175276,2022,Poland,Canada,0,0,0,0,1/6/2022,0,0,0,0,0,0,0,0,0,0,0,0,0,0,0,0,0,0,0,0
182883,2022,,,-,-,-,-,-,-,-,-,-,-,-,-,-,-,-,-,-,-,-,-,-,-,-,-,-
168355,2022,Netherlands,Canada,3,5,13,21,3/7/2022,0,0,7,7,18,12,18,48,1,3,2,6,0,0,0,0,21,2,0,23
168355,2022,Germany,Canada,3,8,3,14,3/7/2022,0,0,7,7,18,8,11,37,1,2,3,6,0,0,0,0,9,2,0,11
168355,2022,Serbia,Canada,0,1,8,9,2/7/2022,0,0,2,2,16,11,20,47,2,2,2,6,0,0,0,0,3,0,0,3
168355,2022,Canada,Türkiye,2,5,6,13,29/06/2022,0,0,2,2,19,8,14,41,0,4,0,4,0,0,0,0,3,1,0,4
168355,2022,Bulgaria,Canada,3,2,8,13,18/06/2022,0,0,2,2,17,6,13,36,0,4,4,8,0,0,0,0,8,2,1,11
168355,2022,China,Canada,1,4,5,10,17/06/2022,1,0,5,6,13,8,14,35,0,0,2,2,0,0,2,2,6,1,1,8
168355,2022,Canada,Belgium,2,4,8,14,16/06/2022,0,1,16,17,20,9,12,41,0,6,8,14,0,0,0,0,11,4,1,16
168355,2022,Canada,Thailand,2,3,7,12,14/06/2022,1,0,1,2,17,7,13,37,1,1,3,5,0,0,0,0,5,0,2,7
168355,2022,Korea,Canada,0,4,5,9,5/6/2022,0,0,2,2,11,3,10,24,3,4,6,13,0,0,0,0,3,0,0,3
168355,2022,USA,Canada,0,3,3,6,4/6/2022,0,0,2,2,8,6,7,21,0,2,4,6,0,0,0,0,5,1,0,6
168355,2022,Canada,Dominican Republic,3,4,3,10,3/6/2022,0,0,2,2,13,5,12,30,2,0,2,4,0,0,0,0,8,0,0,8
168355,2022,Poland,Canada,1,7,9,17,1/6/2022,0,0,4,4,12,11,16,39,1,1,4,6,0,0,0,0,5,3,1,9
139514,2022,,,-,-,-,-,-,-,-,-,-,-,-,-,-,-,-,-,-,-,-,-,-,-,-,-,-
175158,2022,Netherlands,Canada,0,0,0,0,3/7/2022,0,0,0,0,0,0,0,0,0,0,0,0,0,0,0,0,0,0,0,0
175158,2022,Germany,Canada,0,0,0,0,3/7/2022,0,0,3,3,0,0,0,0,0,0,0,0,1,1,7,9,5,2,0,7
175158,2022,Serbia,Canada,0,0,0,0,2/7/2022,0,0,2,2,0,0,0,0,0,0,0,0,1,0,4,5,0,0,0,0
175158,2022,Canada,Türkiye,0,0,0,0,29/06/2022,0,0,6,6,0,0,1,1,0,0,0,0,7,4,13,24,7,4,1,12
175158,2022,Bulgaria,Canada,0,0,0,0,18/06/2022,0,0,12,12,0,0,0,0,0,0,0,0,4,0,9,13,8,3,0,11
175158,2022,China,Canada,0,0,0,0,17/06/2022,0,0,0,0,0,0,0,0,0,0,0,0,0,0,0,0,0,0,0,0
175158,2022,Canada,Belgium,0,0,0,0,16/06/2022,0,0,8,8,0,0,0,0,0,0,0,0,3,0,10,13,7,2,2,11
175158,2022,Canada,Thailand,0,0,0,0,14/06/2022,0,0,3,3,0,0,0,0,0,0,0,0,2,0,11,13,3,2,1,6
175158,2022,Korea,Canada,0,0,0,0,5/6/2022,0,0,2,2,0,0,0,0,0,0,0,0,5,0,1,6,11,3,1,15
175158,2022,USA,Canada,0,0,0,0,4/6/2022,0,0,0,0,0,0,0,0,0,0,0,0,0,0,0,0,0,0,0,0
175158,2022,Canada,Dominican Republic,0,0,0,0,3/6/2022,0,0,5,5,0,0,0,0,0,0,0,0,8,2,7,17,13,1,1,15
175158,2022,Poland,Canada,0,0,0,0,1/6/2022,0,0,12,12,0,0,0,0,0,0,0,0,6,1,5,12,9,5,0,14
153629,2022,Netherlands,Canada,0,0,0,0,3/7/2022,0,0,0,0,0,0,0,0,0,0,0,0,0,0,0,0,0,0,0,0
153629,2022,Germany,Canada,0,0,0,0,3/7/2022,0,0,0,0,0,0,0,0,0,0,0,0,0,0,0,0,0,0,0,0
153629,2022,Serbia,Canada,0,0,0,0,2/7/2022,0,0,0,0,0,0,0,0,0,0,0,0,0,0,0,0,0,0,0,0
153629,2022,Canada,Türkiye,0,0,0,0,29/06/2022,0,0,0,0,0,0,0,0,0,0,0,0,0,0,0,0,0,0,0,0
153629,2022,Bulgaria,Canada,0,0,0,0,18/06/2022,0,0,0,0,0,0,0,0,0,0,0,0,0,0,0,0,0,0,0,0
153629,2022,China,Canada,0,0,4,4,17/06/2022,1,0,0,1,1,0,0,1,0,0,0,0,0,0,0,0,2,0,0,2
153629,2022,Canada,Belgium,0,0,0,0,16/06/2022,0,0,0,0,0,0,0,0,0,0,0,0,0,0,0,0,0,0,0,0
153629,2022,Canada,Thailand,0,0,0,0,14/06/2022,0,0,0,0,0,0,0,0,0,0,0,0,0,0,0,0,0,0,0,0
153629,2022,Korea,Canada,0,0,0,0,5/6/2022,0,0,0,0,0,0,0,0,0,0,0,0,0,0,0,0,0,0,0,0
153629,2022,USA,Canada,0,0,4,4,4/6/2022,0,0,1,1,2,0,1,3,1,1,1,3,1,0,1,2,0,0,0,0
153629,2022,Canada,Dominican Republic,0,0,0,0,3/6/2022,0,0,0,0,0,0,0,0,0,0,0,0,0,0,0,0,0,0,0,0
153629,2022,Poland,Canada,0,0,0,0,1/6/2022,0,0,0,0,0,0,0,0,0,0,0,0,0,0,0,0,0,0,0,0
189220,2022,,,-,-,-,-,-,-,-,-,-,-,-,-,-,-,-,-,-,-,-,-,-,-,-,-,-
142777,2022,Netherlands,Canada,0,0,0,0,3/7/2022,0,0,0,0,0,0,0,0,0,0,0,0,0,0,0,0,0,0,0,0
142777,2022,Germany,Canada,0,0,0,0,3/7/2022,0,0,0,0,0,0,0,0,0,0,0,0,0,0,0,0,0,0,0,0
142777,2022,Serbia,Canada,0,2,8,10,2/7/2022,0,0,0,0,4,0,2,6,2,4,2,8,0,0,0,0,0,0,0,0
142777,2022,Canada,Türkiye,0,0,0,0,29/06/2022,0,0,0,0,0,0,0,0,0,0,0,0,0,0,0,0,0,0,0,0
142777,2022,Bulgaria,Canada,0,0,0,0,18/06/2022,0,0,0,0,0,0,0,0,0,0,0,0,0,0,0,0,0,0,0,0
142777,2022,China,Canada,0,0,10,10,17/06/2022,0,0,3,3,2,1,3,6,1,3,13,17,0,0,0,0,1,1,0,2
142777,2022,Canada,Belgium,0,0,0,0,16/06/2022,0,0,0,0,0,0,0,0,0,0,0,0,0,0,0,0,0,0,0,0
142777,2022,Canada,Thailand,0,0,2,2,14/06/2022,0,0,0,0,0,0,0,0,0,1,1,2,0,0,0,0,0,0,0,0
132236,2022,Netherlands,Canada,0,0,21,21,3/7/2022,0,0,9,9,21,4,20,45,1,3,0,4,15,3,28,46,12,2,0,14
132236,2022,Germany,Canada,0,1,15,16,3/7/2022,0,0,1,1,26,8,20,54,0,0,0,0,6,2,10,18,12,3,0,15
132236,2022,Serbia,Canada,0,1,2,3,2/7/2022,0,1,0,1,4,3,10,17,0,0,0,0,2,0,4,6,1,0,0,1
132236,2022,Canada,Türkiye,0,1,15,16,29/06/2022,0,0,2,2,19,4,14,37,4,0,2,6,7,0,21,28,4,0,0,4
132236,2022,Bulgaria,Canada,1,0,8,9,18/06/2022,0,1,1,2,8,5,20,33,1,0,5,6,6,1,33,40,8,3,0,11
132236,2022,China,Canada,0,0,0,0,17/06/2022,0,0,0,0,0,0,0,0,0,0,0,0,0,0,0,0,0,0,0,0
132236,2022,Canada,Belgium,0,1,14,15,16/06/2022,0,0,2,2,23,4,16,43,1,1,2,4,6,0,28,34,10,4,0,14
132236,2022,Canada,Thailand,0,0,7,7,14/06/2022,0,0,0,0,12,4,18,34,1,6,2,9,5,3,29,37,3,3,0,6
132236,2022,Korea,Canada,0,1,15,16,5/6/2022,0,0,0,0,11,5,9,25,0,1,2,3,20,3,6,29,7,1,0,8
132236,2022,USA,Canada,0,0,9,9,4/6/2022,0,0,1,1,10,6,11,27,0,2,1,3,20,1,17,38,5,2,0,7
132236,2022,Canada,Dominican Republic,0,0,13,13,3/6/2022,0,0,1,1,18,4,5,27,1,2,3,6,9,0,6,15,9,1,0,10
132236,2022,Poland,Canada,0,0,14,14,1/6/2022,0,0,3,3,19,6,17,42,0,1,5,6,33,3,19,55,10,1,0,11
157583,2022,Netherlands,Canada,0,0,0,0,3/7/2022,0,0,0,0,0,0,0,0,0,0,0,0,0,0,0,0,0,0,0,0
157583,2022,Germany,Canada,0,0,0,0,3/7/2022,0,0,0,0,0,0,0,0,0,0,0,0,0,0,0,0,0,0,0,0
157583,2022,Serbia,Canada,0,0,0,0,2/7/2022,0,0,3,3,0,0,0,0,0,0,0,0,0,0,0,0,0,0,0,0
157583,2022,Canada,Türkiye,0,0,0,0,29/06/2022,0,0,0,0,0,0,0,0,0,0,0,0,0,0,0,0,0,0,0,0
157583,2022,Korea,Canada,0,0,0,0,5/6/2022,0,0,0,0,0,0,0,0,0,0,0,0,0,0,0,0,0,0,0,0
157583,2022,USA,Canada,0,1,0,1,4/6/2022,4,0,7,11,0,0,0,0,0,0,0,0,0,0,0,0,1,1,0,2
157583,2022,Canada,Dominican Republic,0,0,0,0,3/6/2022,0,0,0,0,0,0,0,0,0,0,0,0,0,0,0,0,0,0,0,0
157583,2022,Poland,Canada,0,1,0,1,1/6/2022,1,0,4,5,0,0,0,0,1,0,0,1,0,0,0,0,0,0,0,0
173581,2022,Netherlands,Canada,0,0,2,2,3/7/2022,0,0,0,0,4,1,3,8,0,1,1,2,1,0,1,2,3,0,0,3
173581,2022,Germany,Canada,0,1,3,4,3/7/2022,0,0,0,0,0,0,1,1,0,0,0,0,0,0,2,2,1,0,0,1
173581,2022,Serbia,Canada,1,0,11,12,2/7/2022,0,0,0,0,4,3,6,13,1,1,2,4,7,1,10,18,3,0,0,3
173581,2022,Canada,Türkiye,0,0,0,0,29/06/2022,0,0,0,0,0,0,0,0,0,0,0,0,0,0,0,0,0,0,0,0
173581,2022,Bulgaria,Canada,0,0,0,0,18/06/2022,0,0,0,0,0,0,0,0,0,0,0,0,0,0,0,0,0,0,0,0
173581,2022,China,Canada,0,1,1,2,17/06/2022,0,0,2,2,4,2,4,10,0,0,1,1,2,1,3,6,1,1,0,2
173581,2022,Canada,Belgium,0,0,1,1,16/06/2022,0,0,0,0,0,0,0,0,0,0,0,0,0,2,2,4,0,0,0,0
173581,2022,Canada,Thailand,1,3,6,10,14/06/2022,0,0,1,1,4,2,5,11,0,3,0,3,3,0,9,12,3,2,0,5
173581,2022,Korea,Canada,0,0,0,0,5/6/2022,0,0,0,0,0,0,0,0,0,0,0,0,0,0,0,0,0,0,0,0
173581,2022,USA,Canada,0,0,6,6,4/6/2022,0,0,2,2,6,2,11,19,1,0,1,2,5,0,5,10,5,0,0,5
173581,2022,Canada,Dominican Republic,0,0,0,0,3/6/2022,0,0,0,0,0,0,0,0,0,0,0,0,0,0,0,0,0,0,0,0
173581,2022,Poland,Canada,0,1,1,2,1/6/2022,0,0,0,0,0,0,0,0,0,0,0,0,3,0,0,3,2,0,0,2
139522,2022,Netherlands,Canada,2,0,19,21,3/7/2022,0,0,3,3,4,0,5,9,3,4,4,11,0,0,0,0,4,0,0,4
139522,2022,Germany,Canada,0,1,15,16,3/7/2022,0,0,3,3,9,0,2,11,3,4,3,10,0,0,0,0,1,1,0,2
139522,2022,Serbia,Canada,0,0,8,8,2/7/2022,0,0,0,0,2,0,2,4,0,1,0,1,0,0,0,0,0,0,0,0
139522,2022,Canada,Türkiye,0,1,15,16,29/06/2022,0,0,0,0,3,1,4,8,2,4,1,7,0,0,0,0,3,1,0,4
139522,2022,Bulgaria,Canada,0,0,12,12,18/06/2022,1,0,1,2,5,0,3,8,1,5,3,9,0,0,0,0,3,2,0,5
139522,2022,China,Canada,1,0,3,4,17/06/2022,0,0,0,0,0,2,0,2,1,2,1,4,0,0,1,1,1,0,0,1
139522,2022,Canada,Belgium,1,1,11,13,16/06/2022,0,0,1,1,3,0,2,5,5,3,7,15,0,0,0,0,1,2,0,3
139522,2022,Canada,Thailand,1,0,5,6,14/06/2022,0,0,0,0,3,0,4,7,1,1,4,6,0,0,0,0,0,0,0,0
139522,2022,Korea,Canada,2,0,13,15,5/6/2022,0,0,1,1,8,0,1,9,3,1,5,9,0,0,0,0,4,0,0,4
139522,2022,USA,Canada,0,1,4,5,4/6/2022,0,0,0,0,0,2,2,4,0,2,2,4,0,0,0,0,0,0,0,0
139522,2022,Canada,Dominican Republic,1,0,11,12,3/6/2022,0,0,2,2,3,0,1,4,1,2,6,9,0,0,0,0,2,0,0,2
139522,2022,Poland,Canada,0,1,11,12,1/6/2022,0,0,1,1,2,0,2,4,3,5,3,11,0,0,0,0,4,3,0,7
173585,2022,Netherlands,Canada,0,0,12,12,3/7/2022,0,2,128,130,1,1,1,3,2,1,1,4,0,0,0,0,15,3,0,18
173585,2022,Germany,Canada,0,1,15,16,3/7/2022,5,0,116,121,0,0,3,3,3,1,1,5,0,0,0,0,5,1,0,6
173585,2022,Serbia,Canada,0,0,13,13,2/7/2022,7,1,69,77,2,1,1,4,1,0,0,1,0,0,1,1,0,0,1,1
173585,2022,Canada,Türkiye,1,0,13,14,29/06/2022,0,3,92,95,1,0,3,4,3,2,0,5,0,0,0,0,3,0,0,3
173585,2022,Bulgaria,Canada,0,0,11,11,18/06/2022,14,0,70,84,1,0,4,5,1,8,4,13,0,0,0,0,7,3,1,11
173585,2022,China,Canada,1,1,9,11,17/06/2022,17,0,55,72,2,1,3,6,0,1,0,1,0,0,0,0,8,4,2,14
173585,2022,Canada,Belgium,1,0,18,19,16/06/2022,26,0,68,94,4,1,1,6,1,7,3,11,0,1,0,1,10,3,1,14
173585,2022,Canada,Thailand,1,1,10,12,14/06/2022,27,3,68,98,0,0,1,1,0,3,0,3,0,0,0,0,4,6,0,10
173585,2022,Korea,Canada,1,1,8,10,5/6/2022,20,0,48,68,1,0,2,3,3,1,2,6,0,0,0,0,5,1,1,7
173585,2022,USA,Canada,0,0,11,11,4/6/2022,9,0,56,65,3,0,1,4,2,0,0,2,1,0,0,1,13,3,0,16
173585,2022,Canada,Dominican Republic,1,0,15,16,3/6/2022,15,0,51,66,2,0,1,3,0,1,0,1,0,1,0,1,9,1,1,11
173585,2022,Poland,Canada,1,1,12,14,1/6/2022,12,1,75,88,0,0,4,4,1,1,2,4,0,0,0,0,14,3,1,18
174676,2022,Netherlands,Canada,0,3,7,10,3/7/2022,0,0,3,3,6,6,15,27,1,3,3,7,8,3,15,26,6,0,0,6
174676,2022,Germany,Canada,0,3,10,13,3/7/2022,0,0,2,2,6,2,11,19,0,2,0,2,16,1,16,33,17,2,0,19
174676,2022,Serbia,Canada,0,3,12,15,2/7/2022,0,0,3,3,8,5,20,33,3,1,4,8,7,2,35,44,1,0,0,1
174676,2022,Canada,Türkiye,2,4,10,16,29/06/2022,0,0,3,3,8,5,5,18,4,1,1,6,11,1,21,33,5,0,0,5
174676,2022,Bulgaria,Canada,2,0,10,12,18/06/2022,0,0,1,1,5,4,3,12,0,0,3,3,1,2,9,12,8,1,0,9
174676,2022,China,Canada,0,3,6,9,17/06/2022,0,0,6,6,11,5,14,30,0,1,5,6,3,6,26,35,5,1,2,8
174676,2022,Canada,Belgium,0,4,6,10,16/06/2022,0,0,0,0,12,5,8,25,2,2,2,6,1,2,26,29,9,0,1,10
174676,2022,Canada,Thailand,1,0,3,4,14/06/2022,0,0,0,0,0,2,4,6,1,0,0,1,1,0,3,4,1,0,0,1
174676,2022,Korea,Canada,0,1,5,6,5/6/2022,0,0,1,1,6,1,10,17,0,2,1,3,5,0,3,8,5,2,1,8
174676,2022,USA,Canada,0,1,0,1,4/6/2022,0,0,1,1,0,0,2,2,1,0,0,1,1,0,3,4,1,1,0,2
174676,2022,Canada,Dominican Republic,2,2,8,12,3/6/2022,0,0,5,5,4,2,10,16,3,2,1,6,4,2,4,10,8,2,0,10
174676,2022,Poland,Canada,0,4,8,12,1/6/2022,0,0,3,3,8,4,11,23,1,2,1,4,3,2,2,7,10,1,0,11
166581,2022,,,-,-,-,-,-,-,-,-,-,-,-,-,-,-,-,-,-,-,-,-,-,-,-,-,-
174680,2022,Netherlands,Canada,0,1,5,6,3/7/2022,0,0,0,0,0,0,0,0,0,0,0,0,0,0,0,0,0,0,0,0
174680,2022,Germany,Canada,0,0,5,5,3/7/2022,0,0,0,0,0,0,0,0,0,0,0,0,0,0,0,0,1,1,0,2
174680,2022,Serbia,Canada,0,0,2,2,2/7/2022,0,0,0,0,2,0,1,3,0,0,0,0,0,0,0,0,0,0,0,0
174680,2022,Canada,Türkiye,1,0,6,7,29/06/2022,0,0,0,0,0,0,0,0,0,0,0,0,0,0,0,0,3,0,0,3
174680,2022,Bulgaria,Canada,0,2,1,3,18/06/2022,0,0,0,0,0,0,0,0,0,1,0,1,2,0,2,4,1,0,0,1
174680,2022,China,Canada,1,0,9,10,17/06/2022,0,0,2,2,6,3,10,19,0,0,1,1,6,1,19,26,9,1,0,10
174680,2022,Canada,Belgium,0,0,9,9,16/06/2022,0,0,0,0,0,0,0,0,0,0,0,0,0,0,0,0,1,0,0,1
174680,2022,Canada,Thailand,0,0,2,2,14/06/2022,0,0,0,0,0,0,0,0,0,0,0,0,2,0,2,4,0,0,0,0
174680,2022,Korea,Canada,0,1,1,2,5/6/2022,0,0,0,0,0,0,0,0,0,0,0,0,0,1,0,1,1,0,0,1
174680,2022,USA,Canada,0,1,1,2,4/6/2022,0,0,0,0,2,0,1,3,0,0,0,0,2,1,1,4,2,0,0,2
174680,2022,Canada,Dominican Republic,0,0,0,0,3/6/2022,0,0,0,0,0,0,0,0,0,0,0,0,0,0,0,0,0,0,0,0
174680,2022,Poland,Canada,0,1,0,1,1/6/2022,0,0,0,0,0,0,0,0,0,0,0,0,0,0,0,0,1,1,1,3
170054,2022,Korea,Canada,0,0,0,0,5/6/2022,0,0,0,0,0,0,0,0,0,0,0,0,0,0,0,0,0,0,0,0
170054,2022,USA,Canada,0,0,0,0,4/6/2022,0,0,13,13,0,0,0,0,0,0,0,0,4,0,2,6,9,2,0,11
170054,2022,Canada,Dominican Republic,0,0,0,0,3/6/2022,0,0,0,0,0,0,0,0,0,0,0,0,0,0,0,0,0,0,0,0
170054,2022,Poland,Canada,0,0,0,0,1/6/2022,0,0,0,0,0,0,0,0,0,0,0,0,0,0,0,0,0,0,0,0
156485,2022,Bulgaria,Canada,0,0,0,0,18/06/2022,0,0,0,0,0,0,0,0,0,0,0,0,0,0,0,0,0,0,0,0
156485,2022,China,Canada,0,0,1,1,17/06/2022,3,0,16,19,0,0,0,0,0,0,1,1,0,0,0,0,1,0,2,3
156485,2022,Canada,Belgium,0,0,0,0,16/06/2022,0,0,0,0,0,0,0,0,0,0,0,0,0,0,0,0,0,0,0,0
156485,2022,Canada,Thailand,0,0,0,0,14/06/2022,0,0,0,0,0,0,0,0,0,0,0,0,0,0,0,0,0,0,0,0
168354,2022,Netherlands,Canada,0,2,3,5,3/7/2022,0,0,3,3,8,2,7,17,4,7,4,15,1,1,0,2,5,1,0,6
168354,2022,Germany,Canada,0,2,7,9,3/7/2022,0,0,0,0,5,0,9,14,4,5,4,13,1,0,2,3,1,0,0,1
168354,2022,Serbia,Canada,0,0,10,10,2/7/2022,0,0,0,0,7,2,5,14,4,2,3,9,1,0,1,2,2,0,0,2
168354,2022,Canada,Türkiye,0,1,12,13,29/06/2022,0,0,2,2,6,0,7,13,1,3,0,4,0,0,0,0,0,0,0,0
168354,2022,Bulgaria,Canada,1,1,6,8,18/06/2022,0,0,0,0,9,0,5,14,3,8,2,13,0,0,0,0,4,1,0,5
168354,2022,China,Canada,1,2,7,10,17/06/2022,0,0,1,1,7,0,3,10,1,4,0,5,0,0,0,0,2,1,0,3
168354,2022,Canada,Belgium,0,3,12,15,16/06/2022,0,0,1,1,7,2,3,12,2,1,1,4,0,0,3,3,4,0,0,4
168354,2022,Canada,Thailand,0,4,6,10,14/06/2022,0,0,0,0,7,0,5,12,1,3,3,7,0,0,0,0,0,0,0,0
168354,2022,Korea,Canada,1,1,13,15,5/6/2022,0,0,1,1,6,1,4,11,3,2,5,10,2,0,0,2,6,0,1,7
168354,2022,USA,Canada,0,1,6,7,4/6/2022,0,0,1,1,5,1,7,13,1,3,3,7,0,0,0,0,1,0,0,1
168354,2022,Canada,Dominican Republic,1,0,9,10,3/6/2022,0,0,1,1,3,1,2,6,2,1,2,5,0,0,1,1,4,1,0,5
168354,2022,Poland,Canada,0,3,11,14,1/6/2022,0,0,1,1,7,1,3,11,0,4,2,6,3,0,1,4,3,1,0,4
181280,2022,Netherlands,Canada,0,0,0,0,3/7/2022,0,0,14,14,0,0,0,0,0,0,0,0,7,0,10,17,14,3,0,17
181280,2022,Germany,Canada,0,0,0,0,3/7/2022,0,0,5,5,0,0,0,0,0,0,0,0,9,0,10,19,8,1,0,9
181280,2022,Serbia,Canada,0,0,0,0,2/7/2022,0,0,3,3,0,0,0,0,0,0,0,0,1,0,5,6,1,1,0,2
181280,2022,Canada,Türkiye,0,0,0,0,29/06/2022,0,0,0,0,0,0,0,0,0,0,0,0,0,0,0,0,0,0,0,0
181280,2022,Bulgaria,Canada,0,0,0,0,18/06/2022,0,0,0,0,0,0,0,0,0,0,0,0,0,0,0,0,0,0,0,0
181280,2022,China,Canada,0,0,0,0,17/06/2022,2,0,6,8,0,0,0,0,0,0,0,0,3,1,13,17,14,4,1,19
181280,2022,Canada,Belgium,0,0,0,0,16/06/2022,0,0,0,0,0,0,0,0,0,0,0,0,0,0,0,0,0,0,0,0
181280,2022,Canada,Thailand,0,0,0,0,14/06/2022,0,0,0,0,0,0,0,0,0,0,0,0,0,0,0,0,0,0,0,0
181279,2022,,,-,-,-,-,-,-,-,-,-,-,-,-,-,-,-,-,-,-,-,-,-,-,-,-,-
181178,2022,,,-,-,-,-,-,-,-,-,-,-,-,-,-,-,-,-,-,-,-,-,-,-,-,-,-
189157,2022,,,-,-,-,-,-,-,-,-,-,-,-,-,-,-,-,-,-,-,-,-,-,-,-,-,-
174681,2022,,,-,-,-,-,-,-,-,-,-,-,-,-,-,-,-,-,-,-,-,-,-,-,-,-,-
189156,2022,Netherlands,Canada,0,0,0,0,3/7/2022,0,0,0,0,0,0,0,0,0,0,0,0,0,0,0,0,0,0,0,0
189156,2022,Germany,Canada,0,0,0,0,3/7/2022,0,0,0,0,0,0,0,0,0,0,0,0,0,0,0,0,0,0,0,0
189156,2022,Serbia,Canada,0,0,0,0,2/7/2022,0,0,0,0,0,0,0,0,0,0,0,0,0,0,0,0,0,0,0,0
189156,2022,Canada,Türkiye,0,0,0,0,29/06/2022,0,0,0,0,0,0,0,0,0,0,0,0,0,0,0,0,0,0,0,0
189156,2022,Bulgaria,Canada,0,0,0,0,18/06/2022,0,0,0,0,0,0,0,0,0,0,0,0,0,0,0,0,0,0,0,0
189156,2022,China,Canada,0,1,0,1,17/06/2022,0,0,0,0,0,0,2,2,0,0,0,0,0,0,0,0,0,2,0,2
189156,2022,Canada,Belgium,0,0,0,0,16/06/2022,0,0,0,0,0,0,0,0,0,0,0,0,0,0,0,0,0,0,0,0
189156,2022,Canada,Thailand,0,0,0,0,14/06/2022,0,0,0,0,0,0,0,0,0,0,0,0,0,0,0,0,0,0,0,0
189156,2022,Korea,Canada,0,0,0,0,5/6/2022,0,0,0,0,0,0,0,0,0,0,0,0,0,0,0,0,0,0,0,0
189156,2022,USA,Canada,1,2,2,5,4/6/2022,0,0,0,0,0,2,3,5,0,1,0,1,0,0,0,0,1,1,0,2
189156,2022,Canada,Dominican Republic,0,0,0,0,3/6/2022,0,0,0,0,0,0,0,0,0,0,0,0,0,0,0,0,0,0,0,0
189156,2022,Poland,Canada,1,1,2,4,1/6/2022,0,0,0,0,1,0,0,1,0,0,0,0,0,0,0,0,1,0,0,1
135746,2022,Italy,China,0,0,16,16,14/07/2022,0,0,1,1,7,1,7,15,2,3,5,10,0,1,2,3,1,0,0,1
135746,2022,China,Korea,0,2,12,14,3/7/2022,0,0,0,0,9,3,7,19,2,6,9,17,1,0,0,1,2,1,1,4
135746,2022,China,Dominican Republic,2,0,17,19,1/7/2022,1,0,0,1,7,0,7,14,1,10,4,15,0,0,0,0,1,0,3,4
135746,2022,Poland,China,1,0,11,12,30/06/2022,0,0,3,3,5,1,7,13,2,4,2,8,0,0,0,0,0,0,0,0
135746,2022,China,Brazil,0,1,16,17,28/06/2022,0,0,1,1,10,1,8,19,2,8,1,11,0,0,0,0,2,1,0,3
135746,2022,Japan,China,1,1,7,9,19/06/2022,0,0,1,1,5,1,4,10,3,7,6,16,0,0,0,0,1,1,0,2
135746,2022,USA,China,1,0,8,9,18/06/2022,0,1,1,2,3,0,7,10,1,5,5,11,0,0,0,0,2,0,1,3
135746,2022,China,Canada,1,0,16,17,17/06/2022,1,0,1,2,4,1,10,15,3,6,7,16,0,0,0,0,3,1,0,4
135746,2022,China,Belgium,0,0,9,9,15/06/2022,0,0,1,1,5,0,4,9,1,2,5,8,0,0,0,0,1,0,0,1
135746,2022,Thailand,China,3,1,14,18,5/6/2022,1,0,2,3,6,1,10,17,2,9,9,20,0,0,0,0,4,0,3,7
135746,2022,China,Italy,0,1,11,12,4/6/2022,1,0,0,1,6,0,5,11,4,11,4,19,0,0,0,0,2,0,0,2
135746,2022,Türkiye,China,1,2,13,16,3/6/2022,0,0,1,1,7,2,6,15,3,3,6,12,0,0,1,1,2,0,1,3
135746,2022,China,Netherlands,0,0,13,13,1/6/2022,0,0,3,3,7,1,3,11,4,7,10,21,0,0,0,0,1,1,2,4
162354,2022,Italy,China,0,0,17,17,14/07/2022,30,0,70,100,0,0,1,1,0,3,5,8,0,0,0,0,10,2,2,14
162354,2022,China,Korea,0,0,15,15,3/7/2022,8,0,86,94,0,0,1,1,0,2,4,6,0,0,0,0,5,2,2,9
162354,2022,China,Dominican Republic,0,1,7,8,1/7/2022,64,0,0,64,2,0,0,2,3,5,6,14,0,0,0,0,5,0,2,7
162354,2022,Poland,China,0,2,8,10,30/06/2022,0,2,60,62,1,0,0,1,1,1,1,3,0,0,0,0,8,2,3,13
162354,2022,China,Brazil,1,0,20,21,28/06/2022,32,1,69,102,1,0,1,2,1,5,6,12,0,0,0,0,7,0,3,10
162354,2022,China,Belgium,0,0,0,0,15/06/2022,0,0,0,0,0,0,0,0,0,0,0,0,0,0,0,0,0,0,0,0
162354,2022,Thailand,China,0,0,6,6,5/6/2022,26,0,22,48,1,2,0,3,0,1,1,2,0,0,0,0,5,0,1,6
162354,2022,China,Italy,0,0,6,6,4/6/2022,25,0,12,37,1,0,0,1,0,2,0,2,0,0,1,1,3,5,0,8
162354,2022,Türkiye,China,1,1,15,17,3/6/2022,48,0,39,87,3,0,0,3,2,3,1,6,0,0,1,1,1,2,0,3
162354,2022,China,Netherlands,2,0,12,14,1/6/2022,22,1,71,94,1,0,2,3,3,3,5,11,0,0,0,0,6,5,7,18
152337,2022,Italy,China,0,0,0,0,14/07/2022,0,0,0,0,0,0,0,0,0,0,0,0,0,0,0,0,0,0,0,0
152337,2022,China,Korea,0,0,0,0,3/7/2022,0,0,0,0,0,0,0,0,0,0,0,0,0,0,0,0,0,0,0,0
152337,2022,China,Dominican Republic,0,0,0,0,1/7/2022,0,0,0,0,0,0,0,0,0,0,0,0,0,0,0,0,0,0,0,0
152337,2022,Poland,China,0,0,0,0,30/06/2022,0,0,0,0,0,0,0,0,0,0,0,0,0,0,0,0,0,0,0,0
152337,2022,China,Brazil,0,0,0,0,28/06/2022,0,0,0,0,0,0,0,0,0,0,0,0,0,0,0,0,0,0,0,0
152337,2022,Japan,China,0,0,0,0,19/06/2022,0,0,0,0,0,0,0,0,0,0,0,0,0,0,0,0,0,0,0,0
152337,2022,USA,China,1,1,3,5,18/06/2022,0,0,1,1,2,0,5,7,1,2,1,4,0,0,0,0,0,0,0,0
152337,2022,China,Canada,0,0,1,1,17/06/2022,0,0,2,2,2,0,0,2,0,0,2,2,0,0,0,0,0,0,0,0
152337,2022,China,Belgium,0,0,0,0,15/06/2022,0,0,0,0,0,0,0,0,0,0,0,0,0,0,0,0,0,0,0,0
152337,2022,Thailand,China,0,0,0,0,5/6/2022,0,0,0,0,0,0,0,0,0,0,0,0,0,0,0,0,0,0,0,0
152337,2022,China,Italy,0,0,0,0,4/6/2022,0,0,0,0,0,0,0,0,0,0,0,0,0,0,0,0,0,0,0,0
152337,2022,Türkiye,China,0,0,0,0,3/6/2022,0,0,0,0,0,0,0,0,0,0,0,0,0,0,0,0,0,0,0,0
152337,2022,China,Netherlands,0,0,0,0,1/6/2022,0,0,0,0,0,0,0,0,0,0,0,0,0,0,0,0,0,0,0,0
152332,2022,Italy,China,0,0,0,0,14/07/2022,0,0,0,0,0,0,0,0,0,0,0,0,0,0,0,0,0,0,0,0
152332,2022,China,Korea,0,0,0,0,3/7/2022,0,0,0,0,0,0,0,0,0,0,0,0,0,0,0,0,0,0,0,0
152332,2022,China,Dominican Republic,0,0,0,0,1/7/2022,0,0,0,0,0,0,0,0,0,0,0,0,0,0,0,0,0,0,0,0
152332,2022,Poland,China,0,0,0,0,30/06/2022,0,0,0,0,0,0,0,0,0,0,0,0,0,0,0,0,0,0,0,0
152332,2022,China,Brazil,0,0,0,0,28/06/2022,0,0,0,0,0,0,0,0,0,0,0,0,0,0,0,0,0,0,0,0
143206,2022,Italy,China,0,0,12,12,14/07/2022,0,0,5,5,18,3,13,34,2,4,3,9,4,2,6,12,12,2,1,15
143206,2022,China,Korea,1,0,16,17,3/7/2022,0,0,0,0,13,3,10,26,3,7,2,12,1,0,2,3,3,0,2,5
143206,2022,China,Dominican Republic,1,0,10,11,1/7/2022,2,1,0,3,9,2,8,19,0,4,0,4,2,2,1,5,6,1,0,7
143206,2022,Poland,China,1,1,10,12,30/06/2022,0,0,1,1,9,2,4,15,1,1,1,3,5,0,3,8,4,0,1,5
143206,2022,China,Brazil,1,0,14,15,28/06/2022,2,0,11,13,14,6,13,33,2,7,2,11,4,0,15,19,9,3,2,14
143206,2022,Japan,China,2,0,17,19,19/06/2022,0,1,5,6,9,4,16,29,1,3,4,8,2,1,10,13,5,1,2,8
143206,2022,USA,China,0,1,11,12,18/06/2022,0,0,3,3,9,3,6,18,2,3,1,6,4,0,1,5,8,3,1,12
143206,2022,China,Canada,1,2,11,14,17/06/2022,0,0,5,5,13,1,17,31,1,2,1,4,3,0,7,10,17,2,0,19
143206,2022,China,Belgium,0,0,16,16,15/06/2022,0,0,0,0,15,0,7,22,3,1,2,6,2,0,0,2,7,2,0,9
143206,2022,Thailand,China,1,0,18,19,5/6/2022,1,0,4,5,18,3,17,38,1,1,5,7,7,1,8,16,12,1,1,14
143206,2022,China,Italy,1,0,9,10,4/6/2022,0,0,1,1,13,4,7,24,2,3,1,6,6,0,13,19,9,1,0,10
143206,2022,Türkiye,China,0,1,20,21,3/6/2022,0,0,6,6,12,6,6,24,0,1,2,3,8,1,2,11,12,1,5,18
143206,2022,China,Netherlands,1,0,13,14,1/6/2022,0,1,5,6,19,1,17,37,0,5,2,7,4,1,16,21,6,3,6,15
143201,2022,Italy,China,1,1,10,12,14/07/2022,0,0,5,5,6,0,2,8,5,4,5,14,1,0,0,1,4,0,1,5
143201,2022,China,Korea,0,2,18,20,3/7/2022,0,0,3,3,8,0,6,14,2,6,3,11,0,0,0,0,0,0,2,2
143201,2022,China,Dominican Republic,0,0,10,10,1/7/2022,4,0,0,4,6,1,3,10,1,4,4,9,1,0,2,3,1,0,1,2
143201,2022,Poland,China,0,1,6,7,30/06/2022,0,0,0,0,6,0,2,8,3,1,2,6,0,0,0,0,1,0,1,2
143201,2022,China,Brazil,1,1,13,15,28/06/2022,1,0,2,3,9,1,1,11,5,3,3,11,0,0,1,1,2,0,0,2
143201,2022,Japan,China,0,0,8,8,19/06/2022,0,0,1,1,1,3,4,8,3,0,5,8,0,0,1,1,2,0,0,2
143201,2022,USA,China,0,0,7,7,18/06/2022,0,0,0,0,2,0,1,3,0,4,1,5,0,1,0,1,2,0,0,2
143201,2022,China,Canada,1,1,12,14,17/06/2022,0,0,0,0,7,2,4,13,4,3,6,13,1,0,1,2,4,0,0,4
143201,2022,China,Belgium,1,1,11,13,15/06/2022,0,0,1,1,7,1,1,9,1,5,5,11,0,0,0,0,2,2,0,4
143201,2022,Thailand,China,0,0,18,18,5/6/2022,0,0,2,2,9,2,6,17,1,6,6,13,0,0,0,0,4,4,3,11
143201,2022,China,Italy,0,0,13,13,4/6/2022,0,0,3,3,4,1,6,11,2,5,12,19,0,0,0,0,2,0,1,3
143201,2022,Türkiye,China,0,1,10,11,3/6/2022,0,0,2,2,5,3,5,13,3,3,5,11,1,0,3,4,2,0,0,2
143201,2022,China,Netherlands,0,2,6,8,1/6/2022,0,0,6,6,18,4,7,29,3,6,9,18,0,0,0,0,1,0,3,4
152917,2022,Italy,China,0,0,1,1,14/07/2022,0,0,0,0,0,0,0,0,0,0,0,0,0,0,0,0,0,1,0,1
152917,2022,China,Korea,1,1,9,11,3/7/2022,0,0,3,3,4,4,4,12,1,2,1,4,4,1,9,14,6,0,0,6
152917,2022,China,Dominican Republic,0,0,10,10,1/7/2022,0,0,0,0,5,2,7,14,2,0,1,3,1,0,8,9,5,1,0,6
152917,2022,Poland,China,0,0,14,14,30/06/2022,0,0,1,1,7,3,9,19,1,1,2,4,4,0,5,9,6,1,0,7
152917,2022,China,Brazil,0,0,12,12,28/06/2022,0,0,1,1,2,1,7,10,0,2,2,4,2,3,12,17,6,1,0,7
152917,2022,Japan,China,0,1,3,4,19/06/2022,0,0,0,0,4,1,3,8,0,0,0,0,1,0,3,4,2,1,0,3
152917,2022,USA,China,0,0,12,12,18/06/2022,0,0,2,2,7,2,4,13,0,2,1,3,1,1,8,10,3,2,0,5
152917,2022,China,Canada,1,0,4,5,17/06/2022,0,0,1,1,2,0,4,6,0,1,0,1,1,0,2,3,2,0,0,2
152917,2022,China,Belgium,0,0,13,13,15/06/2022,0,0,1,1,7,0,9,16,1,3,2,6,8,1,11,20,7,3,0,10
152917,2022,Thailand,China,0,0,3,3,5/6/2022,0,0,0,0,1,2,1,4,0,1,0,1,0,0,5,5,4,0,0,4
152917,2022,China,Italy,0,1,11,12,4/6/2022,0,0,2,2,4,0,7,11,2,1,1,4,0,1,6,7,3,0,0,3
152917,2022,Türkiye,China,0,1,8,9,3/6/2022,0,0,2,2,6,5,4,15,0,1,3,4,4,0,9,13,6,1,1,8
152917,2022,China,Netherlands,0,0,2,2,1/6/2022,0,0,0,0,1,2,4,7,0,1,0,1,0,0,5,5,0,1,1,2
135740,2022,Italy,China,1,3,18,22,14/07/2022,0,0,5,5,9,3,19,31,0,4,1,5,10,1,9,20,6,3,0,9
135740,2022,China,Korea,0,2,3,5,3/7/2022,1,0,0,1,3,2,4,9,1,1,0,2,4,0,7,11,1,2,1,4
135740,2022,China,Dominican Republic,0,0,0,0,1/7/2022,0,0,0,0,0,0,0,0,0,0,0,0,0,0,0,0,0,0,0,0
135740,2022,Poland,China,0,0,0,0,30/06/2022,0,0,0,0,0,0,0,0,0,0,0,0,0,0,0,0,0,0,0,0
135740,2022,China,Brazil,0,2,5,7,28/06/2022,0,0,3,3,3,2,8,13,0,1,0,1,5,0,3,8,5,0,0,5
135740,2022,Japan,China,1,0,7,8,19/06/2022,1,0,3,4,3,3,7,13,1,2,1,4,6,4,15,25,3,2,1,6
135740,2022,USA,China,0,0,0,0,18/06/2022,0,0,0,0,0,0,3,3,0,0,0,0,0,0,0,0,0,0,0,0
135740,2022,China,Canada,2,2,12,16,17/06/2022,0,0,4,4,4,1,16,21,1,0,0,1,2,1,8,11,6,0,0,6
135740,2022,China,Belgium,0,0,2,2,15/06/2022,0,0,0,0,2,1,4,7,1,2,1,4,0,0,5,5,4,0,0,4
135740,2022,Thailand,China,2,1,12,15,5/6/2022,1,0,2,3,7,3,7,17,2,4,2,8,9,1,20,30,9,3,0,12
135740,2022,China,Italy,0,0,10,10,4/6/2022,0,0,1,1,4,2,8,14,1,1,0,2,3,0,7,10,6,2,1,9
135740,2022,Türkiye,China,0,1,3,4,3/6/2022,0,0,0,0,1,0,0,1,0,0,1,1,3,0,6,9,1,2,0,3
135740,2022,China,Netherlands,0,0,18,18,1/6/2022,0,0,2,2,3,4,7,14,1,0,2,3,9,0,25,34,7,4,5,16
172644,2022,Italy,China,0,0,0,0,14/07/2022,0,0,0,0,0,0,0,0,0,0,0,0,0,0,0,0,0,0,0,0
172644,2022,China,Belgium,0,0,0,0,15/06/2022,0,0,0,0,0,0,0,0,0,0,0,0,0,0,0,0,0,0,0,0
172644,2022,Thailand,China,0,0,2,2,5/6/2022,0,0,0,0,0,0,0,0,0,0,0,0,0,0,0,0,1,0,0,1
172644,2022,China,Italy,0,0,0,0,4/6/2022,0,0,0,0,0,0,0,0,0,0,0,0,0,0,0,0,0,0,0,0
172644,2022,Türkiye,China,0,0,2,2,3/6/2022,0,0,0,0,0,0,0,0,0,0,0,0,0,0,0,0,0,0,0,0
172644,2022,China,Netherlands,0,1,2,3,1/6/2022,0,0,0,0,0,0,0,0,0,0,0,0,0,0,0,0,0,0,0,0
152318,2022,Italy,China,0,2,8,10,14/07/2022,0,0,8,8,14,8,13,35,2,8,4,14,13,1,11,25,14,2,0,16
152318,2022,China,Korea,2,2,7,11,3/7/2022,0,1,1,2,18,3,16,37,3,4,2,9,9,1,17,27,11,3,4,18
152318,2022,China,Dominican Republic,2,0,14,16,1/7/2022,0,0,0,0,12,5,7,24,1,1,0,2,8,0,6,14,3,1,0,4
152318,2022,Poland,China,1,4,9,14,30/06/2022,0,0,0,0,11,4,9,24,3,1,0,4,5,0,5,10,3,2,1,6
152318,2022,China,Brazil,0,1,13,14,28/06/2022,0,0,3,3,20,11,20,51,1,4,4,9,7,0,22,29,7,1,4,12
152318,2022,Japan,China,0,3,10,13,19/06/2022,0,0,3,3,25,7,16,48,2,4,1,7,10,1,14,25,12,4,1,17
152318,2022,USA,China,0,2,7,9,18/06/2022,0,1,0,1,12,4,5,21,1,2,3,6,7,2,6,15,6,2,0,8
152318,2022,China,Canada,3,0,15,18,17/06/2022,0,0,3,3,17,8,7,32,0,0,2,2,5,1,8,14,8,3,1,12
152318,2022,China,Belgium,0,1,4,5,15/06/2022,0,0,0,0,8,2,8,18,1,5,0,6,1,0,8,9,3,2,2,7
152318,2022,Thailand,China,1,1,16,18,5/6/2022,1,0,2,3,26,6,22,54,0,6,3,9,4,0,6,10,14,3,3,20
152318,2022,China,Italy,3,3,15,21,4/6/2022,0,0,0,0,15,3,14,32,3,0,4,7,1,1,17,19,7,3,2,12
152318,2022,Türkiye,China,1,2,11,14,3/6/2022,0,0,0,0,20,2,15,37,1,6,1,8,7,1,12,20,7,4,4,15
152318,2022,China,Netherlands,0,1,13,14,1/6/2022,0,1,1,2,19,3,23,45,0,5,4,9,5,0,11,16,6,6,5,17
152326,2022,China,Korea,0,0,0,0,3/7/2022,0,0,0,0,0,0,0,0,0,0,0,0,0,0,0,0,0,0,0,0
152326,2022,China,Dominican Republic,0,0,0,0,1/7/2022,0,0,0,0,0,0,0,0,0,0,0,0,0,0,0,0,0,0,0,0
152326,2022,Poland,China,0,0,2,2,30/06/2022,0,0,0,0,0,0,0,0,0,0,0,0,0,0,0,0,0,0,0,0
152326,2022,China,Brazil,0,0,3,3,28/06/2022,0,0,0,0,0,0,0,0,0,0,0,0,0,0,0,0,0,1,0,1
135742,2022,Japan,China,0,0,3,3,19/06/2022,0,0,1,1,0,1,1,2,0,4,1,5,0,0,0,0,1,1,0,2
135742,2022,USA,China,0,0,0,0,18/06/2022,0,0,0,0,0,0,0,0,0,0,0,0,0,0,0,0,0,0,0,0
135742,2022,China,Canada,0,0,0,0,17/06/2022,0,0,0,0,0,0,0,0,0,0,0,0,0,0,0,0,0,0,0,0
135742,2022,China,Belgium,0,0,0,0,15/06/2022,0,0,0,0,0,0,0,0,0,0,0,0,0,0,0,0,0,0,0,0
135742,2022,Thailand,China,0,0,0,0,5/6/2022,0,0,0,0,0,0,0,0,0,0,0,0,0,0,0,0,0,0,0,0
135742,2022,China,Italy,0,0,0,0,4/6/2022,0,0,0,0,0,0,0,0,0,0,0,0,0,0,0,0,0,0,0,0
135742,2022,Türkiye,China,0,0,0,0,3/6/2022,0,0,0,0,0,0,0,0,0,0,0,0,0,0,0,0,0,0,0,0
135742,2022,China,Netherlands,0,0,0,0,1/6/2022,0,0,0,0,0,0,0,0,0,0,0,0,0,0,0,0,0,0,0,0
150705,2022,Italy,China,0,0,0,0,14/07/2022,0,0,7,7,0,0,0,0,0,0,0,0,2,3,23,28,14,2,2,18
150705,2022,China,Korea,0,0,0,0,3/7/2022,0,0,1,1,0,0,0,0,0,0,0,0,2,2,9,13,4,2,3,9
150705,2022,China,Dominican Republic,0,0,0,0,1/7/2022,2,0,0,2,0,0,0,0,0,0,0,0,2,1,10,13,4,2,2,8
150705,2022,Poland,China,0,0,0,0,30/06/2022,0,0,8,8,0,0,0,0,0,0,0,0,4,1,10,15,14,2,4,20
150705,2022,China,Brazil,0,0,0,0,28/06/2022,0,0,4,4,0,0,0,0,0,0,0,0,4,0,13,17,13,0,1,14
150705,2022,Japan,China,0,0,0,0,19/06/2022,0,0,5,5,0,0,0,0,0,0,0,0,4,0,3,7,7,1,0,8
150705,2022,USA,China,0,0,0,0,18/06/2022,0,0,1,1,0,0,0,0,0,0,0,0,5,4,22,31,6,2,0,8
150705,2022,China,Canada,0,0,0,0,17/06/2022,0,0,4,4,0,0,0,0,0,0,0,0,2,2,6,10,4,1,0,5
150705,2022,China,Belgium,0,0,0,0,15/06/2022,0,0,5,5,0,0,0,0,0,0,0,0,1,1,12,14,4,1,1,6
150705,2022,Thailand,China,0,0,0,0,5/6/2022,1,0,3,4,0,0,0,0,0,0,0,0,3,0,13,16,5,2,2,9
150705,2022,China,Italy,0,0,0,0,4/6/2022,0,0,3,3,0,0,0,0,0,0,0,0,3,2,7,12,4,3,6,13
150705,2022,Türkiye,China,0,0,0,0,3/6/2022,0,0,4,4,0,0,0,0,0,0,0,0,3,0,8,11,10,2,1,13
150705,2022,China,Netherlands,0,0,0,0,1/6/2022,0,0,12,12,0,0,0,0,0,0,0,0,3,0,12,15,14,5,2,21
124130,2022,Italy,China,0,0,0,0,14/07/2022,0,0,3,3,0,0,0,0,0,0,0,0,0,0,0,0,0,0,0,0
124130,2022,China,Korea,0,0,1,1,3/7/2022,1,0,10,11,0,0,0,0,0,0,0,0,0,0,0,0,0,1,0,1
124130,2022,China,Dominican Republic,0,0,0,0,1/7/2022,0,0,0,0,0,0,0,0,0,0,0,0,0,0,0,0,0,0,0,0
124130,2022,Poland,China,0,0,0,0,30/06/2022,0,0,3,3,0,0,0,0,0,0,1,1,0,0,0,0,0,0,0,0
124130,2022,China,Brazil,0,0,0,0,28/06/2022,1,0,2,3,0,0,0,0,0,0,0,0,0,0,0,0,1,0,0,1
124130,2022,Japan,China,0,0,13,13,19/06/2022,32,3,60,95,0,3,1,4,2,2,4,8,0,0,0,0,7,0,1,8
124130,2022,USA,China,1,1,11,13,18/06/2022,16,1,50,67,0,0,0,0,0,6,4,10,0,0,0,0,3,1,0,4
124130,2022,China,Canada,0,0,7,7,17/06/2022,23,0,70,93,1,0,1,2,1,2,2,5,0,0,1,1,8,2,2,12
124130,2022,China,Belgium,1,2,13,16,15/06/2022,27,1,45,73,1,0,1,2,2,0,3,5,0,0,0,0,6,3,2,11
124130,2022,Thailand,China,0,0,8,8,5/6/2022,39,0,34,73,2,1,2,5,0,1,3,4,0,0,0,0,1,2,2,5
124130,2022,China,Italy,1,0,9,10,4/6/2022,36,0,17,53,1,0,2,3,0,0,3,3,0,0,0,0,4,2,2,8
124130,2022,Türkiye,China,0,0,0,0,3/6/2022,0,0,0,0,0,0,0,0,0,0,0,0,0,0,0,0,0,0,0,0
124130,2022,China,Netherlands,0,0,4,4,1/6/2022,0,0,18,18,0,0,0,0,0,0,1,1,0,0,0,0,0,1,0,1
163909,2022,Italy,China,0,0,0,0,14/07/2022,0,0,0,0,0,0,0,0,0,0,0,0,0,0,0,0,0,0,0,0
163909,2022,China,Korea,0,0,0,0,3/7/2022,0,1,1,2,0,0,0,0,0,0,0,0,1,0,4,5,12,0,5,17
163909,2022,China,Dominican Republic,0,0,0,0,1/7/2022,1,0,0,1,0,0,0,0,0,0,0,0,0,0,0,0,5,1,0,6
163909,2022,Poland,China,0,0,0,0,30/06/2022,0,0,0,0,0,0,0,0,0,0,0,0,0,0,0,0,0,0,0,0
163909,2022,China,Brazil,0,0,0,0,28/06/2022,1,0,4,5,0,0,0,0,0,0,0,0,0,0,0,0,8,3,1,12
163909,2022,Japan,China,0,0,0,0,19/06/2022,0,0,7,7,0,0,0,0,0,0,0,0,3,1,6,10,15,0,1,16
163909,2022,USA,China,0,0,0,0,18/06/2022,0,0,0,0,0,0,0,0,0,0,0,0,0,0,0,0,0,0,0,0
163909,2022,China,Canada,0,0,0,0,17/06/2022,0,0,5,5,0,0,0,0,0,0,0,0,1,1,7,9,13,2,0,15
163909,2022,China,Belgium,0,0,0,0,15/06/2022,0,0,0,0,0,0,0,0,0,0,0,0,0,0,0,0,0,0,0,0
163909,2022,Thailand,China,0,0,0,0,5/6/2022,1,0,2,3,0,0,0,0,0,0,0,0,0,0,0,0,10,0,0,10
163909,2022,China,Italy,0,0,0,0,4/6/2022,0,0,2,2,0,0,0,0,0,0,0,0,0,0,0,0,2,0,1,3
163909,2022,Türkiye,China,0,0,0,0,3/6/2022,0,0,0,0,0,0,0,0,0,0,0,0,0,0,0,0,0,0,0,0
163909,2022,China,Netherlands,0,0,0,0,1/6/2022,0,0,0,0,0,0,0,0,0,0,0,0,0,0,0,0,0,0,0,0
173642,2022,Thailand,China,0,0,1,1,5/6/2022,0,0,0,0,0,1,0,1,0,0,0,0,0,0,1,1,0,0,0,0
173642,2022,China,Italy,0,0,0,0,4/6/2022,0,0,0,0,0,0,0,0,0,0,0,0,0,0,0,0,0,0,0,0
173642,2022,Türkiye,China,0,0,0,0,3/6/2022,0,0,0,0,0,0,0,0,0,0,0,0,0,0,0,0,0,0,0,0
173642,2022,China,Netherlands,0,0,0,0,1/6/2022,0,0,0,0,0,0,0,0,0,0,0,0,0,0,0,0,0,0,0,0
162977,2022,Italy,China,0,0,0,0,14/07/2022,0,0,0,0,0,0,1,1,1,0,0,1,0,0,0,0,0,0,0,0
162977,2022,China,Korea,0,0,0,0,3/7/2022,0,0,0,0,0,0,0,0,0,0,0,0,0,0,0,0,0,0,0,0
162977,2022,China,Dominican Republic,0,0,0,0,1/7/2022,0,0,0,0,0,0,0,0,0,0,0,0,0,0,0,0,0,0,0,0
162977,2022,Poland,China,0,0,2,2,30/06/2022,0,0,1,1,0,0,1,1,0,0,0,0,0,0,0,0,0,0,0,0
162977,2022,China,Brazil,0,0,0,0,28/06/2022,0,0,0,0,1,0,2,3,0,1,0,1,0,0,0,0,0,0,0,0
162977,2022,Japan,China,0,0,0,0,19/06/2022,0,0,0,0,0,0,0,0,0,0,0,0,0,0,0,0,0,0,0,0
162977,2022,USA,China,0,0,0,0,18/06/2022,0,0,0,0,0,0,0,0,0,0,0,0,0,0,0,0,0,0,0,0
162977,2022,China,Canada,0,0,0,0,17/06/2022,0,0,0,0,0,0,0,0,0,0,0,0,0,0,0,0,0,0,0,0
162977,2022,China,Belgium,0,0,0,0,15/06/2022,0,0,0,0,0,0,0,0,0,0,0,0,0,0,0,0,0,0,0,0
175119,2022,,,-,-,-,-,-,-,-,-,-,-,-,-,-,-,-,-,-,-,-,-,-,-,-,-,-
189173,2022,,,-,-,-,-,-,-,-,-,-,-,-,-,-,-,-,-,-,-,-,-,-,-,-,-,-
152329,2022,,,-,-,-,-,-,-,-,-,-,-,-,-,-,-,-,-,-,-,-,-,-,-,-,-,-
135745,2022,,,-,-,-,-,-,-,-,-,-,-,-,-,-,-,-,-,-,-,-,-,-,-,-,-,-
152920,2022,,,-,-,-,-,-,-,-,-,-,-,-,-,-,-,-,-,-,-,-,-,-,-,-,-,-
143198,2022,,,-,-,-,-,-,-,-,-,-,-,-,-,-,-,-,-,-,-,-,-,-,-,-,-,-
175121,2022,,,-,-,-,-,-,-,-,-,-,-,-,-,-,-,-,-,-,-,-,-,-,-,-,-,-
158817,2022,Germany,Dominican Republic,0,0,0,0,19/06/2022,0,1,12,13,0,0,0,0,0,0,0,0,7,2,15,24,9,5,2,16
158817,2022,Netherlands,Dominican Republic,0,0,0,0,18/06/2022,0,0,13,13,0,0,0,0,0,0,0,0,7,2,9,18,7,11,2,20
158817,2022,Italy,Dominican Republic,0,0,0,0,16/06/2022,0,0,13,13,0,0,0,0,0,0,0,0,9,0,9,18,10,4,1,15
158817,2022,Dominican Republic,Korea,0,0,0,0,15/06/2022,0,0,4,4,0,0,0,0,0,0,0,0,2,1,4,7,9,3,1,13
158817,2022,Dominican Republic,Japan,0,0,0,0,4/6/2022,0,0,0,0,0,0,0,0,0,0,0,0,0,0,0,0,0,0,0,0
158817,2022,Dominican Republic,Brazil,0,0,0,0,3/6/2022,0,0,4,4,0,0,0,0,0,0,0,0,8,2,1,11,6,3,0,9
158817,2022,Canada,Dominican Republic,0,0,0,0,3/6/2022,0,0,1,1,0,0,0,0,0,0,0,0,5,2,1,8,4,1,0,5
158817,2022,USA,Dominican Republic,0,0,0,0,1/6/2022,0,0,0,0,0,0,0,0,0,0,0,0,0,0,0,0,0,0,0,0
168727,2022,Germany,Dominican Republic,0,0,0,0,19/06/2022,0,0,0,0,0,0,0,0,0,0,0,0,0,0,0,0,0,0,0,0
168727,2022,Netherlands,Dominican Republic,0,0,0,0,18/06/2022,0,0,0,0,0,0,0,0,0,0,0,0,0,0,0,0,0,0,0,0
168727,2022,Italy,Dominican Republic,0,0,0,0,16/06/2022,0,0,0,0,0,0,0,0,0,0,0,0,0,0,0,0,0,0,0,0
168727,2022,Dominican Republic,Korea,0,0,0,0,15/06/2022,0,0,0,0,0,0,0,0,0,0,0,0,0,0,0,0,0,0,0,0
168727,2022,Dominican Republic,Japan,0,0,1,1,4/6/2022,0,0,0,0,0,0,0,0,0,0,0,0,0,0,0,0,0,0,0,0
168727,2022,Dominican Republic,Brazil,0,0,0,0,3/6/2022,0,0,0,0,0,0,0,0,0,0,0,0,0,0,0,0,0,0,0,0
168727,2022,Canada,Dominican Republic,0,0,0,0,3/6/2022,0,0,0,0,0,0,0,0,0,0,0,0,0,0,0,0,0,0,0,0
168727,2022,USA,Dominican Republic,0,1,3,4,1/6/2022,0,0,0,0,1,2,0,3,1,1,0,2,0,0,0,0,1,0,0,1
151087,2022,Dominican Republic,Poland,0,0,1,1,2/7/2022,0,0,0,0,4,2,3,9,0,0,0,0,0,0,2,2,1,0,0,1
151087,2022,China,Dominican Republic,0,1,7,8,1/7/2022,2,0,0,2,8,2,7,17,0,1,0,1,2,1,14,17,0,0,1,1
151087,2022,Thailand,Dominican Republic,0,0,2,2,30/06/2022,0,0,0,0,0,0,0,0,0,0,0,0,1,0,0,1,0,0,0,0
151087,2022,Dominican Republic,Bulgaria,0,1,4,5,28/06/2022,0,0,0,0,3,2,4,9,0,0,0,0,3,0,7,10,3,2,1,6
151087,2022,Germany,Dominican Republic,0,0,1,1,19/06/2022,0,0,0,0,0,0,3,3,0,0,1,1,1,0,1,2,0,0,0,0
151087,2022,Netherlands,Dominican Republic,0,1,4,5,18/06/2022,0,0,0,0,1,0,0,1,0,0,1,1,1,0,2,3,0,1,0,1
151087,2022,Italy,Dominican Republic,0,0,1,1,16/06/2022,0,0,0,0,3,0,1,4,0,1,1,2,1,0,2,3,1,0,1,2
151087,2022,Dominican Republic,Korea,0,0,1,1,15/06/2022,0,0,0,0,0,0,3,3,0,0,0,0,0,0,4,4,1,0,0,1
151087,2022,Dominican Republic,Japan,0,0,8,8,4/6/2022,0,0,1,1,7,4,18,29,1,2,1,4,17,1,13,31,11,3,1,15
151087,2022,Dominican Republic,Brazil,2,0,8,10,3/6/2022,0,0,5,5,5,4,14,23,0,0,1,1,11,1,19,31,4,2,0,6
151087,2022,Canada,Dominican Republic,0,0,4,4,3/6/2022,0,0,0,0,2,0,6,8,0,1,0,1,3,1,3,7,3,0,0,3
151087,2022,USA,Dominican Republic,0,0,3,3,1/6/2022,0,0,1,1,4,0,2,6,1,2,0,3,10,1,12,23,4,2,0,6
119039,2022,,,-,-,-,-,-,-,-,-,-,-,-,-,-,-,-,-,-,-,-,-,-,-,-,-,-
119545,2022,Dominican Republic,Poland,0,0,0,0,2/7/2022,0,0,0,0,0,0,0,0,0,0,0,0,0,0,0,0,0,0,0,0
119545,2022,China,Dominican Republic,0,0,5,5,1/7/2022,41,0,3,44,1,0,1,2,0,1,0,1,0,0,1,1,1,1,1,3
119545,2022,Thailand,Dominican Republic,0,0,0,0,30/06/2022,0,0,0,0,0,0,0,0,0,0,0,0,0,0,0,0,0,0,0,0
119545,2022,Dominican Republic,Bulgaria,0,0,1,1,28/06/2022,0,0,0,0,0,0,0,0,0,0,0,0,0,0,0,0,0,0,0,0
119545,2022,Germany,Dominican Republic,0,0,0,0,19/06/2022,1,0,5,6,0,0,0,0,0,0,0,0,0,0,0,0,0,0,0,0
119545,2022,Netherlands,Dominican Republic,0,0,0,0,18/06/2022,2,0,8,10,0,0,0,0,0,0,0,0,0,0,0,0,0,0,1,1
119545,2022,Italy,Dominican Republic,0,0,2,2,16/06/2022,0,0,6,6,0,1,0,1,0,0,0,0,0,0,0,0,0,0,0,0
119545,2022,Dominican Republic,Korea,0,0,0,0,15/06/2022,0,0,0,0,0,0,0,0,0,0,0,0,0,0,0,0,0,0,0,0
119545,2022,Dominican Republic,Japan,0,0,0,0,4/6/2022,1,0,28,29,0,0,0,0,0,0,0,0,0,0,0,0,1,0,1,2
119545,2022,Dominican Republic,Brazil,0,0,0,0,3/6/2022,0,0,5,5,0,0,0,0,0,0,0,0,0,0,0,0,1,1,0,2
119545,2022,Canada,Dominican Republic,0,0,0,0,3/6/2022,0,0,9,9,0,0,0,0,0,0,0,0,0,0,0,0,0,0,0,0
119545,2022,USA,Dominican Republic,0,0,0,0,1/6/2022,0,0,4,4,0,0,0,0,0,0,0,0,0,0,0,0,0,0,0,0
119585,2022,Dominican Republic,Poland,0,2,16,18,2/7/2022,10,1,137,148,1,1,2,4,1,5,6,12,0,0,0,0,9,0,1,10
119585,2022,China,Dominican Republic,0,0,3,3,1/7/2022,31,0,1,32,0,0,0,0,0,1,0,1,0,0,0,0,0,0,1,1
119585,2022,Thailand,Dominican Republic,0,0,10,10,30/06/2022,94,1,2,97,0,0,0,0,0,2,3,5,0,0,0,0,4,5,4,13
119585,2022,Dominican Republic,Bulgaria,0,1,6,7,28/06/2022,48,2,1,51,0,0,2,2,1,4,2,7,0,0,0,0,2,0,0,2
119585,2022,Germany,Dominican Republic,0,2,10,12,19/06/2022,18,1,78,97,0,1,2,3,0,2,1,3,0,0,0,0,5,2,1,8
119585,2022,Netherlands,Dominican Republic,1,0,17,18,18/06/2022,33,0,86,119,3,0,2,5,1,3,3,7,0,0,0,0,7,3,2,12
119585,2022,Italy,Dominican Republic,2,1,13,16,16/06/2022,22,0,84,106,1,1,3,5,0,5,4,9,0,0,0,0,6,1,1,8
119585,2022,Dominican Republic,Korea,0,0,14,14,15/06/2022,14,1,53,68,1,0,1,2,0,1,4,5,0,0,0,0,1,1,0,2
119585,2022,Dominican Republic,Japan,1,1,7,9,4/6/2022,12,1,75,88,0,2,3,5,0,1,1,2,0,0,0,0,9,1,0,10
119585,2022,Dominican Republic,Brazil,0,0,6,6,3/6/2022,7,0,76,83,1,0,4,5,0,2,3,5,1,0,0,1,10,2,0,12
119585,2022,Canada,Dominican Republic,0,1,5,6,3/6/2022,4,0,70,74,1,0,2,3,0,0,1,1,0,0,0,0,4,0,0,4
119585,2022,USA,Dominican Republic,0,1,8,9,1/6/2022,5,0,67,72,3,0,1,4,0,0,1,1,0,0,0,0,7,1,0,8
143961,2022,Dominican Republic,Poland,0,0,9,9,2/7/2022,0,0,0,0,2,0,3,5,4,1,0,5,0,0,0,0,1,1,2,4
143961,2022,China,Dominican Republic,0,1,4,5,1/7/2022,0,0,0,0,0,0,3,3,0,3,1,4,0,0,1,1,0,0,0,0
143961,2022,Thailand,Dominican Republic,1,2,7,10,30/06/2022,0,0,0,0,0,0,1,1,4,1,1,6,0,0,0,0,1,0,0,1
143961,2022,Dominican Republic,Bulgaria,0,0,0,0,28/06/2022,0,0,0,0,0,0,0,0,0,0,0,0,0,0,0,0,0,0,0,0
143961,2022,Germany,Dominican Republic,0,0,1,1,19/06/2022,0,0,0,0,1,0,0,1,0,1,0,1,0,0,0,0,1,0,0,1
143961,2022,Netherlands,Dominican Republic,0,0,0,0,18/06/2022,0,0,1,1,0,0,0,0,0,0,0,0,0,0,0,0,1,1,0,2
143961,2022,Italy,Dominican Republic,0,0,0,0,16/06/2022,0,0,1,1,0,0,0,0,0,1,0,1,0,0,0,0,0,0,0,0
143961,2022,Dominican Republic,Korea,0,0,0,0,15/06/2022,0,0,0,0,0,0,0,0,0,0,0,0,0,0,0,0,0,0,0,0
143961,2022,Dominican Republic,Japan,0,0,0,0,4/6/2022,0,0,0,0,0,0,0,0,0,0,0,0,0,0,0,0,0,0,0,0
143961,2022,Dominican Republic,Brazil,0,0,0,0,3/6/2022,0,0,0,0,0,0,0,0,0,0,0,0,0,0,0,0,0,0,0,0
143961,2022,Canada,Dominican Republic,0,2,2,4,3/6/2022,0,0,0,0,1,0,3,4,0,1,0,1,0,1,0,1,2,0,0,2
143961,2022,USA,Dominican Republic,0,0,0,0,1/6/2022,0,0,0,0,0,0,0,0,0,0,0,0,0,0,0,0,0,0,0,0
139912,2022,Dominican Republic,Poland,0,0,0,0,2/7/2022,0,0,0,0,0,0,0,0,0,0,0,0,0,0,0,0,0,0,0,0
139912,2022,China,Dominican Republic,0,0,2,2,1/7/2022,6,1,1,8,0,0,0,0,0,0,0,0,0,0,0,0,1,0,1,2
139912,2022,Thailand,Dominican Republic,0,0,0,0,30/06/2022,0,0,0,0,0,0,0,0,0,0,0,0,0,0,0,0,0,0,0,0
139912,2022,Dominican Republic,Bulgaria,0,0,0,0,28/06/2022,0,0,0,0,0,0,0,0,0,0,0,0,0,0,0,0,0,0,0,0
139911,2022,Dominican Republic,Poland,0,0,0,0,2/7/2022,0,0,0,0,0,0,0,0,0,0,0,0,0,0,0,0,0,0,0,0
139911,2022,China,Dominican Republic,0,1,0,1,1/7/2022,0,0,0,0,2,3,1,6,0,3,0,3,0,0,4,4,2,0,1,3
139911,2022,Thailand,Dominican Republic,0,0,0,0,30/06/2022,0,0,0,0,0,0,0,0,0,0,0,0,0,0,0,0,0,0,0,0
139911,2022,Dominican Republic,Bulgaria,0,0,0,0,28/06/2022,0,0,0,0,0,0,0,0,0,0,0,0,0,0,0,0,0,0,0,0
149531,2022,Germany,Dominican Republic,0,0,3,3,19/06/2022,0,0,0,0,0,1,0,1,0,0,0,0,0,1,1,2,0,0,0,0
149531,2022,Netherlands,Dominican Republic,0,1,15,16,18/06/2022,0,0,0,0,10,1,5,16,0,0,2,2,4,0,6,10,7,1,2,10
149531,2022,Italy,Dominican Republic,0,1,7,8,16/06/2022,0,0,0,0,0,0,0,0,0,0,0,0,0,0,0,0,0,1,0,1
149531,2022,Dominican Republic,Korea,0,1,3,4,15/06/2022,0,0,0,0,0,0,0,0,0,0,0,0,0,0,0,0,0,0,0,0
149531,2022,Dominican Republic,Japan,0,1,2,3,4/6/2022,0,0,0,0,1,1,4,6,0,1,1,2,5,0,1,6,2,1,0,3
149531,2022,Dominican Republic,Brazil,0,1,5,6,3/6/2022,0,0,0,0,1,4,2,7,0,1,0,1,2,0,4,6,3,1,0,4
149531,2022,Canada,Dominican Republic,0,1,10,11,3/6/2022,0,0,4,4,11,4,14,29,1,1,1,3,11,0,7,18,6,1,1,8
149531,2022,USA,Dominican Republic,0,0,6,6,1/6/2022,0,0,0,0,2,5,4,11,0,0,0,0,8,3,14,25,7,0,0,7
123978,2022,Dominican Republic,Poland,2,1,11,14,2/7/2022,0,0,4,4,13,8,18,39,0,6,2,8,5,4,16,25,8,2,5,15
123978,2022,China,Dominican Republic,1,1,7,9,1/7/2022,2,0,0,2,11,8,11,30,3,2,1,6,2,2,24,28,2,2,2,6
123978,2022,Thailand,Dominican Republic,1,2,15,18,30/06/2022,3,0,1,4,18,6,16,40,0,4,3,7,5,1,19,25,8,1,3,12
123978,2022,Dominican Republic,Bulgaria,0,0,6,6,28/06/2022,1,1,0,2,3,2,11,16,0,0,0,0,2,2,21,25,1,0,0,1
123978,2022,Germany,Dominican Republic,0,2,14,16,19/06/2022,0,0,2,2,16,8,11,35,2,1,4,7,3,0,13,16,10,0,2,12
123978,2022,Netherlands,Dominican Republic,0,0,20,20,18/06/2022,0,0,6,6,14,5,17,36,0,3,3,6,7,0,25,32,11,3,1,15
123978,2022,Italy,Dominican Republic,0,4,13,17,16/06/2022,0,0,5,5,19,9,15,43,1,1,3,5,22,1,18,41,4,1,2,7
123978,2022,Dominican Republic,Korea,2,3,9,14,15/06/2022,0,0,0,0,19,4,9,32,1,1,1,3,5,0,8,13,11,0,0,11
123978,2022,Dominican Republic,Japan,1,1,12,14,4/6/2022,0,0,5,5,16,2,28,46,2,0,1,3,25,2,5,32,16,3,0,19
123978,2022,Dominican Republic,Brazil,1,3,11,15,3/6/2022,0,0,3,3,15,6,26,47,1,1,1,3,8,1,9,18,12,4,0,16
123978,2022,Canada,Dominican Republic,2,3,4,9,3/6/2022,0,0,3,3,6,6,12,24,1,1,0,2,16,2,3,21,8,2,0,10
123978,2022,USA,Dominican Republic,0,0,11,11,1/6/2022,0,0,6,6,9,6,17,32,0,0,2,2,5,0,4,9,5,1,0,6
115391,2022,Germany,Dominican Republic,0,0,1,1,19/06/2022,0,0,0,0,0,0,2,2,0,1,1,2,0,0,0,0,0,0,0,0
115391,2022,Netherlands,Dominican Republic,0,0,0,0,18/06/2022,0,0,0,0,0,0,0,0,0,0,0,0,0,0,0,0,0,0,0,0
115391,2022,Italy,Dominican Republic,0,1,0,1,16/06/2022,0,0,3,3,1,0,0,1,0,1,0,1,0,0,0,0,1,0,0,1
115391,2022,Dominican Republic,Korea,0,0,0,0,15/06/2022,0,0,0,0,0,0,0,0,0,0,0,0,0,0,0,0,0,0,0,0
115391,2022,Dominican Republic,Japan,0,2,1,3,4/6/2022,0,0,1,1,2,1,6,9,0,1,1,2,0,0,0,0,2,0,0,2
115391,2022,Dominican Republic,Brazil,0,0,2,2,3/6/2022,0,0,1,1,0,0,0,0,0,0,0,0,0,0,0,0,0,0,0,0
115391,2022,Canada,Dominican Republic,0,0,1,1,3/6/2022,0,0,0,0,0,0,2,2,0,1,0,1,0,0,0,0,0,1,0,1
115391,2022,USA,Dominican Republic,0,0,1,1,1/6/2022,0,0,0,0,2,0,2,4,0,1,1,2,0,0,0,0,0,0,0,0
114294,2022,,,-,-,-,-,-,-,-,-,-,-,-,-,-,-,-,-,-,-,-,-,-,-,-,-,-
119224,2022,,,-,-,-,-,-,-,-,-,-,-,-,-,-,-,-,-,-,-,-,-,-,-,-,-,-
123982,2022,Dominican Republic,Poland,1,2,16,19,2/7/2022,0,0,4,4,19,7,16,42,3,5,2,10,2,1,24,27,14,2,3,19
123982,2022,China,Dominican Republic,0,1,1,2,1/7/2022,0,0,0,0,4,1,6,11,1,1,0,2,0,1,11,12,4,0,1,5
123982,2022,Thailand,Dominican Republic,0,2,15,17,30/06/2022,3,0,0,3,19,3,20,42,0,3,3,6,3,3,16,22,11,4,0,15
123982,2022,Dominican Republic,Bulgaria,0,2,11,13,28/06/2022,0,0,0,0,3,4,9,16,0,1,0,1,1,1,7,9,2,0,1,3
123982,2022,Germany,Dominican Republic,0,3,6,9,19/06/2022,0,0,3,3,9,4,18,31,0,1,5,6,8,2,18,28,5,2,1,8
123982,2022,Netherlands,Dominican Republic,1,1,8,10,18/06/2022,0,1,4,5,21,3,25,49,1,1,8,10,2,0,23,25,10,5,4,19
123982,2022,Italy,Dominican Republic,0,3,10,13,16/06/2022,0,0,5,5,15,3,18,36,2,1,6,9,6,0,18,24,9,0,4,13
123982,2022,Dominican Republic,Korea,0,2,11,13,15/06/2022,0,0,3,3,10,0,6,16,0,1,1,2,2,0,7,9,3,2,1,6
123982,2022,Dominican Republic,Japan,0,0,0,0,4/6/2022,0,0,0,0,0,0,0,0,0,0,0,0,0,0,0,0,0,0,0,0
123982,2022,Dominican Republic,Brazil,0,0,0,0,3/6/2022,0,0,0,0,0,0,0,0,0,0,0,0,0,0,0,0,0,0,0,0
123982,2022,Canada,Dominican Republic,0,0,0,0,3/6/2022,0,0,0,0,0,0,0,0,0,0,0,0,0,0,0,0,0,0,0,0
123982,2022,USA,Dominican Republic,0,0,0,0,1/6/2022,0,0,0,0,0,0,0,0,0,0,0,0,0,0,0,0,0,0,0,0
139910,2022,Dominican Republic,Poland,1,1,18,20,2/7/2022,0,0,0,0,9,2,9,20,2,13,5,20,0,1,2,3,4,0,1,5
139910,2022,China,Dominican Republic,0,0,2,2,1/7/2022,0,0,0,0,0,0,5,5,1,1,0,2,0,0,0,0,0,0,0,0
139910,2022,Thailand,Dominican Republic,0,2,15,17,30/06/2022,2,0,0,2,11,4,9,24,2,2,1,5,0,0,0,0,3,0,1,4
139910,2022,Dominican Republic,Bulgaria,0,0,5,5,28/06/2022,3,0,0,3,8,1,4,13,1,4,0,5,0,1,0,1,1,0,0,1
139910,2022,Germany,Dominican Republic,0,2,14,16,19/06/2022,0,0,1,1,8,1,8,17,8,4,10,22,0,0,0,0,1,1,0,2
139910,2022,Netherlands,Dominican Republic,1,3,14,18,18/06/2022,0,0,3,3,9,1,8,18,2,5,5,12,0,0,1,1,3,0,2,5
139910,2022,Italy,Dominican Republic,2,0,16,18,16/06/2022,0,0,0,0,7,1,5,13,2,4,4,10,0,0,0,0,1,0,0,1
139910,2022,Dominican Republic,Korea,0,2,4,6,15/06/2022,0,0,1,1,3,0,3,6,1,2,7,10,0,0,0,0,2,0,0,2
139910,2022,Dominican Republic,Japan,0,0,14,14,4/6/2022,0,0,5,5,3,2,10,15,2,5,6,13,1,0,0,1,9,1,0,10
139910,2022,Dominican Republic,Brazil,0,2,8,10,3/6/2022,0,0,2,2,5,1,2,8,1,0,2,3,0,0,0,0,1,1,0,2
139910,2022,Canada,Dominican Republic,1,1,5,7,3/6/2022,0,0,0,0,4,1,4,9,1,5,4,10,0,0,0,0,1,1,0,2
139910,2022,USA,Dominican Republic,0,0,4,4,1/6/2022,0,0,3,3,0,1,3,4,3,0,2,5,0,0,0,0,2,0,0,2
162342,2022,Dominican Republic,Poland,0,0,5,5,2/7/2022,0,0,1,1,0,0,0,0,0,0,0,0,2,0,3,5,5,1,0,6
162342,2022,China,Dominican Republic,0,0,0,0,1/7/2022,0,0,0,0,0,0,0,0,0,0,0,0,0,0,2,2,2,0,3,5
162342,2022,Thailand,Dominican Republic,0,0,0,0,30/06/2022,0,0,0,0,0,0,0,0,0,0,0,0,0,0,0,0,0,0,0,0
162342,2022,Dominican Republic,Bulgaria,0,0,3,3,28/06/2022,0,0,0,0,0,0,0,0,0,0,0,0,0,0,2,2,0,0,0,0
139927,2022,Dominican Republic,Poland,0,5,14,19,2/7/2022,0,0,1,1,21,9,14,44,2,6,3,11,1,0,2,3,5,2,2,9
139927,2022,China,Dominican Republic,2,1,4,7,1/7/2022,0,0,0,0,8,5,8,21,0,1,1,2,0,0,0,0,2,2,2,6
139927,2022,Thailand,Dominican Republic,2,3,14,19,30/06/2022,0,0,0,0,15,3,15,33,1,5,2,8,0,0,0,0,5,1,1,7
139927,2022,Dominican Republic,Bulgaria,0,1,6,7,28/06/2022,0,0,0,0,8,6,9,23,2,4,2,8,0,0,0,0,0,0,2,2
139927,2022,Germany,Dominican Republic,1,3,11,15,19/06/2022,0,0,1,1,15,2,9,26,1,1,4,6,2,1,4,7,6,5,0,11
139927,2022,Netherlands,Dominican Republic,0,1,4,5,18/06/2022,0,0,1,1,8,5,10,23,2,4,2,8,1,0,0,1,5,2,1,8
139927,2022,Italy,Dominican Republic,0,3,11,14,16/06/2022,0,0,1,1,13,9,11,33,3,1,2,6,1,0,0,1,4,2,1,7
139927,2022,Dominican Republic,Korea,0,2,10,12,15/06/2022,0,0,2,2,8,6,4,18,1,4,0,5,0,0,0,0,5,0,0,5
139927,2022,Dominican Republic,Japan,0,1,8,9,4/6/2022,0,0,0,0,10,8,13,31,4,2,1,7,0,0,0,0,6,2,0,8
139927,2022,Dominican Republic,Brazil,2,1,9,12,3/6/2022,0,0,2,2,12,7,10,29,2,4,1,7,1,0,1,2,6,1,0,7
139927,2022,Canada,Dominican Republic,2,1,5,8,3/6/2022,0,0,0,0,1,4,10,15,1,1,2,4,0,0,0,0,4,1,0,5
139927,2022,USA,Dominican Republic,0,1,9,10,1/6/2022,0,0,1,1,7,5,21,33,0,0,3,3,1,0,0,1,12,2,2,16
149530,2022,Dominican Republic,Poland,0,1,5,6,2/7/2022,0,0,2,2,0,1,2,3,0,0,0,0,0,0,0,0,1,0,0,1
149530,2022,China,Dominican Republic,0,1,6,7,1/7/2022,4,1,0,5,1,1,2,4,0,4,1,5,0,0,1,1,1,0,2,3
149530,2022,Thailand,Dominican Republic,0,0,3,3,30/06/2022,0,0,0,0,1,1,0,2,1,2,3,6,0,0,0,0,0,0,1,1
149530,2022,Dominican Republic,Bulgaria,0,1,3,4,28/06/2022,0,0,0,0,4,3,1,8,0,0,0,0,0,0,0,0,0,0,0,0
149530,2022,Germany,Dominican Republic,0,2,9,11,19/06/2022,0,1,2,3,2,1,0,3,0,0,5,5,0,0,2,2,1,1,0,2
149530,2022,Netherlands,Dominican Republic,0,2,8,10,18/06/2022,0,0,1,1,3,3,4,10,2,2,6,10,0,0,0,0,0,1,3,4
149530,2022,Italy,Dominican Republic,0,3,11,14,16/06/2022,0,0,4,4,5,1,0,6,3,3,3,9,0,1,1,2,1,0,0,1
149530,2022,Dominican Republic,Korea,0,0,9,9,15/06/2022,0,0,0,0,0,1,1,2,3,4,4,11,0,0,0,0,0,0,0,0
149530,2022,Dominican Republic,Japan,1,3,9,13,4/6/2022,0,0,1,1,3,2,4,9,4,6,3,13,0,0,1,1,3,0,0,3
149530,2022,Dominican Republic,Brazil,0,4,5,9,3/6/2022,0,0,2,2,3,2,2,7,0,4,4,8,0,0,0,0,2,0,1,3
149530,2022,Canada,Dominican Republic,0,0,3,3,3/6/2022,0,0,3,3,0,0,4,4,0,1,0,1,0,1,0,1,0,0,0,0
149530,2022,USA,Dominican Republic,0,1,9,10,1/6/2022,0,0,4,4,4,1,2,7,2,4,2,8,0,0,0,0,2,0,0,2
139913,2022,Dominican Republic,Poland,0,0,0,0,2/7/2022,0,0,6,6,0,0,0,0,0,0,0,0,8,2,27,37,10,3,1,14
139913,2022,China,Dominican Republic,0,0,0,0,1/7/2022,4,0,0,4,0,0,0,0,0,0,0,0,0,1,6,7,4,0,5,9
139913,2022,Thailand,Dominican Republic,0,0,0,0,30/06/2022,7,0,1,8,0,0,0,0,0,0,0,0,7,2,25,34,16,4,4,24
139913,2022,Dominican Republic,Bulgaria,0,0,0,0,28/06/2022,0,0,0,0,0,0,0,0,0,0,0,0,1,1,18,20,0,2,1,3
139913,2022,Germany,Dominican Republic,0,0,2,2,19/06/2022,0,0,0,0,0,0,0,0,0,0,0,0,0,0,4,4,0,0,0,0
139913,2022,Netherlands,Dominican Republic,0,0,0,0,18/06/2022,0,0,0,0,0,0,0,0,0,0,0,0,0,0,0,0,0,0,0,0
139913,2022,Italy,Dominican Republic,0,0,0,0,16/06/2022,0,0,0,0,0,0,0,0,0,0,0,0,0,0,0,0,0,0,0,0
139913,2022,Dominican Republic,Korea,0,0,0,0,15/06/2022,0,0,0,0,0,0,0,0,0,0,0,0,0,0,0,0,0,0,0,0
139913,2022,Dominican Republic,Japan,0,0,0,0,4/6/2022,0,0,12,12,0,0,0,0,0,0,0,0,8,0,6,14,17,5,1,23
139913,2022,Dominican Republic,Brazil,0,0,0,0,3/6/2022,0,0,5,5,0,0,0,0,0,0,0,0,6,2,9,17,11,4,0,15
139913,2022,Canada,Dominican Republic,0,0,0,0,3/6/2022,0,0,1,1,0,0,0,0,0,0,0,0,4,1,6,11,8,2,0,10
139913,2022,USA,Dominican Republic,0,0,0,0,1/6/2022,0,0,6,6,0,0,0,0,0,0,0,0,4,0,4,8,10,2,0,12
152140,2022,Germany,Dominican Republic,0,0,0,0,19/06/2022,0,0,0,0,0,0,0,0,0,0,0,0,0,0,0,0,0,0,0,0
152140,2022,Germany,Türkiye,0,0,0,0,18/06/2022,0,0,0,0,0,0,0,0,0,0,0,0,0,0,0,0,1,1,0,2
152140,2022,Germany,Italy,0,0,0,0,17/06/2022,0,0,0,0,0,0,0,0,0,0,0,0,0,0,0,0,0,0,0,0
152140,2022,Netherlands,Germany,0,0,0,0,14/06/2022,0,0,0,0,0,0,0,0,0,0,0,0,0,0,0,0,0,0,0,0
152140,2022,Poland,Germany,0,0,0,0,5/6/2022,0,0,0,0,0,0,0,0,0,0,0,0,0,0,0,0,0,0,0,0
152140,2022,Germany,Korea,0,0,0,0,3/6/2022,0,0,0,0,0,0,0,0,0,0,0,0,1,0,2,3,2,1,0,3
152140,2022,Germany,Japan,0,0,2,2,2/6/2022,0,0,0,0,1,0,0,1,0,0,0,0,0,0,2,2,2,1,0,3
152140,2022,Germany,Brazil,0,0,0,0,31/05/2022,0,0,0,0,0,0,0,0,0,0,0,0,0,1,1,2,0,0,0,0
150973,2022,USA,Germany,1,0,10,11,3/7/2022,5,0,102,107,0,1,1,2,0,2,1,3,0,0,0,0,15,2,0,17
150973,2022,Germany,Canada,0,1,7,8,3/7/2022,6,0,86,92,1,0,1,2,0,1,5,6,0,0,1,1,7,1,0,8
150973,2022,Germany,Belgium,1,0,12,13,30/06/2022,7,0,97,104,2,0,2,4,0,1,0,1,0,0,0,0,16,0,0,16
150973,2022,Serbia,Germany,0,0,14,14,28/06/2022,19,0,84,103,0,0,1,1,0,1,2,3,0,0,0,0,10,1,0,11
150973,2022,Germany,Dominican Republic,0,2,5,7,19/06/2022,32,0,71,103,1,0,0,1,0,3,4,7,0,0,0,0,3,2,1,6
150973,2022,Germany,Türkiye,0,0,3,3,18/06/2022,12,0,33,45,0,0,0,0,0,2,0,2,0,0,0,0,0,0,0,0
150973,2022,Germany,Italy,1,0,11,12,17/06/2022,19,0,55,74,1,1,0,2,1,2,2,5,0,0,0,0,1,2,3,6
150973,2022,Netherlands,Germany,0,1,8,9,14/06/2022,9,0,30,39,1,0,0,1,0,0,0,0,0,0,0,0,4,0,2,6
150973,2022,Poland,Germany,0,0,3,3,5/6/2022,4,0,27,31,1,0,1,2,0,1,0,1,0,0,0,0,2,0,1,3
150973,2022,Germany,Korea,2,1,11,14,3/6/2022,16,0,51,67,1,0,0,1,0,3,2,5,0,0,0,0,6,0,0,6
150973,2022,Germany,Japan,0,1,5,6,2/6/2022,19,0,37,56,1,1,1,3,0,0,3,3,0,0,0,0,1,3,0,4
150973,2022,Germany,Brazil,2,0,11,13,31/05/2022,20,0,72,92,1,0,1,2,0,3,2,5,0,0,1,1,11,3,0,14
136671,2022,USA,Germany,0,0,0,0,3/7/2022,0,0,11,11,0,0,0,0,0,0,0,0,8,0,9,17,10,1,0,11
136671,2022,Germany,Canada,0,0,0,0,3/7/2022,0,0,9,9,0,0,0,0,0,0,0,0,12,0,8,20,12,3,0,15
136671,2022,Germany,Belgium,0,0,0,0,30/06/2022,0,0,16,16,0,0,0,0,0,0,0,0,12,2,4,18,11,1,0,12
136671,2022,Serbia,Germany,0,0,0,0,28/06/2022,1,0,12,13,0,0,0,0,0,0,0,0,2,0,8,10,7,3,0,10
136671,2022,Germany,Dominican Republic,0,0,0,0,19/06/2022,0,0,9,9,0,0,0,0,0,0,0,0,15,0,12,27,11,4,2,17
136671,2022,Germany,Türkiye,0,0,0,0,18/06/2022,0,0,3,3,0,0,0,0,0,0,0,0,2,0,2,4,4,3,0,7
136671,2022,Germany,Italy,0,0,0,0,17/06/2022,0,0,5,5,0,0,0,0,0,0,0,0,8,0,6,14,3,7,4,14
136671,2022,Netherlands,Germany,0,0,0,0,14/06/2022,0,0,0,0,0,0,0,0,0,0,0,0,7,1,10,18,9,7,0,16
136671,2022,Poland,Germany,0,0,0,0,5/6/2022,0,0,11,11,0,0,0,0,0,0,0,0,20,2,11,33,20,7,0,27
136671,2022,Germany,Korea,0,0,0,0,3/6/2022,0,0,6,6,0,0,0,0,0,0,0,0,12,4,5,21,13,4,0,17
136671,2022,Germany,Japan,0,0,0,0,2/6/2022,0,0,17,17,0,0,0,0,0,0,0,0,35,2,15,52,26,5,0,31
136671,2022,Germany,Brazil,0,0,0,0,31/05/2022,0,0,10,10,0,0,0,0,0,0,0,0,29,0,14,43,18,2,1,21
163661,2022,USA,Germany,0,0,0,0,3/7/2022,0,0,0,0,0,0,0,0,0,0,0,0,0,0,0,0,0,0,0,0
163661,2022,Germany,Canada,1,0,7,8,3/7/2022,0,0,14,14,0,0,0,0,0,1,0,1,0,0,0,0,4,0,0,4
163661,2022,Germany,Belgium,0,0,0,0,30/06/2022,0,0,5,5,0,0,0,0,0,0,0,0,0,0,0,0,0,0,0,0
163661,2022,Serbia,Germany,0,0,0,0,28/06/2022,0,0,0,0,0,0,0,0,0,0,0,0,0,0,0,0,0,0,0,0
163661,2022,Germany,Dominican Republic,0,0,2,2,19/06/2022,7,1,5,13,1,0,1,2,0,1,0,1,0,0,0,0,3,0,0,3
163661,2022,Germany,Türkiye,0,1,6,7,18/06/2022,8,0,30,38,0,0,0,0,0,0,3,3,0,0,0,0,2,2,1,5
163661,2022,Germany,Italy,0,0,0,0,17/06/2022,0,0,4,4,0,0,0,0,0,0,0,0,0,0,0,0,0,0,0,0
163661,2022,Netherlands,Germany,0,0,8,8,14/06/2022,23,0,81,104,0,0,0,0,1,2,1,4,0,0,0,0,7,2,0,9
163661,2022,Poland,Germany,0,1,11,12,5/6/2022,17,1,74,92,0,0,1,1,0,2,0,2,0,0,0,0,9,4,0,13
163661,2022,Germany,Korea,0,0,0,0,3/6/2022,0,0,0,0,0,0,0,0,0,0,0,0,0,0,0,0,0,0,0,0
163661,2022,Germany,Japan,0,2,9,11,2/6/2022,19,0,67,86,0,0,1,1,0,1,0,1,0,0,0,0,13,4,0,17
163661,2022,Germany,Brazil,0,0,5,5,31/05/2022,11,0,27,38,0,0,0,0,0,1,0,1,0,0,0,0,4,2,0,6
123911,2022,USA,Germany,0,0,6,6,3/7/2022,0,0,2,2,3,2,5,10,0,0,0,0,5,0,4,9,7,1,1,9
123911,2022,Germany,Canada,1,0,9,10,3/7/2022,0,0,5,5,6,2,12,20,0,3,2,5,7,0,5,12,11,3,0,14
123911,2022,Germany,Belgium,0,1,21,22,30/06/2022,0,0,13,13,7,4,15,26,0,2,1,3,9,0,6,15,14,3,0,17
123911,2022,Serbia,Germany,0,0,2,2,28/06/2022,0,0,1,1,3,1,5,9,1,0,0,1,2,0,8,10,4,0,0,4
123911,2022,Germany,Dominican Republic,2,1,12,15,19/06/2022,0,0,2,2,7,7,14,28,0,1,0,1,9,0,9,18,6,1,0,7
123911,2022,Germany,Türkiye,1,0,6,7,18/06/2022,0,0,1,1,3,1,6,10,0,2,2,4,5,0,7,12,3,2,2,7
123911,2022,Germany,Italy,0,0,4,4,17/06/2022,0,0,0,0,1,1,0,2,0,0,1,1,1,0,2,3,1,0,1,2
123911,2022,Netherlands,Germany,0,0,8,8,14/06/2022,0,0,0,0,4,2,6,12,0,0,0,0,5,0,3,8,1,0,1,2
123911,2022,Poland,Germany,0,0,2,2,5/6/2022,0,0,2,2,0,0,0,0,0,0,0,0,5,0,2,7,5,3,0,8
123911,2022,Germany,Korea,0,0,7,7,3/6/2022,0,0,1,1,0,2,8,10,0,2,0,2,2,0,2,4,5,1,0,6
123911,2022,Germany,Japan,0,0,9,9,2/6/2022,0,0,1,1,2,4,6,12,0,0,1,1,5,0,1,6,9,0,0,9
123911,2022,Germany,Brazil,1,2,19,22,31/05/2022,0,0,7,7,13,4,15,32,1,1,0,2,4,0,4,8,17,3,0,20
168102,2022,USA,Germany,0,2,0,2,3/7/2022,0,0,2,2,3,3,3,9,0,0,2,2,1,0,2,3,0,2,0,2
168102,2022,Germany,Canada,1,2,5,8,3/7/2022,0,0,2,2,13,3,18,34,1,3,0,4,1,0,1,2,8,2,0,10
168102,2022,Germany,Belgium,0,0,0,0,30/06/2022,0,0,0,0,0,0,0,0,0,0,0,0,0,0,0,0,0,0,0,0
168102,2022,Serbia,Germany,0,0,3,3,28/06/2022,0,0,0,0,1,1,2,4,0,2,1,3,1,0,3,4,2,0,0,2
168102,2022,Germany,Dominican Republic,0,0,0,0,19/06/2022,0,0,0,0,0,0,0,0,0,0,0,0,0,0,0,0,0,0,0,0
168102,2022,Germany,Türkiye,2,2,3,7,18/06/2022,0,0,0,0,8,9,12,29,3,3,0,6,11,0,19,30,4,3,0,7
168102,2022,Germany,Italy,0,0,0,0,17/06/2022,0,0,0,0,0,1,0,1,0,0,0,0,0,0,0,0,0,0,0,0
168102,2022,Netherlands,Germany,0,0,1,1,14/06/2022,0,0,0,0,0,1,1,2,0,0,0,0,0,0,0,0,1,1,0,2
168102,2022,Poland,Germany,0,2,1,3,5/6/2022,0,0,0,0,7,1,11,19,0,2,2,4,4,1,4,9,7,2,1,10
168102,2022,Germany,Korea,0,0,0,0,3/6/2022,0,0,0,0,0,0,1,1,0,0,0,0,0,0,0,0,0,0,0,0
168102,2022,Germany,Japan,1,1,4,6,2/6/2022,0,0,0,0,7,3,10,20,1,0,1,2,8,1,1,10,7,3,0,10
168102,2022,Germany,Brazil,0,2,4,6,31/05/2022,0,0,0,0,4,2,13,19,0,0,0,0,4,0,2,6,1,0,0,1
163658,2022,USA,Germany,0,1,8,9,3/7/2022,0,0,8,8,7,3,12,22,0,0,0,0,3,1,7,11,7,3,0,10
163658,2022,Germany,Canada,1,0,5,6,3/7/2022,0,0,3,3,1,4,5,10,0,0,0,0,7,0,5,12,3,3,0,6
163658,2022,Germany,Belgium,1,3,7,11,30/06/2022,0,0,6,6,27,3,17,47,0,0,2,2,7,0,3,10,9,0,0,9
163658,2022,Serbia,Germany,2,3,9,14,28/06/2022,0,0,3,3,9,4,11,24,1,2,1,4,2,2,30,34,5,1,2,8
163658,2022,Germany,Dominican Republic,2,1,16,19,19/06/2022,0,0,2,2,9,6,6,21,0,0,1,1,6,0,3,9,11,3,1,15
163658,2022,Germany,Italy,2,3,10,15,17/06/2022,0,0,3,3,7,1,8,16,2,0,1,3,12,1,18,31,4,3,1,8
163658,2022,Netherlands,Germany,0,3,9,12,14/06/2022,0,1,1,2,14,0,12,26,0,3,3,6,18,3,8,29,4,2,2,8
163658,2022,Poland,Germany,2,4,12,18,5/6/2022,0,0,3,3,17,7,15,39,2,2,1,5,9,0,7,16,16,4,0,20
163658,2022,Germany,Korea,0,1,5,6,3/6/2022,0,0,1,1,4,0,7,11,1,1,0,2,1,1,3,5,10,0,0,10
163658,2022,Germany,Japan,1,1,6,8,2/6/2022,0,0,6,6,13,2,22,37,2,1,0,3,4,0,7,11,11,1,0,12
163658,2022,Germany,Brazil,0,3,3,6,31/05/2022,0,0,0,0,3,2,6,11,0,1,1,2,8,0,3,11,4,2,0,6
144980,2022,USA,Germany,0,1,4,5,3/7/2022,0,0,3,3,6,3,10,19,0,0,1,1,5,1,8,14,5,0,0,5
144980,2022,Germany,Canada,0,1,4,5,3/7/2022,0,0,0,0,0,0,0,0,0,0,0,0,2,0,5,7,3,0,0,3
144980,2022,Germany,Belgium,0,1,12,13,30/06/2022,0,0,3,3,13,1,12,26,1,7,0,8,12,0,16,28,9,2,0,11
144980,2022,Serbia,Germany,0,0,5,5,28/06/2022,0,0,2,2,6,2,8,16,1,2,4,7,4,0,6,10,7,1,0,8
144980,2022,Germany,Dominican Republic,0,0,7,7,19/06/2022,0,0,1,1,5,4,7,16,4,1,0,5,1,0,2,3,2,0,0,2
144980,2022,Germany,Türkiye,0,1,5,6,18/06/2022,0,0,1,1,5,3,5,13,0,0,0,0,11,1,7,19,1,0,0,1
144980,2022,Germany,Italy,1,0,10,11,17/06/2022,0,0,0,0,5,1,12,18,0,0,1,1,4,1,7,12,1,0,1,2
144980,2022,Netherlands,Germany,0,0,12,12,14/06/2022,0,1,0,1,8,1,16,25,1,5,2,8,6,0,4,10,3,0,0,3
144980,2022,Poland,Germany,0,0,18,18,5/6/2022,0,0,4,4,9,1,22,32,2,3,1,6,9,1,6,16,10,1,1,12
144980,2022,Germany,Korea,0,0,11,11,3/6/2022,0,0,8,8,7,0,4,11,0,2,0,2,5,0,0,5,5,0,1,6
144980,2022,Germany,Japan,0,0,15,15,2/6/2022,0,0,5,5,12,4,18,34,1,1,1,3,5,0,3,8,13,2,2,17
144980,2022,Germany,Brazil,0,0,8,8,31/05/2022,0,0,2,2,9,5,18,32,1,2,0,3,6,1,10,17,10,2,1,13
151016,2022,USA,Germany,0,1,7,8,3/7/2022,0,0,3,3,12,7,22,41,1,2,0,3,10,1,10,21,11,6,0,17
151016,2022,Germany,Canada,3,4,12,19,3/7/2022,0,0,5,5,18,3,17,38,0,4,1,5,7,1,11,19,5,2,0,7
151016,2022,Germany,Belgium,0,1,4,5,30/06/2022,0,0,1,1,5,2,10,17,0,0,1,1,0,0,2,2,3,1,0,4
151016,2022,Serbia,Germany,0,3,7,10,28/06/2022,0,0,2,2,13,9,16,38,1,3,1,5,2,0,10,12,2,1,0,3
151016,2022,Germany,Dominican Republic,2,4,6,12,19/06/2022,0,0,1,1,20,5,14,39,0,1,0,1,7,1,8,16,4,1,1,6
151016,2022,Germany,Türkiye,0,0,0,0,18/06/2022,0,0,1,1,0,0,0,0,0,0,1,1,0,0,0,0,0,0,0,0
151016,2022,Germany,Italy,1,3,5,9,17/06/2022,0,0,0,0,11,5,17,33,1,1,1,3,2,0,5,7,0,1,0,1
151016,2022,Netherlands,Germany,0,5,6,11,14/06/2022,0,0,0,0,22,5,17,44,1,2,2,5,5,0,5,10,3,1,1,5
151016,2022,Poland,Germany,1,5,10,16,5/6/2022,0,0,1,1,18,4,12,34,2,1,0,3,3,1,3,7,4,0,1,5
151016,2022,Germany,Korea,0,2,5,7,3/6/2022,0,0,2,2,19,1,12,32,3,2,3,8,1,2,2,5,5,1,0,6
151016,2022,Germany,Japan,1,3,7,11,2/6/2022,0,1,3,4,11,4,15,30,0,1,1,2,3,0,0,3,5,3,0,8
151016,2022,Germany,Brazil,1,2,6,9,31/05/2022,0,0,0,0,14,7,18,39,0,2,0,2,2,1,3,6,3,2,0,5
118954,2022,USA,Germany,0,0,5,5,3/7/2022,0,0,1,1,5,1,5,11,0,0,0,0,0,0,0,0,4,0,0,4
118954,2022,Germany,Canada,0,0,1,1,3/7/2022,0,0,0,0,0,0,0,0,0,0,0,0,0,0,0,0,0,0,0,0
118954,2022,Germany,Belgium,0,0,0,0,30/06/2022,0,0,0,0,0,0,0,0,0,0,0,0,0,0,0,0,1,0,0,1
118954,2022,Serbia,Germany,0,0,4,4,28/06/2022,0,0,0,0,2,2,2,6,0,1,0,1,0,0,0,0,1,0,0,1
118954,2022,Germany,Dominican Republic,0,1,4,5,19/06/2022,0,0,0,0,1,0,1,2,0,0,0,0,0,0,0,0,2,0,0,2
118954,2022,Germany,Türkiye,3,2,14,19,18/06/2022,0,0,1,1,10,6,7,23,1,2,0,3,0,1,0,1,1,3,0,4
118954,2022,Germany,Italy,0,0,1,1,17/06/2022,0,0,0,0,0,0,0,0,0,0,0,0,0,0,0,0,0,1,0,1
118954,2022,Netherlands,Germany,0,0,0,0,14/06/2022,0,0,0,0,0,0,0,0,0,0,0,0,0,0,0,0,0,0,0,0
118954,2022,Poland,Germany,0,0,0,0,5/6/2022,0,0,0,0,0,0,0,0,0,0,0,0,0,0,0,0,0,0,0,0
118954,2022,Germany,Korea,0,0,1,1,3/6/2022,0,0,0,0,0,1,2,3,0,1,0,1,0,0,0,0,0,0,0,0
118954,2022,Germany,Japan,0,2,2,4,2/6/2022,0,0,0,0,1,0,1,2,0,0,1,1,1,0,0,1,0,0,0,0
118954,2022,Germany,Brazil,0,0,4,4,31/05/2022,0,0,2,2,1,1,2,4,0,0,0,0,0,0,0,0,4,0,0,4
150812,2022,USA,Germany,0,0,4,4,3/7/2022,0,0,1,1,3,1,5,9,2,0,0,2,0,0,0,0,1,1,0,2
150812,2022,Germany,Canada,0,0,11,11,3/7/2022,0,0,2,2,4,2,4,10,1,9,6,16,1,0,0,1,3,0,0,3
150812,2022,Germany,Belgium,0,1,1,2,30/06/2022,0,0,1,1,2,1,0,3,0,4,3,7,0,0,0,0,0,0,0,0
150812,2022,Serbia,Germany,2,1,14,17,28/06/2022,0,0,0,0,4,2,3,9,0,5,3,8,0,0,0,0,2,1,0,3
150812,2022,Germany,Dominican Republic,0,0,3,3,19/06/2022,0,0,1,1,1,1,4,6,1,3,0,4,0,0,0,0,1,0,1,2
150812,2022,Germany,Türkiye,0,1,8,9,18/06/2022,0,0,0,0,5,0,6,11,0,2,4,6,0,0,0,0,2,0,1,3
150812,2022,Germany,Italy,0,0,5,5,17/06/2022,0,0,1,1,2,1,1,4,2,2,0,4,0,0,0,0,0,1,0,1
150812,2022,Netherlands,Germany,0,3,9,12,14/06/2022,0,0,0,0,7,4,4,15,1,7,0,8,0,1,0,1,2,1,1,4
150812,2022,Poland,Germany,0,0,11,11,5/6/2022,0,0,2,2,7,2,2,11,0,4,7,11,0,1,1,2,1,0,0,1
150812,2022,Germany,Korea,0,0,0,0,3/6/2022,0,0,0,0,0,0,0,0,0,0,0,0,0,0,0,0,0,0,0,0
150812,2022,Germany,Japan,3,1,12,16,2/6/2022,0,0,1,1,10,2,4,16,1,5,4,10,2,1,2,5,0,0,0,0
150812,2022,Germany,Brazil,0,1,8,9,31/05/2022,0,0,3,3,8,2,3,13,2,6,5,13,0,0,0,0,3,0,0,3
151014,2022,,,-,-,-,-,-,-,-,-,-,-,-,-,-,-,-,-,-,-,-,-,-,-,-,-,-
163989,2022,,,-,-,-,-,-,-,-,-,-,-,-,-,-,-,-,-,-,-,-,-,-,-,-,-,-
151021,2022,,,-,-,-,-,-,-,-,-,-,-,-,-,-,-,-,-,-,-,-,-,-,-,-,-,-
153929,2022,USA,Germany,2,2,19,23,3/7/2022,0,0,2,2,5,0,5,10,3,5,2,10,0,0,0,0,2,0,1,3
153929,2022,Germany,Canada,0,0,19,19,3/7/2022,0,0,1,1,10,2,5,17,2,5,0,7,0,0,0,0,3,0,0,3
153929,2022,Germany,Belgium,2,1,17,20,30/06/2022,0,0,0,0,8,0,4,12,2,6,1,9,1,0,0,1,1,2,0,3
153929,2022,Serbia,Germany,1,0,11,12,28/06/2022,0,0,1,1,10,2,11,23,2,6,3,11,0,1,1,2,4,0,0,4
153929,2022,Germany,Dominican Republic,1,1,18,20,19/06/2022,0,0,1,1,6,1,7,14,2,7,7,16,0,0,0,0,1,0,0,1
153929,2022,Germany,Türkiye,0,0,0,0,18/06/2022,0,0,1,1,2,0,2,4,1,1,0,2,0,0,0,0,0,0,0,0
153929,2022,Germany,Italy,0,0,9,9,17/06/2022,0,0,1,1,4,3,3,10,1,2,2,5,0,0,0,0,0,0,0,0
153929,2022,Netherlands,Germany,1,2,10,13,14/06/2022,0,0,0,0,7,0,4,11,3,1,4,8,1,0,0,1,1,2,0,3
153929,2022,Poland,Germany,1,1,15,17,5/6/2022,0,0,1,1,6,4,7,17,2,3,4,9,1,0,0,1,2,0,0,2
153929,2022,Germany,Korea,1,1,15,17,3/6/2022,0,0,1,1,6,1,10,17,2,3,4,9,1,0,1,2,4,0,1,5
153929,2022,Germany,Japan,0,1,13,14,2/6/2022,0,0,1,1,13,1,18,32,1,2,7,10,2,0,3,5,5,0,0,5
153929,2022,Germany,Brazil,1,1,14,16,31/05/2022,0,0,0,0,10,1,5,16,2,6,8,16,0,0,0,0,4,0,0,4
182628,2022,USA,Germany,0,0,0,0,3/7/2022,0,0,0,0,0,0,0,0,0,0,0,0,0,0,0,0,0,0,0,0
182628,2022,Germany,Canada,0,0,0,0,3/7/2022,0,0,0,0,0,0,0,0,0,0,0,0,0,0,0,0,0,0,0,0
182628,2022,Germany,Belgium,0,0,0,0,30/06/2022,0,0,0,0,0,0,0,0,0,0,0,0,0,0,0,0,0,0,0,0
182628,2022,Serbia,Germany,0,0,0,0,28/06/2022,0,0,0,0,0,0,0,0,0,0,0,0,0,0,0,0,0,0,0,0
182628,2022,Germany,Dominican Republic,0,0,0,0,19/06/2022,0,0,0,0,0,0,0,0,0,0,0,0,0,0,0,0,0,0,0,0
182628,2022,Germany,Türkiye,0,2,6,8,18/06/2022,0,0,0,0,1,0,2,3,0,2,2,4,0,0,0,0,1,0,0,1
182628,2022,Germany,Italy,0,0,0,0,17/06/2022,0,0,0,0,0,0,0,0,0,0,0,0,0,0,0,0,0,0,0,0
182628,2022,Netherlands,Germany,0,0,0,0,14/06/2022,0,0,0,0,0,0,0,0,0,0,0,0,0,0,0,0,0,0,0,0
182628,2022,Poland,Germany,0,0,5,5,5/6/2022,0,0,0,0,0,0,0,0,0,0,0,0,0,0,0,0,0,1,0,1
182628,2022,Germany,Korea,0,0,0,0,3/6/2022,0,0,0,0,0,0,0,0,0,0,0,0,0,0,0,0,0,0,0,0
182628,2022,Germany,Japan,0,0,4,4,2/6/2022,0,0,0,0,0,0,0,0,0,0,0,0,0,0,0,0,1,0,0,1
182628,2022,Germany,Brazil,0,0,0,0,31/05/2022,0,0,0,0,0,0,0,0,0,0,0,0,0,0,0,0,0,0,0,0
181272,2022,USA,Germany,0,0,0,0,3/7/2022,0,0,9,9,0,0,0,0,0,1,0,1,0,0,0,0,2,1,0,3
181272,2022,Germany,Canada,0,0,0,0,3/7/2022,0,0,0,0,0,0,0,0,0,0,0,0,0,0,0,0,0,0,0,0
181272,2022,Germany,Belgium,0,0,0,0,30/06/2022,0,0,0,0,0,0,0,0,0,0,0,0,0,0,0,0,0,0,0,0
181272,2022,Serbia,Germany,0,0,0,0,28/06/2022,0,0,0,0,0,0,0,0,0,0,0,0,0,0,0,0,0,0,0,0
177765,2022,USA,Germany,0,1,4,5,3/7/2022,0,0,2,2,6,1,4,11,1,1,2,4,0,0,0,0,2,1,0,3
177765,2022,Germany,Canada,0,0,0,0,3/7/2022,0,0,0,0,0,0,0,0,0,0,0,0,0,0,0,0,0,0,0,0
177765,2022,Germany,Belgium,0,0,7,7,30/06/2022,0,0,1,1,5,1,5,11,0,2,0,2,0,0,0,0,1,0,0,1
177765,2022,Serbia,Germany,0,0,0,0,28/06/2022,0,0,0,0,0,0,0,0,0,0,0,0,0,0,0,0,0,0,0,0
177765,2022,Germany,Dominican Republic,0,1,6,7,19/06/2022,0,0,1,1,4,0,3,7,1,1,3,5,0,0,0,0,0,0,0,0
177765,2022,Germany,Türkiye,0,0,0,0,18/06/2022,0,0,0,0,0,0,0,0,0,0,0,0,0,0,0,0,0,0,0,0
177765,2022,Germany,Italy,0,1,1,2,17/06/2022,0,0,0,0,1,1,2,4,0,0,0,0,0,0,0,0,0,0,0,0
177765,2022,Netherlands,Germany,0,0,0,0,14/06/2022,0,0,0,0,0,0,0,0,0,0,0,0,0,0,0,0,0,0,0,0
177765,2022,Poland,Germany,0,0,0,0,5/6/2022,0,0,0,0,0,0,0,0,0,0,0,0,0,0,0,0,0,0,0,0
177765,2022,Germany,Korea,2,1,8,11,3/6/2022,0,0,0,0,8,0,0,8,0,1,4,5,0,0,1,1,2,0,1,3
177765,2022,Germany,Japan,0,0,0,0,2/6/2022,0,0,0,0,0,0,0,0,0,0,0,0,0,0,0,0,0,0,0,0
177765,2022,Germany,Brazil,0,0,1,1,31/05/2022,0,0,0,0,1,0,0,1,0,0,0,0,1,0,0,1,0,0,0,0
151011,2022,,,-,-,-,-,-,-,-,-,-,-,-,-,-,-,-,-,-,-,-,-,-,-,-,-,-
158238,2022,,,-,-,-,-,-,-,-,-,-,-,-,-,-,-,-,-,-,-,-,-,-,-,-,-,-
151017,2022,,,-,-,-,-,-,-,-,-,-,-,-,-,-,-,-,-,-,-,-,-,-,-,-,-,-
189214,2022,,,-,-,-,-,-,-,-,-,-,-,-,-,-,-,-,-,-,-,-,-,-,-,-,-,-
189215,2022,,,-,-,-,-,-,-,-,-,-,-,-,-,-,-,-,-,-,-,-,-,-,-,-,-,-
189213,2022,,,-,-,-,-,-,-,-,-,-,-,-,-,-,-,-,-,-,-,-,-,-,-,-,-,-
119316,2022,,,-,-,-,-,-,-,-,-,-,-,-,-,-,-,-,-,-,-,-,-,-,-,-,-,-
151658,2022,Italy,Brazil,0,1,1,2,17/07/2022,0,0,0,0,0,0,0,0,0,0,0,0,0,0,0,0,0,0,0,0
151658,2022,Türkiye,Italy,0,0,3,3,16/07/2022,0,0,0,0,0,0,0,0,0,0,0,0,0,0,0,0,0,0,0,0
151658,2022,Italy,China,0,2,2,4,14/07/2022,0,0,0,0,1,1,0,2,1,0,0,1,0,0,0,0,0,1,0,1
151658,2022,Thailand,Italy,0,0,0,0,3/7/2022,0,0,0,0,0,0,0,0,0,0,0,0,0,0,0,0,0,0,0,0
151658,2022,Italy,Bulgaria,0,0,0,0,2/7/2022,0,0,0,0,0,0,0,0,0,0,0,0,0,0,0,0,0,0,0,0
151658,2022,Italy,Korea,0,0,0,0,1/7/2022,0,0,0,0,0,0,0,0,0,0,0,0,0,0,0,0,0,0,0,0
151658,2022,Italy,Poland,0,1,2,3,29/06/2022,0,0,0,0,0,0,0,0,0,1,0,1,0,0,0,0,0,0,0,0
151658,2022,Italy,Brazil,1,2,15,18,18/06/2022,0,0,0,0,7,0,4,11,1,1,5,7,0,0,0,0,5,1,0,6
151658,2022,Germany,Italy,1,1,3,5,17/06/2022,0,0,0,0,0,0,0,0,0,0,0,0,0,0,0,0,0,0,0,0
151658,2022,Italy,Dominican Republic,0,2,5,7,16/06/2022,0,0,1,1,0,0,0,0,0,0,0,0,0,0,0,0,0,1,0,1
151658,2022,Serbia,Italy,0,0,2,2,15/06/2022,0,0,0,0,1,0,1,2,0,0,1,1,0,0,0,0,0,0,1,1
151658,2022,China,Italy,2,1,9,12,4/6/2022,0,0,1,1,0,2,3,5,0,2,5,7,0,0,1,1,1,1,0,2
151658,2022,Netherlands,Italy,2,2,11,15,3/6/2022,0,0,2,2,6,2,2,10,2,0,5,7,0,0,0,0,3,0,0,3
151658,2022,Belgium,Italy,0,1,4,5,2/6/2022,0,0,1,1,0,0,0,0,0,0,0,0,0,0,0,0,2,0,0,2
151658,2022,Türkiye,Italy,0,1,4,5,31/05/2022,0,0,0,0,0,0,0,0,0,0,0,0,0,0,0,0,1,0,0,1
151986,2022,Italy,Brazil,0,0,1,1,18/06/2022,2,0,6,8,0,0,0,0,0,0,0,0,0,0,0,0,0,0,0,0
151986,2022,Germany,Italy,0,0,1,1,17/06/2022,0,0,1,1,0,0,0,0,0,0,0,0,0,0,0,0,0,0,0,0
151986,2022,Italy,Dominican Republic,0,0,11,11,16/06/2022,18,1,29,48,0,0,1,1,1,1,1,3,0,0,0,0,1,0,0,1
151986,2022,Serbia,Italy,0,0,0,0,15/06/2022,0,0,0,0,0,0,0,0,0,0,0,0,0,0,0,0,0,0,0,0
151986,2022,China,Italy,0,0,3,3,4/6/2022,1,0,4,5,0,0,0,0,0,0,0,0,0,0,0,0,0,0,0,0
151986,2022,Netherlands,Italy,0,1,9,10,3/6/2022,27,1,45,73,0,0,1,1,2,2,3,7,0,0,0,0,11,1,2,14
151986,2022,Belgium,Italy,0,1,1,2,2/6/2022,0,0,1,1,0,0,0,0,0,0,0,0,0,0,0,0,0,1,0,1
151986,2022,Türkiye,Italy,0,0,2,2,31/05/2022,1,0,2,3,0,0,0,0,0,0,0,0,0,0,0,0,0,0,0,0
118764,2022,Italy,Brazil,0,0,0,0,17/07/2022,0,0,0,0,0,0,0,0,0,0,0,0,0,0,0,0,0,0,0,0
118764,2022,Türkiye,Italy,0,0,0,0,16/07/2022,0,0,0,0,0,0,0,0,0,0,0,0,0,0,4,4,3,0,0,3
118764,2022,Italy,China,0,0,0,0,14/07/2022,0,0,0,0,0,0,0,0,0,0,0,0,0,0,0,0,0,0,0,0
118764,2022,Thailand,Italy,0,0,0,0,3/7/2022,0,0,0,0,0,0,0,0,0,0,0,0,0,0,0,0,0,0,0,0
118764,2022,Italy,Bulgaria,0,1,14,15,2/7/2022,0,0,0,0,8,0,8,16,1,3,0,4,2,0,14,16,8,2,1,11
118764,2022,Italy,Korea,0,0,0,0,1/7/2022,0,0,0,0,0,0,0,0,0,0,0,0,0,0,0,0,0,1,0,1
118764,2022,Italy,Poland,0,2,12,14,29/06/2022,1,0,0,1,5,2,12,19,1,4,2,7,3,0,18,21,16,2,4,22
118764,2022,China,Italy,0,0,0,0,4/6/2022,0,0,0,0,0,0,0,0,0,0,0,0,0,0,0,0,0,0,0,0
118764,2022,Netherlands,Italy,0,1,8,9,3/6/2022,0,0,1,1,10,0,12,22,1,3,1,5,7,1,13,21,4,2,0,6
118764,2022,Belgium,Italy,1,1,10,12,2/6/2022,0,0,1,1,8,2,15,25,0,3,2,5,4,1,12,17,4,3,0,7
118764,2022,Türkiye,Italy,0,0,0,0,31/05/2022,0,0,0,0,0,0,0,0,0,0,0,0,0,0,1,1,0,0,0,0
142391,2022,Italy,Brazil,0,0,0,0,17/07/2022,0,0,0,0,0,0,0,0,0,0,0,0,0,0,0,0,0,0,0,0
142391,2022,Türkiye,Italy,0,0,0,0,16/07/2022,0,0,0,0,0,0,0,0,0,0,0,0,0,0,0,0,0,0,0,0
142391,2022,Italy,China,0,0,0,0,14/07/2022,0,0,0,0,0,0,0,0,0,0,0,0,0,0,0,0,0,0,0,0
142391,2022,Thailand,Italy,0,0,0,0,3/7/2022,0,0,0,0,0,0,0,0,0,0,0,0,0,0,0,0,0,0,0,0
142391,2022,Italy,Bulgaria,0,0,0,0,2/7/2022,0,0,0,0,0,0,0,0,0,0,0,0,0,0,0,0,0,0,0,0
142391,2022,Italy,Korea,0,1,10,11,1/7/2022,0,0,0,0,5,1,8,14,0,3,5,8,0,0,0,0,0,4,0,4
142391,2022,Italy,Poland,0,0,0,0,29/06/2022,0,0,0,0,0,0,0,0,0,0,0,0,0,0,0,0,0,0,0,0
142391,2022,Italy,Brazil,0,1,11,12,18/06/2022,0,0,0,0,3,1,4,8,7,3,1,11,0,0,0,0,1,0,1,2
142391,2022,Germany,Italy,0,0,0,0,17/06/2022,0,0,0,0,0,0,0,0,0,0,0,0,0,0,0,0,0,0,0,0
142391,2022,Italy,Dominican Republic,0,0,7,7,16/06/2022,0,0,0,0,6,1,1,8,2,3,2,7,0,0,0,0,0,1,0,1
142391,2022,Serbia,Italy,0,0,0,0,15/06/2022,0,0,0,0,0,0,0,0,0,0,0,0,0,0,0,0,0,0,0,0
142391,2022,China,Italy,0,0,9,9,4/6/2022,1,0,1,2,9,1,1,11,1,2,5,8,0,0,0,0,1,0,2,3
142391,2022,Netherlands,Italy,0,0,0,0,3/6/2022,0,0,0,0,0,0,0,0,0,0,0,0,0,0,0,0,0,0,0,0
142391,2022,Belgium,Italy,0,1,14,15,2/6/2022,0,0,1,1,4,1,3,8,1,2,4,7,0,0,0,0,0,0,0,0
142391,2022,Türkiye,Italy,0,0,7,7,31/05/2022,0,0,1,1,5,1,5,11,2,5,5,12,0,0,0,0,1,1,0,2
143371,2022,Italy,Brazil,0,0,0,0,17/07/2022,0,0,5,5,1,0,0,1,0,0,1,1,0,0,0,0,0,0,0,0
143371,2022,Türkiye,Italy,0,0,0,0,16/07/2022,1,0,1,2,0,0,0,0,0,0,0,0,0,0,0,0,0,0,0,0
143371,2022,Italy,China,0,0,5,5,14/07/2022,6,0,27,33,1,0,0,1,0,0,3,3,0,0,0,0,3,0,0,3
143371,2022,Thailand,Italy,0,0,0,0,3/7/2022,0,0,0,0,0,0,0,0,0,0,0,0,0,0,0,0,0,0,0,0
143371,2022,Italy,Bulgaria,0,0,0,0,2/7/2022,0,0,0,0,0,0,0,0,0,0,0,0,0,0,0,0,0,0,0,0
143371,2022,Italy,Korea,0,2,9,11,1/7/2022,13,1,85,99,1,1,3,5,2,2,2,6,0,0,0,0,4,2,1,7
143371,2022,Italy,Poland,0,3,7,10,29/06/2022,76,0,0,76,1,1,0,2,0,4,0,4,0,0,1,1,0,2,0,2
143371,2022,Italy,Brazil,0,0,14,14,18/06/2022,21,0,45,66,0,0,1,1,4,1,4,9,0,0,0,0,3,1,0,4
143371,2022,Germany,Italy,0,0,15,15,17/06/2022,28,1,60,89,3,0,2,5,2,2,6,10,0,0,0,0,1,2,0,3
143371,2022,Italy,Dominican Republic,0,0,10,10,16/06/2022,28,0,50,78,2,0,1,3,0,3,4,7,0,0,0,0,5,0,0,5
143371,2022,Serbia,Italy,0,0,14,14,15/06/2022,0,0,70,70,2,0,1,3,3,0,8,11,0,0,0,0,7,0,2,9
143371,2022,China,Italy,1,3,9,13,4/6/2022,55,0,45,100,3,0,2,5,0,1,5,6,0,0,0,0,11,2,1,14
143371,2022,Netherlands,Italy,0,0,0,0,3/6/2022,0,0,0,0,0,0,0,0,0,0,0,0,0,0,0,0,0,0,0,0
143371,2022,Belgium,Italy,0,1,12,13,2/6/2022,13,3,81,97,0,0,1,1,2,2,4,8,0,1,0,1,7,2,1,10
143371,2022,Türkiye,Italy,0,1,8,9,31/05/2022,13,1,61,75,2,0,2,4,1,0,1,2,1,1,0,2,5,2,0,7
115478,2022,Italy,Brazil,0,0,0,0,17/07/2022,0,0,7,7,0,0,0,0,0,0,0,0,4,1,1,6,7,4,4,15
115478,2022,Türkiye,Italy,0,0,0,0,16/07/2022,0,0,13,13,0,0,0,0,0,0,0,0,6,0,3,9,11,1,1,13
115478,2022,Italy,China,0,0,0,0,14/07/2022,0,0,9,9,0,0,0,0,0,0,0,0,9,0,2,11,19,4,3,26
115478,2022,Thailand,Italy,0,0,0,0,3/7/2022,0,0,2,2,0,0,0,0,0,0,0,0,6,0,2,8,13,1,1,15
115478,2022,Italy,Bulgaria,0,0,0,0,2/7/2022,0,0,1,1,0,0,0,0,0,0,0,0,1,1,4,6,8,4,1,13
115478,2022,Italy,Korea,0,0,0,0,1/7/2022,0,0,0,0,0,0,0,0,0,0,0,0,0,0,0,0,0,0,0,0
115478,2022,Italy,Poland,0,0,0,0,29/06/2022,7,0,0,7,0,0,0,0,0,0,0,0,5,0,9,14,13,3,4,20
115478,2022,Italy,Brazil,0,0,0,0,18/06/2022,0,0,6,6,0,0,0,0,0,0,0,0,7,0,5,12,4,3,0,7
115478,2022,Germany,Italy,0,0,0,0,17/06/2022,0,0,5,5,0,0,0,0,0,0,0,0,6,0,4,10,14,0,1,15
115478,2022,Italy,Dominican Republic,0,0,0,0,16/06/2022,0,0,13,13,0,0,0,0,0,0,0,0,9,1,4,14,14,3,0,17
115478,2022,Serbia,Italy,0,0,0,0,15/06/2022,0,0,2,2,0,0,0,0,0,0,0,0,4,0,5,9,13,0,1,14
115478,2022,China,Italy,0,0,0,0,4/6/2022,3,0,8,11,0,0,0,0,0,0,0,0,7,0,15,22,13,3,3,19
115478,2022,Netherlands,Italy,0,0,0,0,3/6/2022,1,0,10,11,0,0,0,0,0,0,0,0,0,0,9,9,14,2,0,16
115478,2022,Belgium,Italy,0,0,0,0,2/6/2022,0,0,15,15,0,0,0,0,0,0,0,0,4,0,8,12,10,3,0,13
115478,2022,Türkiye,Italy,0,0,0,0,31/05/2022,1,0,8,9,0,0,0,0,0,0,0,0,3,0,9,12,6,2,2,10
173402,2022,Italy,Brazil,0,0,0,0,17/07/2022,0,0,0,0,0,0,0,0,0,0,0,0,0,0,0,0,0,1,0,1
173402,2022,Türkiye,Italy,0,0,0,0,16/07/2022,0,0,0,0,0,0,0,0,0,0,0,0,0,0,0,0,0,0,0,0
173402,2022,Italy,China,0,0,0,0,14/07/2022,0,0,0,0,0,0,0,0,0,0,0,0,0,0,0,0,0,0,0,0
173402,2022,Thailand,Italy,0,0,0,0,3/7/2022,0,0,0,0,0,0,0,0,0,0,0,0,2,0,0,2,1,0,0,1
173402,2022,Italy,Bulgaria,0,0,0,0,2/7/2022,0,0,0,0,0,0,0,0,0,0,0,0,0,0,0,0,0,0,0,0
173402,2022,Italy,Korea,0,0,0,0,1/7/2022,0,1,3,4,0,0,0,0,0,0,0,0,9,1,13,23,22,1,2,25
173402,2022,Italy,Poland,0,0,0,0,29/06/2022,0,0,0,0,0,0,0,0,0,0,0,0,0,0,0,0,0,0,0,0
173402,2022,Italy,Brazil,0,0,0,0,18/06/2022,0,0,0,0,0,0,0,0,0,0,0,0,3,0,3,6,1,1,0,2
173402,2022,Germany,Italy,0,0,0,0,17/06/2022,0,0,0,0,0,0,0,0,0,0,0,0,1,0,2,3,1,0,0,1
173402,2022,Italy,Dominican Republic,0,0,0,0,16/06/2022,0,0,0,0,0,0,0,0,0,0,0,0,1,0,1,2,0,1,0,1
173402,2022,Serbia,Italy,0,0,0,0,15/06/2022,0,0,0,0,0,0,0,0,0,0,0,0,0,0,0,0,1,0,0,1
173402,2022,China,Italy,0,0,0,0,4/6/2022,0,0,0,0,0,0,0,0,0,0,0,0,0,0,0,0,0,0,0,0
173402,2022,Netherlands,Italy,0,0,0,0,3/6/2022,0,0,0,0,0,0,0,0,0,0,0,0,1,0,1,2,1,0,1,2
173402,2022,Belgium,Italy,0,0,0,0,2/6/2022,0,0,0,0,0,0,0,0,0,0,0,0,0,0,0,0,0,0,0,0
173402,2022,Türkiye,Italy,0,0,0,0,31/05/2022,0,0,0,0,0,0,0,0,0,0,0,0,0,0,0,0,0,0,0,0
150441,2022,Italy,Brazil,0,1,8,9,17/07/2022,19,0,58,77,0,0,4,4,0,0,2,2,1,1,1,3,4,5,3,12
150441,2022,Türkiye,Italy,0,0,16,16,16/07/2022,15,1,69,85,1,0,0,1,0,0,3,3,0,1,0,1,11,2,0,13
150441,2022,Italy,China,0,0,12,12,14/07/2022,17,0,80,97,2,0,1,3,0,2,0,2,0,0,1,1,8,5,1,14
150441,2022,Thailand,Italy,1,1,17,19,3/7/2022,10,0,75,85,1,0,1,2,0,2,0,2,0,0,0,0,8,2,2,12
150441,2022,Italy,Bulgaria,1,2,11,14,2/7/2022,6,2,73,81,2,0,1,3,0,5,3,8,0,0,0,0,3,1,1,5
150441,2022,Italy,Korea,0,0,6,6,1/7/2022,1,0,12,13,0,0,0,0,0,0,0,0,0,0,0,0,1,0,0,1
150441,2022,Italy,Poland,1,0,13,14,29/06/2022,35,2,0,37,1,0,1,2,1,1,2,4,0,0,0,0,3,1,1,5
123744,2022,Italy,Brazil,1,1,8,10,17/07/2022,0,1,7,8,10,0,7,17,0,0,1,1,6,1,6,13,3,4,2,9
123744,2022,Türkiye,Italy,1,3,9,13,16/07/2022,0,0,5,5,9,2,11,22,1,3,0,4,9,0,11,20,16,1,0,17
123744,2022,Italy,China,2,2,10,14,14/07/2022,0,0,5,5,11,1,13,25,1,3,2,6,21,2,16,39,7,2,0,9
123744,2022,Italy,Brazil,0,2,13,15,18/06/2022,0,0,4,4,6,5,0,11,1,1,1,3,6,3,5,14,7,0,0,7
123744,2022,Germany,Italy,0,0,13,13,17/06/2022,0,0,1,1,11,2,2,15,0,0,3,3,8,2,7,17,5,1,0,6
123744,2022,Italy,Dominican Republic,0,0,9,9,16/06/2022,0,0,2,2,4,2,6,12,2,1,0,3,4,1,7,12,0,0,0,0
123744,2022,Serbia,Italy,4,3,16,23,15/06/2022,0,0,0,0,7,6,8,21,1,0,3,4,7,2,20,29,8,1,2,11
136690,2022,Italy,Brazil,1,2,8,11,17/07/2022,0,0,0,0,6,1,2,9,2,2,0,4,0,0,0,0,2,0,0,2
136690,2022,Türkiye,Italy,0,2,8,10,16/07/2022,0,1,3,4,4,2,3,9,0,4,2,6,0,0,0,0,4,2,0,6
136690,2022,Italy,China,1,2,12,15,14/07/2022,0,0,2,2,7,1,8,16,1,3,7,11,1,0,0,1,6,0,0,6
136690,2022,Thailand,Italy,0,2,8,10,3/7/2022,0,0,0,0,7,0,5,12,0,3,3,6,0,0,0,0,1,1,0,2
136690,2022,Italy,Bulgaria,1,2,11,14,2/7/2022,0,0,0,0,5,0,4,9,2,6,6,14,0,0,0,0,4,0,1,5
136690,2022,Italy,Korea,1,0,12,13,1/7/2022,0,0,0,0,7,0,5,12,0,5,4,9,0,0,0,0,4,0,1,5
136690,2022,Italy,Poland,0,2,12,14,29/06/2022,0,0,0,0,7,1,3,11,1,3,3,7,0,0,1,1,0,1,0,1
136690,2022,Italy,Brazil,0,0,0,0,18/06/2022,0,0,0,0,0,0,0,0,0,0,0,0,0,0,0,0,0,0,0,0
136690,2022,Germany,Italy,0,0,11,11,17/06/2022,0,0,1,1,6,3,5,14,3,3,4,10,0,0,1,1,2,1,0,3
136690,2022,Italy,Dominican Republic,0,0,15,15,16/06/2022,0,0,0,0,4,2,8,14,1,9,2,12,0,0,0,0,3,1,0,4
136690,2022,Serbia,Italy,0,1,14,15,15/06/2022,0,0,0,0,4,2,5,11,2,0,8,10,1,0,0,1,6,0,1,7
136690,2022,China,Italy,0,0,6,6,4/6/2022,0,0,2,2,2,3,3,8,1,3,2,6,0,0,0,0,0,0,0,0
136690,2022,Netherlands,Italy,0,0,0,0,3/6/2022,0,0,0,0,0,0,0,0,0,0,0,0,0,0,0,0,0,0,0,0
136690,2022,Belgium,Italy,1,1,8,10,2/6/2022,0,0,0,0,5,1,2,8,3,7,8,18,1,0,0,1,1,3,0,4
136690,2022,Türkiye,Italy,1,2,7,10,31/05/2022,0,0,0,0,2,3,2,7,1,4,2,7,0,0,0,0,2,1,0,3
136694,2022,Italy,Brazil,0,1,16,17,17/07/2022,0,0,1,1,8,0,0,8,1,5,6,12,0,0,0,0,3,1,2,6
136694,2022,Türkiye,Italy,0,2,6,8,16/07/2022,0,0,0,0,4,2,4,10,5,8,2,15,0,0,0,0,2,3,0,5
136694,2022,Italy,China,0,1,11,12,14/07/2022,0,0,2,2,5,1,4,10,3,3,2,8,0,0,1,1,5,0,0,5
136694,2022,Thailand,Italy,1,1,9,11,3/7/2022,0,0,0,0,6,0,4,10,2,3,5,10,0,0,0,0,2,1,0,3
136694,2022,Italy,Bulgaria,2,2,8,12,2/7/2022,0,0,0,0,6,1,1,8,1,4,5,10,0,0,0,0,1,0,0,1
136694,2022,Italy,Korea,0,0,0,0,1/7/2022,0,0,0,0,0,0,0,0,0,0,0,0,0,0,0,0,0,0,0,0
136694,2022,Italy,Poland,0,2,9,11,29/06/2022,1,1,0,2,6,2,4,12,7,1,5,13,0,0,1,1,3,0,2,5
136694,2022,Italy,Brazil,0,0,0,0,18/06/2022,0,0,0,0,0,0,0,0,0,0,0,0,0,0,0,0,0,0,0,0
136694,2022,Germany,Italy,0,2,5,7,17/06/2022,0,0,1,1,4,2,3,9,3,2,4,9,0,0,0,0,1,1,0,2
136694,2022,Italy,Dominican Republic,0,0,5,5,16/06/2022,0,0,1,1,1,0,3,4,2,2,1,5,0,0,0,0,0,0,0,0
136694,2022,Serbia,Italy,1,0,14,15,15/06/2022,0,1,1,2,3,1,5,9,3,0,10,13,1,0,0,1,3,0,0,3
143393,2022,Italy,Brazil,0,0,1,1,18/06/2022,0,0,1,1,1,0,2,3,0,1,0,1,0,0,2,2,1,0,0,1
143393,2022,Germany,Italy,0,0,0,0,17/06/2022,0,0,0,0,0,0,0,0,0,0,0,0,0,0,0,0,0,0,0,0
143393,2022,Italy,Dominican Republic,0,4,5,9,16/06/2022,0,0,2,2,17,4,9,30,0,1,1,2,11,1,14,26,13,2,0,15
143393,2022,Serbia,Italy,0,0,0,0,15/06/2022,0,0,0,0,0,0,0,0,0,0,0,0,0,0,0,0,0,0,0,0
180478,2022,,,-,-,-,-,-,-,-,-,-,-,-,-,-,-,-,-,-,-,-,-,-,-,-,-,-
156104,2022,Italy,Brazil,0,1,14,15,17/07/2022,0,0,2,2,7,3,7,17,1,1,1,3,15,0,28,43,8,1,1,10
156104,2022,Türkiye,Italy,0,0,16,16,16/07/2022,0,0,0,0,7,1,12,20,1,3,3,7,9,1,11,21,5,0,1,6
156104,2022,Italy,China,1,1,8,10,14/07/2022,0,0,0,0,4,3,4,11,1,1,1,3,7,0,4,11,3,0,0,3
156104,2022,Thailand,Italy,1,2,7,10,3/7/2022,0,0,0,0,8,0,8,16,3,3,0,6,4,0,14,18,3,1,1,5
156104,2022,Italy,Bulgaria,0,0,11,11,2/7/2022,0,0,0,0,18,0,9,27,2,3,1,6,3,3,19,25,5,1,1,7
156104,2022,Italy,Korea,0,0,0,0,1/7/2022,0,0,0,0,0,0,0,0,0,0,0,0,0,0,0,0,0,0,0,0
156104,2022,Italy,Poland,0,0,0,0,29/06/2022,0,0,0,0,0,0,0,0,0,0,0,0,0,0,0,0,0,0,0,0
151664,2022,Italy,Brazil,0,0,0,0,17/07/2022,0,0,0,0,0,0,0,0,0,0,0,0,0,0,0,0,0,0,0,0
151664,2022,Türkiye,Italy,0,0,0,0,16/07/2022,0,0,0,0,0,0,0,0,0,0,0,0,0,0,0,0,0,0,0,0
151664,2022,Italy,China,0,0,0,0,14/07/2022,0,0,0,0,0,0,0,0,0,0,0,0,0,0,0,0,0,0,0,0
151664,2022,Thailand,Italy,0,0,0,0,3/7/2022,0,0,0,0,0,0,0,0,0,0,0,0,0,0,0,0,0,0,0,0
151664,2022,Italy,Bulgaria,0,1,7,8,2/7/2022,0,0,0,0,11,2,6,19,1,2,3,6,0,0,0,0,4,0,1,5
151664,2022,Italy,Korea,0,1,20,21,1/7/2022,0,0,3,3,17,6,13,36,4,6,1,11,0,0,0,0,11,0,1,12
151664,2022,Italy,Poland,0,0,0,0,29/06/2022,0,0,0,0,0,1,1,2,0,0,1,1,0,0,0,0,1,0,0,1
151664,2022,Italy,Brazil,0,0,0,0,18/06/2022,0,0,0,0,0,0,0,0,0,0,0,0,0,0,0,0,0,0,0,0
151664,2022,Germany,Italy,0,0,0,0,17/06/2022,0,0,0,0,0,0,0,0,0,0,0,0,0,0,0,0,0,0,0,0
151664,2022,Italy,Dominican Republic,0,1,12,13,16/06/2022,0,0,0,0,9,6,18,33,2,4,0,6,0,0,0,0,1,1,0,2
151664,2022,Serbia,Italy,0,0,0,0,15/06/2022,0,0,0,0,0,0,0,0,0,0,0,0,0,0,0,0,0,0,0,0
151664,2022,China,Italy,0,0,10,10,4/6/2022,1,0,2,3,18,9,13,40,1,4,2,7,0,0,0,0,3,0,2,5
151664,2022,Netherlands,Italy,0,0,8,8,3/6/2022,0,0,0,0,15,4,5,24,1,1,1,3,0,0,0,0,4,0,3,7
151664,2022,Belgium,Italy,1,1,16,18,2/6/2022,1,0,1,2,26,9,16,51,2,2,4,8,0,0,0,0,7,2,1,10
151664,2022,Türkiye,Italy,0,0,9,9,31/05/2022,0,0,1,1,14,9,17,40,1,4,1,6,0,0,0,0,2,1,1,4
143391,2022,China,Italy,0,0,0,0,4/6/2022,0,0,0,0,0,0,0,0,0,0,0,0,0,0,0,0,0,0,0,0
143391,2022,Netherlands,Italy,0,0,0,0,3/6/2022,0,0,0,0,0,0,0,0,0,0,0,0,0,0,0,0,0,0,0,0
143391,2022,Belgium,Italy,0,0,0,0,2/6/2022,0,0,0,0,0,1,1,2,0,0,0,0,0,0,1,1,0,0,0,0
143391,2022,Türkiye,Italy,0,0,0,0,31/05/2022,0,0,0,0,0,0,0,0,0,0,0,0,0,1,0,1,1,0,0,1
136701,2022,Italy,Brazil,0,0,0,0,17/07/2022,0,0,0,0,0,0,0,0,0,0,0,0,0,0,0,0,0,0,0,0
136701,2022,Türkiye,Italy,0,0,0,0,16/07/2022,0,0,0,0,0,0,2,2,0,0,0,0,1,0,3,4,0,0,0,0
136701,2022,Italy,China,0,0,6,6,14/07/2022,0,0,3,3,5,6,10,21,0,1,2,3,6,0,14,20,10,1,0,11
136701,2022,Thailand,Italy,0,0,9,9,3/7/2022,0,1,0,1,9,1,6,16,0,0,2,2,4,0,15,19,4,4,5,13
136701,2022,Italy,Bulgaria,0,0,0,0,2/7/2022,0,0,0,0,0,0,0,0,0,0,0,0,0,0,0,0,0,0,0,0
136701,2022,Italy,Korea,0,2,11,13,1/7/2022,1,0,3,4,13,5,16,34,4,2,2,8,3,0,17,20,9,1,1,11
136701,2022,Italy,Poland,1,0,2,3,29/06/2022,0,0,0,0,0,0,0,0,0,0,0,0,0,1,0,1,0,0,0,0
136701,2022,Italy,Brazil,0,0,0,0,18/06/2022,0,0,0,0,0,0,0,0,0,0,0,0,0,0,0,0,0,0,0,0
136701,2022,Germany,Italy,0,0,0,0,17/06/2022,0,0,0,0,0,0,0,0,0,0,0,0,0,0,0,0,0,0,0,0
136701,2022,Italy,Dominican Republic,0,0,0,0,16/06/2022,0,0,0,0,0,0,0,0,0,0,0,0,0,0,0,0,0,0,0,0
136701,2022,Serbia,Italy,0,0,0,0,15/06/2022,0,0,0,0,0,0,0,0,0,0,0,0,0,0,0,0,0,0,0,0
150840,2022,Italy,Brazil,0,3,7,10,17/07/2022,0,0,0,0,18,8,16,42,3,3,3,9,0,0,0,0,4,4,1,9
150840,2022,Türkiye,Italy,1,2,8,11,16/07/2022,0,0,2,2,22,5,18,45,3,2,4,9,0,0,0,0,2,2,0,4
150840,2022,Italy,China,4,1,15,20,14/07/2022,0,0,2,2,32,10,24,66,0,4,1,5,0,0,0,0,10,5,1,16
150840,2022,Thailand,Italy,4,1,9,14,3/7/2022,0,1,1,2,19,4,10,33,1,1,1,3,0,0,0,0,4,2,2,8
150840,2022,Italy,Bulgaria,0,0,0,0,2/7/2022,0,0,0,0,0,0,0,0,0,0,0,0,0,0,0,0,0,0,0,0
150840,2022,Italy,Korea,0,0,0,0,1/7/2022,0,0,0,0,0,0,0,0,0,0,0,0,0,0,0,0,0,0,0,0
150840,2022,Italy,Poland,1,6,7,14,29/06/2022,1,1,0,2,26,5,21,52,2,1,3,6,0,0,0,0,6,0,2,8
150840,2022,Italy,Brazil,0,3,11,14,18/06/2022,0,0,0,0,20,5,13,38,2,4,2,8,0,0,0,0,3,2,0,5
150840,2022,Germany,Italy,0,3,8,11,17/06/2022,0,0,2,2,22,8,11,41,0,2,1,3,0,0,0,0,3,2,1,6
150840,2022,Italy,Dominican Republic,1,2,1,4,16/06/2022,0,0,0,0,6,4,7,17,1,2,1,4,0,0,0,0,3,0,1,4
150840,2022,Serbia,Italy,2,3,10,15,15/06/2022,0,0,1,1,19,4,18,41,2,0,7,9,0,0,0,0,5,0,5,10
173917,2022,,,-,-,-,-,-,-,-,-,-,-,-,-,-,-,-,-,-,-,-,-,-,-,-,-,-
163627,2022,,,-,-,-,-,-,-,-,-,-,-,-,-,-,-,-,-,-,-,-,-,-,-,-,-,-
143370,2022,Thailand,Italy,0,0,0,0,3/7/2022,0,0,0,0,0,0,0,0,0,0,0,0,0,0,0,0,0,0,0,0
143370,2022,Italy,Bulgaria,0,0,0,0,2/7/2022,0,0,0,0,0,0,0,0,0,0,0,0,0,0,0,0,0,0,0,0
143370,2022,Italy,Korea,2,4,16,22,1/7/2022,0,0,3,3,12,7,6,25,1,2,3,6,2,0,20,22,5,4,2,11
143370,2022,Italy,Poland,1,2,16,19,29/06/2022,2,0,1,3,16,7,13,36,2,4,1,7,6,3,33,42,9,2,0,11
143370,2022,Italy,Brazil,0,4,9,13,18/06/2022,0,0,1,1,10,3,6,19,0,3,1,4,5,2,20,27,4,1,1,6
143370,2022,Germany,Italy,1,2,9,12,17/06/2022,0,0,1,1,7,5,7,19,0,1,4,5,7,3,20,30,4,0,0,4
143370,2022,Italy,Dominican Republic,1,3,7,11,16/06/2022,0,0,0,0,9,4,15,28,1,1,1,3,12,1,21,34,3,1,2,6
143370,2022,Serbia,Italy,0,5,6,11,15/06/2022,0,0,0,0,14,4,5,23,2,0,1,3,11,0,13,24,3,0,2,5
143370,2022,China,Italy,1,5,5,11,4/6/2022,0,0,1,1,21,8,11,40,1,2,3,6,5,3,19,27,15,5,1,21
143370,2022,Netherlands,Italy,0,4,14,18,3/6/2022,1,0,1,2,13,3,8,24,1,3,0,4,2,1,11,14,7,2,2,11
143370,2022,Belgium,Italy,0,2,0,2,2/6/2022,0,0,0,0,1,2,2,5,0,1,0,1,2,0,5,7,1,0,0,1
143370,2022,Türkiye,Italy,0,2,4,6,31/05/2022,1,0,1,2,5,1,6,12,0,4,2,6,12,2,25,39,4,1,1,6
163061,2022,China,Italy,0,0,0,0,4/6/2022,0,0,0,0,0,1,2,3,0,0,0,0,0,0,0,0,1,0,1,2
163061,2022,Netherlands,Italy,0,0,0,0,3/6/2022,0,0,0,0,0,0,0,0,0,0,0,0,0,0,0,0,0,0,0,0
163061,2022,Belgium,Italy,0,1,0,1,2/6/2022,0,0,0,0,0,0,0,0,0,0,0,0,0,0,1,1,1,0,0,1
163061,2022,Türkiye,Italy,0,1,1,2,31/05/2022,0,0,0,0,1,1,0,2,0,0,0,0,0,0,2,2,0,0,0,0
136697,2022,China,Italy,0,2,12,14,4/6/2022,1,0,3,4,6,6,8,20,0,1,0,1,10,2,27,39,3,4,2,9
136697,2022,Netherlands,Italy,0,0,0,0,3/6/2022,0,0,0,0,0,0,0,0,0,0,0,0,0,0,0,0,0,0,0,0
136697,2022,Belgium,Italy,2,1,14,17,2/6/2022,0,0,1,1,12,1,14,27,1,4,3,8,11,2,25,38,6,3,0,9
136697,2022,Türkiye,Italy,0,1,7,8,31/05/2022,0,0,1,1,8,0,11,19,1,4,1,6,1,0,8,9,4,2,1,7
151661,2022,China,Italy,0,0,1,1,4/6/2022,0,0,0,0,0,0,0,0,0,1,0,1,0,0,0,0,0,0,0,0
151661,2022,Netherlands,Italy,1,0,12,13,3/6/2022,0,0,3,3,6,1,7,14,3,0,4,7,0,0,1,1,2,0,0,2
151661,2022,Belgium,Italy,0,0,0,0,2/6/2022,0,0,0,0,0,0,1,1,0,0,1,1,0,0,0,0,0,0,0,0
151661,2022,Türkiye,Italy,0,0,2,2,31/05/2022,0,0,1,1,0,0,1,1,0,0,0,0,0,0,0,0,0,0,0,0
173730,2022,,,-,-,-,-,-,-,-,-,-,-,-,-,-,-,-,-,-,-,-,-,-,-,-,-,-
168062,2022,Brazil,Japan,0,0,0,0,13/07/2022,0,0,0,0,0,0,0,0,0,0,0,0,0,0,0,0,0,0,0,0
168062,2022,Belgium,Japan,0,0,0,0,3/7/2022,0,0,0,0,0,0,0,0,0,0,0,0,0,0,0,0,0,0,0,0
168062,2022,Japan,Serbia,0,0,0,0,2/7/2022,0,0,0,0,0,0,0,0,0,0,0,0,0,0,0,0,0,0,0,0
168062,2022,Türkiye,Japan,0,0,0,0,1/7/2022,0,0,7,7,0,0,0,0,0,0,0,0,6,1,8,15,7,1,0,8
168062,2022,Japan,Netherlands,0,0,0,0,29/06/2022,0,0,3,3,0,0,0,0,0,0,0,0,11,0,9,20,12,3,0,15
168062,2022,Japan,China,0,0,0,0,19/06/2022,0,0,0,0,0,0,0,0,0,0,0,0,0,0,0,0,0,0,0,0
168062,2022,Japan,Thailand,0,0,0,0,17/06/2022,0,0,0,0,0,0,0,0,0,0,0,0,0,0,0,0,0,0,0,0
168062,2022,Bulgaria,Japan,0,0,0,0,16/06/2022,1,0,3,4,0,0,0,0,0,0,0,0,5,0,7,12,18,6,1,25
168062,2022,Japan,Poland,0,0,0,0,14/06/2022,0,0,0,0,0,0,0,0,0,0,0,0,0,0,0,0,0,0,0,0
168062,2022,Japan,USA,0,0,0,0,5/6/2022,0,0,0,0,0,0,0,0,0,0,0,0,0,0,0,0,0,0,0,0
168062,2022,Dominican Republic,Japan,0,0,0,0,4/6/2022,0,0,0,0,0,0,0,0,0,0,0,0,0,0,0,0,0,0,0,0
168062,2022,Germany,Japan,0,0,0,0,2/6/2022,0,0,0,0,0,0,0,0,0,0,0,0,0,0,0,0,0,0,0,0
168062,2022,Korea,Japan,0,0,0,0,2/6/2022,0,0,0,0,0,0,0,0,0,0,0,0,0,0,0,0,0,0,0,0
146207,2022,Brazil,Japan,0,0,0,0,13/07/2022,0,0,0,0,0,0,0,0,0,0,0,0,0,0,0,0,0,0,0,0
146207,2022,Belgium,Japan,2,1,8,11,3/7/2022,0,0,1,1,5,2,7,14,1,0,0,1,10,1,1,12,6,1,0,7
146207,2022,Japan,Serbia,0,1,1,2,2/7/2022,0,0,2,2,3,2,4,9,0,0,0,0,5,0,5,10,2,0,0,2
146207,2022,Türkiye,Japan,1,1,6,8,1/7/2022,0,0,4,4,8,2,4,14,0,0,1,1,10,1,7,18,6,0,0,6
146207,2022,Japan,Netherlands,0,1,7,8,29/06/2022,0,0,0,0,4,1,10,15,0,1,0,1,10,2,10,22,0,0,0,0
146207,2022,Japan,China,0,0,0,0,19/06/2022,0,0,0,0,0,0,0,0,0,0,0,0,0,0,0,0,0,0,0,0
146207,2022,Japan,Thailand,0,0,0,0,17/06/2022,0,0,0,0,0,0,0,0,0,0,0,0,0,0,0,0,0,0,0,0
146207,2022,Bulgaria,Japan,0,2,7,9,16/06/2022,0,0,2,2,9,1,4,14,0,0,1,1,7,0,17,24,8,0,0,8
146207,2022,Japan,Poland,0,0,0,0,14/06/2022,0,0,0,0,0,0,0,0,0,0,0,0,0,0,0,0,0,0,0,0
146207,2022,Japan,USA,0,0,0,0,5/6/2022,0,0,0,0,0,0,0,0,0,0,0,0,0,0,0,0,0,0,0,0
146207,2022,Dominican Republic,Japan,0,0,6,6,4/6/2022,0,0,1,1,2,2,7,11,0,0,1,1,6,0,1,7,3,0,0,3
146207,2022,Germany,Japan,2,0,15,17,2/6/2022,0,0,2,2,6,0,17,23,0,3,4,7,25,2,6,33,16,1,0,17
146207,2022,Korea,Japan,0,0,9,9,2/6/2022,0,0,3,3,4,2,6,12,0,0,2,2,5,0,2,7,7,0,0,7
143437,2022,Brazil,Japan,0,1,8,9,13/07/2022,0,0,1,1,12,6,25,43,1,1,1,3,11,1,31,43,5,3,2,10
143437,2022,Belgium,Japan,1,1,13,15,3/7/2022,0,0,5,5,24,6,33,63,0,3,0,3,9,0,6,15,9,0,0,9
143437,2022,Japan,Serbia,0,0,16,16,2/7/2022,0,0,3,3,13,5,31,49,1,1,2,4,8,1,11,20,11,1,0,12
143437,2022,Türkiye,Japan,0,0,0,0,1/7/2022,0,0,0,0,0,0,0,0,0,0,0,0,0,0,0,0,0,0,0,0
143437,2022,Japan,Netherlands,0,0,15,15,29/06/2022,0,0,0,0,31,3,35,69,0,1,2,3,18,0,11,29,7,3,0,10
143437,2022,Japan,China,1,1,10,12,19/06/2022,0,0,1,1,17,3,23,43,4,2,2,8,5,3,23,31,15,3,0,18
143437,2022,Japan,Thailand,0,1,10,11,17/06/2022,0,0,1,1,18,5,17,40,3,2,3,8,3,0,9,12,11,2,3,16
143437,2022,Bulgaria,Japan,1,0,14,15,16/06/2022,0,0,2,2,17,2,12,31,0,1,4,5,4,0,12,16,9,1,0,10
143437,2022,Japan,Poland,1,0,15,16,14/06/2022,0,0,0,0,16,3,12,31,2,1,2,5,3,0,9,12,6,1,1,8
143437,2022,Japan,USA,0,2,10,12,5/6/2022,0,0,0,0,17,4,21,42,2,3,2,7,18,0,3,21,10,1,0,11
143437,2022,Dominican Republic,Japan,0,1,13,14,4/6/2022,0,0,4,4,17,8,26,51,2,1,4,7,14,1,4,19,8,1,0,9
143437,2022,Germany,Japan,0,2,18,20,2/6/2022,0,0,4,4,33,9,34,76,0,2,3,5,19,1,6,26,13,1,0,14
143437,2022,Korea,Japan,0,1,13,14,2/6/2022,0,0,3,3,19,1,14,34,3,2,1,6,7,0,0,7,14,0,0,14
162218,2022,Brazil,Japan,2,1,6,9,13/07/2022,0,0,1,1,6,2,4,12,0,0,1,1,6,0,5,11,4,3,1,8
162218,2022,Belgium,Japan,0,1,7,8,3/7/2022,0,0,0,0,0,0,0,0,0,0,0,0,0,0,0,0,0,1,0,1
162218,2022,Japan,Serbia,1,0,8,9,2/7/2022,0,0,0,0,8,1,19,28,0,3,0,3,4,0,1,5,9,2,0,11
162218,2022,Türkiye,Japan,0,3,12,15,1/7/2022,0,0,5,5,19,8,18,45,0,2,1,3,13,0,5,18,6,1,0,7
162218,2022,Japan,Netherlands,0,3,4,7,29/06/2022,0,0,0,0,10,3,4,17,0,0,1,1,3,1,9,13,5,0,0,5
162218,2022,Japan,China,0,1,2,3,19/06/2022,0,0,0,0,0,0,0,0,0,0,0,0,0,0,0,0,0,0,0,0
162218,2022,Japan,Thailand,0,0,8,8,17/06/2022,0,0,0,0,0,0,0,0,0,0,0,0,0,0,0,0,2,0,0,2
162218,2022,Bulgaria,Japan,2,1,2,5,16/06/2022,0,0,1,1,0,4,4,8,0,1,1,2,1,0,1,2,0,1,0,1
162218,2022,Japan,Poland,0,1,2,3,14/06/2022,0,0,0,0,0,0,0,0,0,0,0,0,0,0,0,0,0,0,0,0
162218,2022,Japan,USA,0,0,2,2,5/6/2022,0,0,0,0,0,0,0,0,0,0,0,0,0,0,0,0,1,0,0,1
162218,2022,Dominican Republic,Japan,0,1,0,1,4/6/2022,0,0,0,0,0,0,0,0,0,0,0,0,0,0,0,0,0,0,0,0
162218,2022,Germany,Japan,0,1,12,13,2/6/2022,0,0,1,1,7,5,10,22,0,2,2,4,1,0,2,3,11,4,0,15
162218,2022,Korea,Japan,2,1,15,18,2/6/2022,0,0,2,2,10,3,12,25,2,1,1,4,12,0,5,17,21,1,0,22
141953,2022,Brazil,Japan,1,1,16,18,13/07/2022,0,0,3,3,6,1,9,16,1,3,6,10,0,0,0,0,4,1,0,5
141953,2022,Belgium,Japan,0,0,10,10,3/7/2022,0,0,3,3,4,3,8,15,1,6,3,10,0,0,1,1,3,0,0,3
141953,2022,Japan,Serbia,2,0,12,14,2/7/2022,0,0,1,1,10,2,9,21,0,3,0,3,0,0,0,0,2,1,1,4
141953,2022,Türkiye,Japan,0,0,5,5,1/7/2022,0,0,3,3,2,2,5,9,1,2,1,4,2,0,1,3,2,1,0,3
141953,2022,Japan,Netherlands,0,0,7,7,29/06/2022,0,0,0,0,5,1,3,9,1,3,3,7,0,0,0,0,1,0,0,1
141953,2022,Japan,China,1,1,9,11,19/06/2022,0,0,1,1,5,2,4,11,1,3,3,7,0,0,1,1,0,0,0,0
141953,2022,Japan,Thailand,0,0,8,8,17/06/2022,0,0,1,1,4,1,13,18,0,3,7,10,1,0,0,1,4,0,0,4
141953,2022,Bulgaria,Japan,0,1,9,10,16/06/2022,0,0,1,1,3,0,10,13,2,2,4,8,0,0,1,1,2,1,1,4
141953,2022,Japan,Poland,1,0,11,12,14/06/2022,0,0,1,1,9,1,6,16,0,3,0,3,0,0,1,1,3,0,1,4
141953,2022,Japan,USA,0,0,8,8,5/6/2022,0,0,3,3,4,1,5,10,3,7,1,11,4,0,0,4,3,0,0,3
141953,2022,Dominican Republic,Japan,0,1,7,8,4/6/2022,0,0,2,2,1,1,2,4,1,2,4,7,0,0,0,0,2,0,0,2
141953,2022,Germany,Japan,0,0,0,0,2/6/2022,0,0,0,0,0,0,0,0,0,0,0,0,0,0,0,0,0,0,0,0
141953,2022,Korea,Japan,0,0,0,0,2/6/2022,0,0,0,0,0,0,0,0,0,0,0,0,0,0,0,0,0,0,0,0
152457,2022,,,-,-,-,-,-,-,-,-,-,-,-,-,-,-,-,-,-,-,-,-,-,-,-,-,-
132100,2022,Japan,China,0,0,0,0,19/06/2022,0,0,0,0,0,0,0,0,0,0,0,0,0,0,0,0,0,0,0,0
132100,2022,Japan,Thailand,0,0,0,0,17/06/2022,0,0,0,0,0,0,0,0,0,0,0,0,0,0,0,0,0,0,0,0
132100,2022,Bulgaria,Japan,0,0,2,2,16/06/2022,0,0,1,1,0,0,0,0,0,0,0,0,0,0,0,0,1,0,0,1
132100,2022,Japan,Poland,0,0,0,0,14/06/2022,0,0,0,0,0,0,0,0,0,0,0,0,0,0,0,0,0,0,0,0
142367,2022,Brazil,Japan,0,0,0,0,13/07/2022,0,0,5,5,0,0,0,0,0,0,0,0,2,2,19,23,6,7,8,21
142367,2022,Belgium,Japan,0,0,0,0,3/7/2022,0,0,14,14,0,0,0,0,0,0,0,0,15,0,13,28,21,1,0,22
142367,2022,Japan,Serbia,0,0,0,0,2/7/2022,0,0,13,13,0,0,0,0,0,0,0,0,28,1,17,46,25,4,0,29
142367,2022,Türkiye,Japan,0,0,0,0,1/7/2022,0,0,9,9,0,0,0,0,0,0,0,0,4,0,7,11,7,4,0,11
142367,2022,Japan,Netherlands,0,0,0,0,29/06/2022,0,0,2,2,0,0,0,0,0,0,0,0,5,0,4,9,6,2,0,8
142367,2022,Japan,China,0,0,0,0,19/06/2022,0,0,17,17,0,0,0,0,0,0,0,0,2,0,14,16,12,4,2,18
142367,2022,Japan,Thailand,0,0,0,0,17/06/2022,1,0,8,9,0,0,0,0,0,0,0,0,4,0,14,18,20,3,0,23
142367,2022,Bulgaria,Japan,0,0,0,0,16/06/2022,0,0,0,0,0,0,0,0,0,0,0,0,0,0,0,0,0,0,0,0
142367,2022,Japan,Poland,0,0,0,0,14/06/2022,0,0,2,2,0,0,0,0,0,0,0,0,6,0,9,15,7,5,1,13
142367,2022,Japan,USA,0,0,0,0,5/6/2022,0,0,9,9,0,0,0,0,0,0,0,0,11,0,8,19,16,4,2,22
142367,2022,Dominican Republic,Japan,0,0,0,0,4/6/2022,0,0,14,14,0,0,0,0,0,0,0,0,19,1,6,26,27,2,0,29
142367,2022,Germany,Japan,0,0,0,0,2/6/2022,0,0,12,12,0,0,0,0,0,0,0,0,16,1,11,28,29,5,4,38
142367,2022,Korea,Japan,0,0,0,0,2/6/2022,0,0,12,12,0,0,0,0,0,0,0,0,3,2,0,5,6,2,0,8
142372,2022,Brazil,Japan,1,1,6,8,13/07/2022,0,0,0,0,4,1,5,10,0,1,0,1,0,0,0,0,4,3,3,10
142372,2022,Belgium,Japan,0,0,8,8,3/7/2022,0,0,2,2,7,3,19,29,0,1,1,2,0,0,0,0,8,0,1,9
142372,2022,Japan,Serbia,1,0,7,8,2/7/2022,0,0,1,1,3,4,16,23,1,1,0,2,0,0,0,0,12,1,0,13
142372,2022,Türkiye,Japan,1,1,5,7,1/7/2022,0,0,4,4,4,4,8,16,0,1,1,2,6,0,5,11,4,1,0,5
142372,2022,Japan,Netherlands,1,1,8,10,29/06/2022,0,0,1,1,7,5,14,26,0,2,1,3,0,0,0,0,5,1,0,6
142372,2022,Japan,China,2,2,18,22,19/06/2022,0,0,2,2,12,7,27,46,1,1,1,3,0,0,0,0,6,2,2,10
142372,2022,Japan,Thailand,0,1,10,11,17/06/2022,0,0,0,0,17,1,19,37,1,1,8,10,0,0,0,0,14,2,0,16
142372,2022,Bulgaria,Japan,0,1,9,10,16/06/2022,0,0,1,1,13,0,18,31,3,0,1,4,0,0,0,0,4,2,1,7
142372,2022,Japan,Poland,0,3,8,11,14/06/2022,0,0,0,0,16,4,19,39,1,2,3,6,0,0,0,0,2,1,0,3
142372,2022,Japan,USA,1,0,10,11,5/6/2022,0,0,1,1,17,2,24,43,1,3,3,7,1,0,0,1,16,1,0,17
142372,2022,Dominican Republic,Japan,1,2,9,12,4/6/2022,0,0,3,3,22,2,17,41,3,0,2,5,0,0,0,0,15,3,1,19
142372,2022,Germany,Japan,0,1,14,15,2/6/2022,0,0,7,7,13,1,15,29,0,0,3,3,0,0,0,0,10,1,1,12
142372,2022,Korea,Japan,0,0,0,0,2/6/2022,0,0,1,1,0,0,0,0,0,0,0,0,0,0,0,0,0,0,0,0
181174,2022,,,-,-,-,-,-,-,-,-,-,-,-,-,-,-,-,-,-,-,-,-,-,-,-,-,-
162877,2022,Japan,USA,0,0,0,0,5/6/2022,0,0,0,0,0,0,0,0,0,0,0,0,0,0,0,0,0,0,0,0
162877,2022,Dominican Republic,Japan,0,0,0,0,4/6/2022,0,0,1,1,2,1,1,4,0,0,0,0,0,0,0,0,0,0,0,0
162877,2022,Germany,Japan,0,0,0,0,2/6/2022,0,0,0,0,0,0,0,0,0,0,0,0,0,0,0,0,0,0,0,0
162877,2022,Korea,Japan,0,0,0,0,2/6/2022,0,0,0,0,0,0,0,0,0,0,0,0,0,0,0,0,0,0,0,0
151953,2022,Brazil,Japan,1,2,10,13,13/07/2022,0,0,5,5,14,5,13,32,1,3,1,5,4,0,11,15,9,1,6,16
151953,2022,Belgium,Japan,1,1,16,18,3/7/2022,0,0,7,7,16,3,11,30,0,5,2,7,16,1,7,24,20,1,0,21
151953,2022,Japan,Serbia,1,2,11,14,2/7/2022,0,0,8,8,15,6,23,44,1,6,3,10,4,0,2,6,18,2,0,20
151953,2022,Türkiye,Japan,0,0,12,12,1/7/2022,0,0,1,1,12,5,8,25,0,1,0,1,4,0,3,7,6,0,0,6
151953,2022,Japan,Netherlands,0,0,4,4,29/06/2022,0,0,0,0,3,2,3,8,0,0,0,0,3,0,4,7,2,0,0,2
151953,2022,Japan,China,1,1,9,11,19/06/2022,0,0,4,4,18,4,6,28,0,4,7,11,8,1,14,23,12,5,0,17
151953,2022,Japan,Thailand,0,1,8,9,17/06/2022,1,0,1,2,6,4,13,23,1,0,3,4,9,0,7,16,9,2,0,11
151953,2022,Bulgaria,Japan,0,0,0,0,16/06/2022,0,0,0,0,0,0,0,0,0,0,0,0,0,0,0,0,0,0,0,0
151953,2022,Japan,Poland,1,2,6,9,14/06/2022,0,0,0,0,5,2,4,11,1,1,0,2,12,1,16,29,12,4,1,17
151953,2022,Japan,USA,0,0,12,12,5/6/2022,0,0,2,2,5,2,6,13,0,3,4,7,7,0,1,8,14,1,0,15
151953,2022,Dominican Republic,Japan,1,1,14,16,4/6/2022,0,0,0,0,5,2,9,16,0,1,4,5,10,1,1,12,12,0,0,12
151953,2022,Germany,Japan,0,0,1,1,2/6/2022,0,0,0,0,0,0,0,0,0,0,0,0,0,0,0,0,0,0,0,0
151953,2022,Korea,Japan,0,0,2,2,2/6/2022,0,0,0,0,0,0,0,0,0,0,0,0,0,0,0,0,0,0,0,0
162227,2022,Brazil,Japan,0,0,2,2,13/07/2022,0,0,0,0,2,1,3,6,0,0,4,4,0,0,0,0,1,0,1,2
162227,2022,Belgium,Japan,0,0,0,0,3/7/2022,0,0,0,0,0,0,0,0,0,0,0,0,0,0,0,0,0,0,0,0
162227,2022,Japan,Serbia,0,2,2,4,2/7/2022,0,0,1,1,0,0,2,2,0,2,3,5,0,0,0,0,0,0,0,0
162227,2022,Türkiye,Japan,1,1,4,6,1/7/2022,0,0,0,0,0,1,4,5,0,0,2,2,0,0,1,1,0,0,0,0
162227,2022,Japan,Netherlands,2,1,12,15,29/06/2022,0,0,1,1,6,1,2,9,1,4,0,5,0,0,0,0,0,0,0,0
162227,2022,Japan,USA,0,0,0,0,5/6/2022,0,0,0,0,0,0,0,0,0,0,0,0,0,0,0,0,0,0,0,0
162227,2022,Dominican Republic,Japan,0,1,7,8,4/6/2022,0,0,1,1,1,0,2,3,0,3,2,5,0,0,0,0,1,0,0,1
162227,2022,Germany,Japan,0,3,9,12,2/6/2022,0,0,2,2,4,1,8,13,1,2,5,8,0,0,0,0,5,0,0,5
162227,2022,Korea,Japan,0,2,7,9,2/6/2022,0,0,2,2,5,0,7,12,0,2,4,6,0,0,0,0,4,1,0,5
189198,2022,,,-,-,-,-,-,-,-,-,-,-,-,-,-,-,-,-,-,-,-,-,-,-,-,-,-
189040,2022,Japan,China,0,0,16,16,19/06/2022,0,0,1,1,2,0,3,5,3,2,3,8,0,0,1,1,4,0,0,4
189040,2022,Japan,Thailand,0,2,6,8,17/06/2022,0,0,2,2,6,0,3,9,1,1,5,7,0,0,0,0,2,0,0,2
189040,2022,Bulgaria,Japan,0,1,5,6,16/06/2022,0,0,3,3,0,0,2,2,0,4,5,9,0,0,1,1,2,0,1,3
189040,2022,Japan,Poland,1,2,9,12,14/06/2022,0,0,0,0,3,1,3,7,0,1,7,8,0,0,2,2,2,1,0,3
162876,2022,Brazil,Japan,0,0,8,8,13/07/2022,32,1,55,88,3,0,0,3,0,1,5,6,0,0,0,0,6,5,5,16
162876,2022,Belgium,Japan,1,0,11,12,3/7/2022,8,0,73,81,2,0,2,4,0,1,0,1,0,0,0,0,10,0,0,10
162876,2022,Japan,Serbia,0,0,4,4,2/7/2022,0,1,34,35,1,0,0,1,0,1,0,1,0,0,0,0,3,1,0,4
162876,2022,Türkiye,Japan,0,0,7,7,1/7/2022,0,0,24,24,0,0,0,0,0,1,0,1,0,0,0,0,4,0,0,4
162876,2022,Japan,Netherlands,0,0,6,6,29/06/2022,8,0,55,63,0,0,2,2,0,0,1,1,0,0,0,0,3,2,0,5
162876,2022,Japan,China,1,1,13,15,19/06/2022,20,1,60,81,1,0,2,3,0,1,1,2,0,0,0,0,12,2,0,14
162876,2022,Japan,Thailand,0,0,0,0,17/06/2022,0,0,0,0,0,0,0,0,0,0,0,0,0,0,0,0,0,0,0,0
162876,2022,Bulgaria,Japan,0,0,1,1,16/06/2022,2,0,8,10,1,0,0,1,0,0,0,0,0,0,0,0,1,0,1,2
162876,2022,Japan,Poland,0,0,1,1,14/06/2022,0,0,0,0,0,0,0,0,0,0,0,0,0,0,0,0,0,0,0,0
162876,2022,Japan,USA,0,0,0,0,5/6/2022,0,0,0,0,0,0,0,0,0,0,0,0,0,0,0,0,0,0,0,0
162876,2022,Dominican Republic,Japan,0,0,2,2,4/6/2022,10,1,24,35,0,0,0,0,0,0,1,1,0,0,0,0,3,2,1,6
162876,2022,Germany,Japan,0,0,6,6,2/6/2022,24,0,46,70,0,0,1,1,0,1,2,3,0,1,0,1,4,1,0,5
162876,2022,Korea,Japan,0,0,8,8,2/6/2022,30,0,48,78,2,0,1,3,0,1,0,1,0,0,1,1,16,2,1,19
163046,2022,Brazil,Japan,0,1,13,14,13/07/2022,0,0,2,2,3,4,4,11,2,6,2,10,0,0,0,0,3,2,1,6
163046,2022,Belgium,Japan,0,0,0,0,3/7/2022,0,0,0,0,0,0,0,0,0,0,0,0,0,0,0,0,0,0,0,0
163046,2022,Japan,Serbia,0,0,3,3,2/7/2022,0,0,0,0,0,1,3,4,0,1,0,1,0,0,0,0,2,0,0,2
163046,2022,Türkiye,Japan,0,0,9,9,1/7/2022,0,1,0,1,2,1,5,8,0,3,1,4,0,0,0,0,1,0,0,1
163046,2022,Japan,Netherlands,0,0,6,6,29/06/2022,0,0,1,1,1,2,2,5,0,0,0,0,0,0,0,0,1,0,0,1
163046,2022,Japan,China,0,0,0,0,19/06/2022,0,0,0,0,0,0,0,0,0,0,0,0,0,0,0,0,0,0,0,0
163046,2022,Japan,Thailand,0,0,0,0,17/06/2022,0,0,0,0,0,0,0,0,0,0,0,0,0,0,0,0,0,0,0,0
163046,2022,Bulgaria,Japan,0,0,3,3,16/06/2022,0,0,0,0,3,0,1,4,0,0,2,2,0,0,0,0,0,1,0,1
163046,2022,Japan,Poland,0,0,0,0,14/06/2022,0,0,0,0,0,0,0,0,0,0,0,0,0,0,0,0,0,0,0,0
163046,2022,Japan,USA,2,3,12,17,5/6/2022,0,0,1,1,3,0,8,11,0,4,1,5,3,0,0,3,3,0,0,3
163046,2022,Dominican Republic,Japan,1,1,7,9,4/6/2022,0,0,2,2,7,2,6,15,1,0,7,8,1,0,0,1,9,1,0,10
163046,2022,Germany,Japan,2,1,9,12,2/6/2022,0,0,1,1,11,3,8,22,0,6,3,9,2,1,0,3,5,0,0,5
163046,2022,Korea,Japan,0,0,10,10,2/6/2022,0,0,2,2,7,2,8,17,0,2,3,5,0,0,0,0,4,0,0,4
146519,2022,Belgium,Japan,0,0,0,0,3/7/2022,0,0,0,0,0,0,0,0,0,0,0,0,0,0,0,0,0,0,0,0
146519,2022,Japan,Serbia,0,0,0,0,2/7/2022,0,0,0,0,0,0,0,0,0,0,0,0,0,0,0,0,0,0,0,0
146519,2022,Türkiye,Japan,0,1,4,5,1/7/2022,0,0,1,1,2,4,10,16,2,0,0,2,0,0,0,0,1,0,0,1
146519,2022,Japan,Netherlands,1,0,5,6,29/06/2022,0,0,2,2,6,4,7,17,0,1,0,1,0,0,0,0,2,0,1,3
161807,2022,Brazil,Japan,0,0,0,0,13/07/2022,0,0,0,0,0,0,0,0,0,0,0,0,0,0,0,0,0,0,0,0
161807,2022,Belgium,Japan,0,1,7,8,3/7/2022,0,1,0,1,5,1,4,10,0,4,0,4,0,1,0,1,0,1,0,1
161807,2022,Japan,Serbia,0,0,4,4,2/7/2022,0,0,2,2,1,1,6,8,0,3,1,4,0,0,0,0,0,0,0,0
161807,2022,Türkiye,Japan,0,0,2,2,1/7/2022,0,0,1,1,1,1,2,4,2,0,0,2,0,0,0,0,0,0,0,0
161807,2022,Japan,Netherlands,0,1,1,2,29/06/2022,0,0,0,0,3,1,4,8,0,0,0,0,0,0,2,2,0,0,0,0
151944,2022,Brazil,Japan,0,0,4,4,13/07/2022,12,0,27,39,0,0,0,0,0,1,1,2,0,0,0,0,1,0,0,1
151944,2022,Belgium,Japan,0,1,5,6,3/7/2022,4,1,53,58,1,0,1,2,0,1,0,1,0,0,0,0,4,0,0,4
151944,2022,Japan,Serbia,0,1,8,9,2/7/2022,7,2,128,137,1,0,3,4,0,3,0,3,0,0,0,0,10,2,0,12
151944,2022,Türkiye,Japan,1,0,6,7,1/7/2022,2,0,94,96,0,0,1,1,0,1,3,4,0,0,0,0,10,4,1,15
151944,2022,Japan,Netherlands,1,1,15,17,29/06/2022,16,0,99,115,1,0,0,1,0,2,0,2,0,0,0,0,4,4,0,8
151944,2022,Japan,China,0,0,1,1,19/06/2022,3,0,17,20,0,0,0,0,0,0,0,0,0,0,0,0,0,1,0,1
151944,2022,Japan,Thailand,0,1,14,15,17/06/2022,31,0,79,110,0,0,0,0,0,0,7,7,0,0,0,0,6,0,0,6
151944,2022,Bulgaria,Japan,0,1,6,7,16/06/2022,29,2,52,83,0,0,0,0,0,1,2,3,0,0,0,0,6,3,1,10
151944,2022,Japan,Poland,0,2,7,9,14/06/2022,25,0,75,100,0,0,0,0,0,1,2,3,0,0,0,0,1,1,1,3
151944,2022,Japan,USA,1,1,9,11,5/6/2022,19,0,79,98,1,0,2,3,0,2,3,5,0,0,0,0,10,0,0,10
151944,2022,Dominican Republic,Japan,0,0,16,16,4/6/2022,23,0,54,77,3,0,0,3,0,1,6,7,0,0,0,0,13,1,0,14
151944,2022,Germany,Japan,0,1,7,8,2/6/2022,25,1,57,83,0,0,0,0,0,1,0,1,0,0,0,0,10,0,0,10
151944,2022,Korea,Japan,0,0,0,0,2/6/2022,0,0,0,0,0,0,0,0,0,0,0,0,0,0,0,0,0,0,0,0
151955,2022,,,-,-,-,-,-,-,-,-,-,-,-,-,-,-,-,-,-,-,-,-,-,-,-,-,-
162215,2022,,,-,-,-,-,-,-,-,-,-,-,-,-,-,-,-,-,-,-,-,-,-,-,-,-,-
162225,2022,,,-,-,-,-,-,-,-,-,-,-,-,-,-,-,-,-,-,-,-,-,-,-,-,-,-
189193,2022,Brazil,Japan,0,3,5,8,13/07/2022,0,0,1,1,9,4,10,23,0,1,2,3,0,0,0,0,3,3,3,9
189193,2022,Japan,China,1,1,0,2,19/06/2022,0,0,0,0,0,0,0,0,0,0,0,0,0,0,0,0,0,0,0,0
189193,2022,Japan,Thailand,0,1,2,3,17/06/2022,0,0,0,0,0,0,0,0,0,0,0,0,0,0,0,0,0,0,0,0
189193,2022,Bulgaria,Japan,1,1,3,5,16/06/2022,0,0,0,0,0,0,0,0,0,0,0,0,0,0,0,0,0,0,0,0
189193,2022,Japan,Poland,0,0,0,0,14/06/2022,0,0,0,0,0,0,0,0,0,0,0,0,0,0,0,0,0,0,0,0
189193,2022,Japan,USA,0,0,1,1,5/6/2022,0,0,0,0,0,0,0,0,0,0,0,0,0,0,0,0,0,0,0,0
189193,2022,Dominican Republic,Japan,0,1,1,2,4/6/2022,0,0,0,0,0,0,0,0,0,0,0,0,0,0,0,0,0,0,0,0
189193,2022,Germany,Japan,0,0,8,8,2/6/2022,0,0,1,1,0,0,0,0,0,0,0,0,0,0,0,0,2,1,1,4
189193,2022,Korea,Japan,0,1,3,4,2/6/2022,0,0,1,1,2,3,5,10,0,1,1,2,1,0,0,1,3,1,0,4
174228,2022,,,-,-,-,-,-,-,-,-,-,-,-,-,-,-,-,-,-,-,-,-,-,-,-,-,-
151962,2022,,,-,-,-,-,-,-,-,-,-,-,-,-,-,-,-,-,-,-,-,-,-,-,-,-,-
189225,2022,,,-,-,-,-,-,-,-,-,-,-,-,-,-,-,-,-,-,-,-,-,-,-,-,-,-
120148,2022,China,Korea,0,2,13,15,3/7/2022,10,1,122,133,0,1,2,3,0,2,2,4,0,0,0,0,12,1,1,14
120148,2022,Italy,Korea,1,2,10,13,1/7/2022,7,1,91,99,0,0,0,0,0,0,2,2,0,0,1,1,6,2,1,9
120148,2022,Korea,Brazil,1,2,6,9,30/06/2022,55,0,2,57,0,0,0,0,0,0,0,0,0,0,1,1,2,1,2,5
120148,2022,Thailand,Korea,1,1,6,8,29/06/2022,45,1,2,48,0,1,0,1,0,0,1,1,0,0,0,0,3,0,1,4
120148,2022,Türkiye,Korea,1,1,14,16,19/06/2022,23,1,91,115,0,0,2,2,0,7,4,11,0,0,0,0,4,0,1,5
120148,2022,Netherlands,Korea,3,3,8,14,19/06/2022,25,2,62,89,0,0,1,1,0,2,0,2,0,0,0,0,3,3,1,7
120148,2022,Serbia,Korea,0,2,11,13,16/06/2022,25,2,94,121,3,0,2,5,0,0,2,2,0,0,0,0,5,2,5,12
120148,2022,Dominican Republic,Korea,1,3,9,13,15/06/2022,23,1,59,83,0,0,1,1,0,2,0,2,0,0,0,0,5,0,0,5
120148,2022,Korea,Canada,0,0,6,6,5/6/2022,2,0,55,57,1,0,0,1,0,0,0,0,0,0,0,0,4,2,0,6
120148,2022,Korea,Poland,0,2,3,5,4/6/2022,7,1,48,56,0,0,0,0,0,0,0,0,0,1,0,1,10,2,0,12
120148,2022,Germany,Korea,1,1,10,12,3/6/2022,12,1,58,71,0,0,0,0,0,0,0,0,1,0,0,1,6,0,0,6
120148,2022,Korea,Japan,0,1,8,9,2/6/2022,18,1,62,81,0,0,2,2,0,0,2,2,0,0,0,0,6,5,0,11
181150,2022,China,Korea,0,0,0,0,3/7/2022,0,0,4,4,0,0,0,0,0,0,0,0,5,1,19,25,17,2,2,21
181150,2022,Italy,Korea,0,0,0,0,1/7/2022,1,0,5,6,0,0,0,0,0,0,0,0,7,0,15,22,15,3,6,24
181150,2022,Korea,Brazil,0,0,0,0,30/06/2022,1,0,1,2,0,0,0,0,0,0,0,0,7,0,15,22,9,1,2,12
181150,2022,Thailand,Korea,0,0,0,0,29/06/2022,9,1,0,10,0,0,0,0,0,0,0,0,9,0,20,29,7,0,2,9
181150,2022,Türkiye,Korea,0,0,0,0,19/06/2022,0,0,5,5,0,0,0,0,0,0,0,0,7,0,12,19,11,1,1,13
181150,2022,Netherlands,Korea,0,0,0,0,19/06/2022,0,0,3,3,0,0,0,0,0,0,0,0,6,0,10,16,8,5,0,13
181150,2022,Serbia,Korea,0,0,0,0,16/06/2022,0,0,8,8,0,0,0,0,0,0,0,0,5,0,6,11,8,4,2,14
181150,2022,Dominican Republic,Korea,0,0,0,0,15/06/2022,0,0,8,8,0,0,0,0,0,0,0,0,13,0,10,23,7,4,0,11
181150,2022,Korea,Canada,0,0,0,0,5/6/2022,0,0,1,1,0,0,0,0,0,0,0,0,9,1,0,10,13,2,0,15
181150,2022,Korea,Poland,0,0,0,0,4/6/2022,0,0,0,0,0,0,0,0,0,0,0,0,0,0,0,0,0,0,0,0
181150,2022,Germany,Korea,0,0,0,0,3/6/2022,0,0,0,0,0,0,0,0,0,0,0,0,0,0,0,0,0,0,0,0
181150,2022,Korea,Japan,0,0,0,0,2/6/2022,0,0,0,0,0,0,0,0,0,0,0,0,0,0,0,0,0,0,0,0
135948,2022,Korea,Canada,0,0,0,0,5/6/2022,0,0,1,1,0,0,0,0,0,0,0,0,4,0,2,6,3,0,0,3
135948,2022,Korea,Poland,0,0,0,0,4/6/2022,0,0,12,12,0,0,0,0,0,0,0,0,12,0,3,15,14,3,2,19
135948,2022,Germany,Korea,0,0,0,0,3/6/2022,0,0,4,4,0,0,0,0,0,0,0,0,6,0,7,13,10,2,0,12
135948,2022,Korea,Japan,0,0,0,0,2/6/2022,0,0,7,7,0,0,0,0,0,0,0,0,7,0,4,11,17,5,1,23
175172,2022,Netherlands,Korea,0,1,0,1,19/06/2022,0,0,1,1,2,2,3,7,0,1,0,1,1,0,0,1,1,0,0,1
175172,2022,Serbia,Korea,0,4,6,10,16/06/2022,0,0,0,0,6,13,15,34,3,2,1,6,3,0,3,6,4,1,1,6
175172,2022,Dominican Republic,Korea,0,2,1,3,15/06/2022,0,0,0,0,2,0,4,6,0,0,0,0,1,0,4,5,0,0,0,0
175172,2022,Korea,Canada,0,2,2,4,5/6/2022,0,0,0,0,7,5,6,18,0,2,0,2,0,0,0,0,3,0,0,3
175172,2022,Korea,Poland,0,1,2,3,4/6/2022,0,0,0,0,4,7,6,17,0,0,1,1,2,1,3,6,2,0,0,2
175172,2022,Germany,Korea,5,3,4,12,3/6/2022,0,0,0,0,7,6,13,26,0,2,5,7,0,0,0,0,0,2,0,2
175172,2022,Korea,Japan,2,1,2,5,2/6/2022,0,0,0,0,2,4,8,14,0,1,1,2,0,0,0,0,2,0,0,2
156286,2022,China,Korea,1,1,14,16,3/7/2022,0,0,0,0,9,3,20,32,1,2,1,4,6,3,15,24,3,4,0,7
156286,2022,Italy,Korea,0,2,7,9,1/7/2022,0,0,0,0,5,6,15,26,0,0,1,1,7,1,24,32,10,2,2,14
156286,2022,Korea,Brazil,0,2,7,9,30/06/2022,5,0,0,5,4,3,14,21,2,0,0,2,5,2,12,19,4,2,2,8
156286,2022,Thailand,Korea,0,3,6,9,29/06/2022,2,0,0,2,5,8,7,20,1,1,1,3,4,0,17,21,6,0,3,9
156286,2022,Türkiye,Korea,0,2,8,10,19/06/2022,0,0,3,3,11,8,16,35,2,2,1,5,13,1,15,29,3,0,0,3
156286,2022,Netherlands,Korea,0,3,5,8,19/06/2022,0,0,3,3,7,3,6,16,0,3,2,5,9,0,9,18,8,1,3,12
156286,2022,Serbia,Korea,1,1,1,3,16/06/2022,0,0,1,1,1,0,3,4,0,0,1,1,0,0,0,0,0,0,0,0
156286,2022,Dominican Republic,Korea,0,3,3,6,15/06/2022,0,0,1,1,3,2,6,11,2,0,0,2,2,1,13,16,1,0,0,1
156286,2022,Korea,Canada,1,1,5,7,5/6/2022,0,0,3,3,6,4,9,19,0,3,3,6,7,0,7,14,6,0,0,6
156286,2022,Korea,Poland,0,0,0,0,4/6/2022,0,0,0,0,0,0,0,0,0,0,0,0,0,0,0,0,0,0,0,0
156286,2022,Germany,Korea,1,1,8,10,3/6/2022,0,0,3,3,12,2,14,28,0,3,5,8,5,2,4,11,4,0,0,4
156286,2022,Korea,Japan,0,1,6,7,2/6/2022,0,0,3,3,9,3,13,25,2,0,0,2,18,0,9,27,7,3,0,10
168184,2022,Türkiye,Korea,1,1,14,16,19/06/2022,0,0,0,0,7,4,2,13,2,1,1,4,0,0,1,1,1,1,0,2
168184,2022,Netherlands,Korea,0,0,5,5,19/06/2022,0,0,0,0,3,1,3,7,1,5,3,9,0,0,0,0,1,0,0,1
168184,2022,Serbia,Korea,0,1,14,15,16/06/2022,0,0,2,2,7,1,4,12,1,5,10,16,0,0,0,0,1,0,0,1
168184,2022,Dominican Republic,Korea,0,3,2,5,15/06/2022,0,0,3,3,5,0,6,11,5,2,1,8,0,0,0,0,1,0,0,1
168184,2022,Korea,Canada,0,0,8,8,5/6/2022,0,1,2,3,0,1,3,4,0,5,2,7,0,1,0,1,4,0,1,5
168184,2022,Korea,Poland,0,1,9,10,4/6/2022,0,0,1,1,2,0,4,6,1,2,2,5,0,0,0,0,0,0,0,0
168184,2022,Germany,Korea,0,0,4,4,3/6/2022,0,0,1,1,6,1,5,12,0,3,5,8,0,0,0,0,2,1,0,3
168184,2022,Korea,Japan,0,0,5,5,2/6/2022,0,0,1,1,2,1,8,11,2,1,4,7,0,0,0,0,3,0,0,3
163760,2022,China,Korea,2,1,16,19,3/7/2022,0,0,0,0,6,3,8,17,2,4,3,9,0,0,1,1,2,0,0,2
163760,2022,Italy,Korea,0,2,7,9,1/7/2022,0,0,0,0,4,4,15,23,3,3,2,8,0,0,0,0,2,0,1,3
163760,2022,Korea,Brazil,0,1,5,6,30/06/2022,0,0,0,0,7,5,6,18,1,6,2,9,0,0,1,1,0,0,1,1
163760,2022,Thailand,Korea,0,1,12,13,29/06/2022,1,0,0,1,6,2,5,13,2,3,0,5,0,0,0,0,2,1,0,3
163760,2022,Serbia,Korea,0,0,4,4,16/06/2022,0,0,0,0,0,0,0,0,0,0,0,0,0,0,0,0,0,0,0,0
163760,2022,Dominican Republic,Korea,0,2,4,6,15/06/2022,0,0,1,1,4,0,2,6,1,5,1,7,1,0,0,1,0,0,0,0
163760,2022,Korea,Canada,0,0,7,7,5/6/2022,0,0,1,1,0,0,2,2,0,1,2,3,0,0,0,0,1,0,0,1
163760,2022,Korea,Poland,0,1,5,6,4/6/2022,0,0,0,0,4,3,2,9,3,0,1,4,0,0,1,1,0,0,0,0
163760,2022,Germany,Korea,0,0,0,0,3/6/2022,0,0,0,0,0,0,0,0,0,0,0,0,0,0,0,0,0,0,0,0
163760,2022,Korea,Japan,0,0,1,1,2/6/2022,0,0,0,0,0,0,0,0,0,0,0,0,0,0,0,0,0,0,0,0
147380,2022,China,Korea,0,0,0,0,3/7/2022,0,0,0,0,0,0,0,0,0,0,0,0,0,0,0,0,0,0,0,0
147380,2022,Italy,Korea,0,0,2,2,1/7/2022,0,0,0,0,0,0,3,3,0,1,0,1,2,0,4,6,1,0,0,1
147380,2022,Korea,Brazil,0,1,2,3,30/06/2022,1,1,1,3,0,2,2,4,0,2,0,2,1,2,19,22,5,0,2,7
147380,2022,Thailand,Korea,0,0,0,0,29/06/2022,0,0,0,0,0,0,0,0,0,0,0,0,0,0,0,0,0,0,0,0
147380,2022,Türkiye,Korea,0,0,1,1,19/06/2022,0,0,0,0,0,0,0,0,0,0,0,0,0,0,0,0,0,0,0,0
147380,2022,Netherlands,Korea,0,1,3,4,19/06/2022,0,0,2,2,2,0,2,4,0,0,0,0,3,1,1,5,0,0,1,1
147380,2022,Serbia,Korea,1,1,9,11,16/06/2022,0,0,2,2,16,6,13,35,0,2,1,3,9,2,15,26,7,2,1,10
147380,2022,Dominican Republic,Korea,0,0,0,0,15/06/2022,0,0,0,0,0,0,0,0,0,0,0,0,0,0,0,0,0,0,0,0
147380,2022,Korea,Canada,0,0,0,0,5/6/2022,0,0,0,0,0,0,0,0,0,0,0,0,0,0,0,0,0,0,0,0
147380,2022,Korea,Poland,0,0,0,0,4/6/2022,0,0,0,0,0,1,1,2,0,0,0,0,0,0,0,0,0,1,0,1
147380,2022,Germany,Korea,0,0,0,0,3/6/2022,0,0,0,0,0,0,0,0,0,0,0,0,0,0,0,0,0,0,0,0
147380,2022,Korea,Japan,0,0,0,0,2/6/2022,0,0,0,0,0,0,0,0,0,0,0,0,0,0,0,0,0,0,0,0
163836,2022,China,Korea,0,0,0,0,3/7/2022,0,0,0,0,0,0,0,0,0,0,0,0,0,0,0,0,0,0,0,0
163836,2022,Italy,Korea,0,0,0,0,1/7/2022,0,0,0,0,0,0,0,0,0,0,0,0,0,0,1,1,0,0,0,0
163836,2022,Korea,Brazil,0,0,0,0,30/06/2022,0,0,0,0,0,0,0,0,0,0,0,0,0,0,0,0,0,0,0,0
163836,2022,Thailand,Korea,0,0,1,1,29/06/2022,0,0,0,0,0,3,5,8,0,0,1,1,0,0,2,2,0,0,0,0
163836,2022,Türkiye,Korea,0,0,2,2,19/06/2022,0,0,0,0,0,0,0,0,0,0,0,0,1,2,4,7,0,0,0,0
163836,2022,Netherlands,Korea,0,0,0,0,19/06/2022,0,0,0,0,0,0,0,0,0,0,0,0,0,0,0,0,0,0,0,0
163836,2022,Serbia,Korea,0,0,0,0,16/06/2022,0,0,0,0,0,0,0,0,0,0,0,0,0,0,0,0,0,0,0,0
163836,2022,Dominican Republic,Korea,0,0,0,0,15/06/2022,0,0,0,0,0,0,0,0,0,0,0,0,0,0,0,0,0,0,0,0
163822,2022,China,Korea,1,1,8,10,3/7/2022,0,0,0,0,9,2,9,20,1,5,3,9,0,0,0,0,2,1,1,4
163822,2022,Italy,Korea,0,1,9,10,1/7/2022,0,0,2,2,7,3,9,19,2,6,3,11,1,1,1,3,2,1,1,4
163822,2022,Korea,Brazil,1,0,10,11,30/06/2022,0,0,0,0,4,5,8,17,0,4,0,4,0,0,0,0,2,0,1,3
163822,2022,Thailand,Korea,0,0,5,5,29/06/2022,0,0,0,0,5,3,4,12,2,4,1,7,0,0,0,0,2,0,0,2
163822,2022,Türkiye,Korea,1,0,8,9,19/06/2022,0,0,0,0,4,4,2,10,1,2,5,8,0,0,0,0,2,0,0,2
163822,2022,Netherlands,Korea,0,1,3,4,19/06/2022,0,0,0,0,2,0,2,4,1,4,2,7,0,0,0,0,1,0,0,1
163822,2022,Serbia,Korea,1,0,14,15,16/06/2022,0,0,0,0,7,0,6,13,1,7,1,9,0,0,0,0,3,0,0,3
163822,2022,Dominican Republic,Korea,0,0,0,0,15/06/2022,0,0,0,0,0,0,0,0,0,0,0,0,0,0,0,0,0,0,0,0
163822,2022,Korea,Canada,2,0,2,4,5/6/2022,0,0,1,1,1,2,1,4,0,0,1,1,0,0,1,1,0,0,0,0
163822,2022,Korea,Poland,0,0,0,0,4/6/2022,0,0,0,0,0,0,0,0,0,0,0,0,0,0,0,0,0,0,0,0
163822,2022,Germany,Korea,0,1,5,6,3/6/2022,0,0,1,1,2,1,6,9,2,1,0,3,1,0,1,2,4,0,0,4
163822,2022,Korea,Japan,0,0,4,4,2/6/2022,0,0,2,2,4,0,6,10,1,2,3,6,0,0,0,0,0,0,1,1
131893,2022,China,Korea,0,1,10,11,3/7/2022,0,0,2,2,11,10,21,42,0,3,0,3,0,0,1,1,4,0,4,8
131893,2022,Italy,Korea,0,1,15,16,1/7/2022,1,1,1,3,12,8,20,40,1,2,3,6,0,0,2,2,0,1,1,2
131893,2022,Korea,Brazil,1,2,5,8,30/06/2022,0,1,0,1,13,6,14,33,3,2,0,5,0,0,0,0,3,1,3,7
131893,2022,Thailand,Korea,0,1,4,5,29/06/2022,0,0,0,0,11,3,14,28,1,0,0,1,4,1,10,15,4,0,0,4
131893,2022,Türkiye,Korea,0,0,9,9,19/06/2022,0,0,3,3,10,7,20,37,0,3,0,3,4,1,21,26,2,4,0,6
131893,2022,Netherlands,Korea,0,2,5,7,19/06/2022,0,0,0,0,8,3,13,24,1,0,0,1,2,0,13,15,2,1,0,3
131893,2022,Serbia,Korea,0,0,0,0,16/06/2022,0,0,0,0,0,0,0,0,0,0,0,0,0,0,0,0,0,0,0,0
131893,2022,Dominican Republic,Korea,0,1,5,6,15/06/2022,0,0,1,1,3,1,17,21,0,1,0,1,3,1,8,12,1,1,1,3
131893,2022,Korea,Canada,0,1,5,6,5/6/2022,0,0,0,0,4,3,12,19,1,1,0,2,7,2,13,22,2,2,0,4
131893,2022,Korea,Poland,0,0,0,0,4/6/2022,0,0,0,0,0,1,1,2,0,0,0,0,3,0,1,4,0,1,0,1
131893,2022,Germany,Korea,0,1,6,7,3/6/2022,0,0,2,2,5,5,8,18,0,2,2,4,20,1,8,29,11,2,0,13
131893,2022,Korea,Japan,0,3,5,8,2/6/2022,0,0,2,2,6,2,15,23,1,0,0,1,14,2,12,28,6,4,0,10
163832,2022,,,-,-,-,-,-,-,-,-,-,-,-,-,-,-,-,-,-,-,-,-,-,-,-,-,-
119479,2022,China,Korea,0,0,0,0,3/7/2022,0,0,0,0,0,0,0,0,0,0,0,0,0,0,0,0,0,0,0,0
119479,2022,Italy,Korea,0,0,0,0,1/7/2022,0,0,0,0,0,0,0,0,0,0,0,0,0,0,0,0,0,0,0,0
119479,2022,Korea,Brazil,0,0,0,0,30/06/2022,0,0,0,0,0,0,0,0,0,0,0,0,0,0,0,0,0,0,0,0
119479,2022,Thailand,Korea,0,0,0,0,29/06/2022,0,0,0,0,0,0,0,0,0,0,0,0,0,0,0,0,0,0,0,0
119479,2022,Türkiye,Korea,0,0,1,1,19/06/2022,0,0,0,0,0,0,0,0,0,0,0,0,1,2,2,5,0,0,0,0
119479,2022,Netherlands,Korea,0,0,2,2,19/06/2022,0,0,0,0,0,1,4,5,0,0,0,0,3,1,7,11,0,0,0,0
119479,2022,Serbia,Korea,0,4,9,13,16/06/2022,0,0,1,1,12,7,17,36,1,2,0,3,16,0,19,35,6,2,0,8
119479,2022,Dominican Republic,Korea,0,1,4,5,15/06/2022,0,0,0,0,3,0,2,5,0,0,0,0,4,0,2,6,1,0,0,1
119479,2022,Korea,Canada,1,0,2,3,5/6/2022,0,0,0,0,2,0,1,3,0,0,0,0,4,0,3,7,3,0,1,4
119479,2022,Korea,Poland,0,0,5,5,4/6/2022,0,0,4,4,2,3,5,10,0,1,1,2,13,2,5,20,1,0,0,1
119479,2022,Germany,Korea,0,1,1,2,3/6/2022,0,0,0,0,0,0,0,0,0,0,0,0,0,0,0,0,0,0,0,0
119479,2022,Korea,Japan,0,0,2,2,2/6/2022,0,0,1,1,0,0,5,5,1,0,2,3,1,0,2,3,3,0,0,3
189224,2022,China,Korea,0,2,9,11,3/7/2022,0,0,2,2,12,6,14,32,0,2,2,4,7,0,27,34,7,2,2,11
189224,2022,Italy,Korea,0,3,8,11,1/7/2022,0,1,0,1,14,3,10,27,0,2,1,3,4,0,15,19,4,0,2,6
189224,2022,Korea,Brazil,0,0,2,2,30/06/2022,0,0,0,0,0,1,1,2,0,0,0,0,1,0,4,5,1,0,0,1
189224,2022,Thailand,Korea,0,1,2,3,29/06/2022,0,0,0,0,3,2,10,15,0,1,1,2,1,0,0,1,1,0,0,1
189224,2022,Türkiye,Korea,0,0,0,0,19/06/2022,0,0,0,0,0,0,0,0,0,0,0,0,0,0,0,0,0,0,0,0
189224,2022,Netherlands,Korea,0,0,0,0,19/06/2022,0,0,0,0,0,0,0,0,0,0,0,0,0,0,0,0,0,0,0,0
189224,2022,Serbia,Korea,0,0,0,0,16/06/2022,0,0,0,0,0,0,0,0,0,0,0,0,0,0,0,0,0,0,0,0
189224,2022,Dominican Republic,Korea,0,0,0,0,15/06/2022,0,0,0,0,0,0,0,0,0,0,0,0,0,0,0,0,0,0,0,0
189224,2022,Korea,Canada,0,0,1,1,5/6/2022,0,0,0,0,2,4,6,12,0,0,0,0,2,0,1,3,0,0,0,0
189224,2022,Korea,Poland,0,1,7,8,4/6/2022,0,0,0,0,4,7,6,17,1,0,0,1,9,0,7,16,6,2,0,8
189224,2022,Germany,Korea,0,0,1,1,3/6/2022,0,0,0,0,1,0,1,2,0,1,0,1,6,1,4,11,1,0,0,1
189224,2022,Korea,Japan,0,0,0,0,2/6/2022,0,0,0,0,0,0,0,0,0,0,0,0,0,0,0,0,0,0,0,0
175165,2022,China,Korea,0,0,0,0,3/7/2022,0,0,0,0,0,0,0,0,0,0,0,0,0,0,0,0,0,0,0,0
175165,2022,Italy,Korea,0,0,0,0,1/7/2022,0,0,0,0,0,0,0,0,0,0,0,0,0,1,0,1,0,0,0,0
175165,2022,Korea,Brazil,0,0,0,0,30/06/2022,0,0,0,0,0,0,0,0,0,0,0,0,0,0,0,0,0,0,0,0
175165,2022,Thailand,Korea,0,0,0,0,29/06/2022,0,0,0,0,0,0,0,0,0,0,0,0,0,0,0,0,0,0,0,0
175165,2022,Korea,Canada,0,0,0,0,5/6/2022,2,0,21,23,0,0,1,1,0,0,1,1,0,0,0,0,1,0,1,2
175165,2022,Korea,Poland,0,0,0,0,4/6/2022,0,1,16,17,0,0,0,0,0,0,0,0,0,0,0,0,0,0,0,0
175165,2022,Germany,Korea,0,0,0,0,3/6/2022,1,1,14,16,0,0,0,0,0,0,0,0,0,0,0,0,0,0,0,0
175165,2022,Korea,Japan,0,0,0,0,2/6/2022,0,1,8,9,0,0,0,0,0,0,0,0,0,0,0,0,0,0,0,0
175176,2022,China,Korea,0,0,0,0,3/7/2022,0,0,0,0,0,0,0,0,0,0,0,0,0,0,0,0,0,0,0,0
175176,2022,Italy,Korea,0,0,0,0,1/7/2022,0,0,0,0,0,0,0,0,0,0,0,0,0,0,0,0,0,0,0,0
175176,2022,Korea,Brazil,0,0,0,0,30/06/2022,0,0,0,0,0,0,0,0,0,0,0,0,0,0,0,0,0,0,0,0
175176,2022,Thailand,Korea,0,0,0,0,29/06/2022,0,0,0,0,0,0,0,0,0,0,0,0,0,0,0,0,0,0,0,0
175176,2022,Türkiye,Korea,0,0,0,0,19/06/2022,0,0,0,0,0,0,0,0,0,0,0,0,0,0,0,0,0,0,0,0
175176,2022,Netherlands,Korea,0,0,0,0,19/06/2022,0,0,0,0,0,0,0,0,0,0,0,0,0,0,0,0,0,0,0,0
175176,2022,Serbia,Korea,0,0,0,0,16/06/2022,0,0,0,0,0,0,0,0,0,0,0,0,0,0,0,0,0,0,0,0
119484,2022,China,Korea,0,0,0,0,3/7/2022,0,0,0,0,0,0,0,0,0,0,0,0,0,0,0,0,0,0,0,0
119484,2022,Italy,Korea,0,0,0,0,1/7/2022,0,0,0,0,0,0,0,0,0,0,0,0,0,0,0,0,0,0,0,0
119484,2022,Korea,Brazil,0,0,0,0,30/06/2022,0,0,0,0,0,0,0,0,0,0,0,0,0,0,0,0,0,0,0,0
119484,2022,Thailand,Korea,0,1,3,4,29/06/2022,0,0,0,0,3,5,8,16,0,3,1,4,0,0,0,0,0,0,0,0
119484,2022,Türkiye,Korea,0,1,8,9,19/06/2022,0,0,1,1,10,6,13,29,1,4,3,8,0,0,0,0,4,3,1,8
119484,2022,Netherlands,Korea,0,1,6,7,19/06/2022,0,0,0,0,10,1,14,25,2,1,1,4,0,0,0,0,3,0,1,4
119484,2022,Serbia,Korea,0,0,0,0,16/06/2022,0,0,0,0,0,0,0,0,0,0,0,0,0,0,0,0,0,0,0,0
119484,2022,Dominican Republic,Korea,0,5,4,9,15/06/2022,0,0,0,0,8,8,16,32,0,1,2,3,0,0,0,0,3,0,0,3
119484,2022,Korea,Canada,0,1,4,5,5/6/2022,0,0,0,0,4,2,5,11,1,1,1,3,0,0,0,0,5,1,1,7
119484,2022,Korea,Poland,1,2,5,8,4/6/2022,0,0,0,0,9,4,17,30,0,2,0,2,0,0,1,1,5,0,1,6
119484,2022,Germany,Korea,0,0,0,0,3/6/2022,0,0,0,0,1,0,4,5,0,1,2,3,0,1,0,1,0,0,0,0
119484,2022,Korea,Japan,0,1,3,4,2/6/2022,0,0,1,1,3,5,9,17,1,2,1,4,0,0,0,0,2,1,0,3
151985,2022,,,-,-,-,-,-,-,-,-,-,-,-,-,-,-,-,-,-,-,-,-,-,-,-,-,-
168183,2022,,,-,-,-,-,-,-,-,-,-,-,-,-,-,-,-,-,-,-,-,-,-,-,-,-,-
151959,2022,China,Korea,0,0,0,0,3/7/2022,0,0,0,0,0,0,0,0,0,0,0,0,0,0,0,0,0,0,0,0
151959,2022,Italy,Korea,0,1,6,7,1/7/2022,2,1,29,32,0,0,1,1,0,0,0,0,0,0,0,0,0,0,0,0
151959,2022,Korea,Brazil,0,0,3,3,30/06/2022,22,0,0,22,0,0,0,0,0,0,0,0,0,0,0,0,0,0,0,0
151959,2022,Thailand,Korea,0,0,3,3,29/06/2022,47,1,0,48,0,0,0,0,0,0,0,0,0,0,0,0,1,0,0,1
168185,2022,,,-,-,-,-,-,-,-,-,-,-,-,-,-,-,-,-,-,-,-,-,-,-,-,-,-
168182,2022,,,-,-,-,-,-,-,-,-,-,-,-,-,-,-,-,-,-,-,-,-,-,-,-,-,-
153111,2022,,,-,-,-,-,-,-,-,-,-,-,-,-,-,-,-,-,-,-,-,-,-,-,-,-,-
124071,2022,,,-,-,-,-,-,-,-,-,-,-,-,-,-,-,-,-,-,-,-,-,-,-,-,-,-
150828,2022,Netherlands,Canada,3,2,15,20,3/7/2022,0,0,5,5,14,5,18,37,1,3,0,4,12,0,9,21,8,3,0,11
150828,2022,Belgium,Netherlands,0,0,15,15,1/7/2022,0,0,4,4,15,4,20,39,3,2,0,5,13,1,19,33,15,0,0,15
150828,2022,Türkiye,Netherlands,0,0,0,0,30/06/2022,0,0,0,0,0,0,0,0,0,0,0,0,0,0,0,0,0,0,0,0
150828,2022,Japan,Netherlands,0,2,21,23,29/06/2022,0,0,2,2,17,3,20,40,3,2,1,6,6,1,9,16,8,3,0,11
150828,2022,Netherlands,Korea,0,3,7,10,19/06/2022,0,0,1,1,4,1,5,10,1,0,1,2,2,1,8,11,7,1,1,9
150828,2022,Netherlands,Dominican Republic,0,1,5,6,18/06/2022,0,0,2,2,12,5,13,30,1,0,0,1,10,0,11,21,3,2,1,6
150828,2022,Netherlands,Brazil,0,0,0,0,17/06/2022,0,0,0,0,0,1,2,3,0,1,0,1,0,0,0,0,0,0,0,0
150828,2022,Netherlands,Germany,2,2,5,9,14/06/2022,0,0,0,0,8,0,8,16,3,0,2,5,1,1,9,11,4,0,0,4
150828,2022,Serbia,Netherlands,0,0,9,9,5/6/2022,0,0,3,3,5,4,8,17,0,1,1,2,6,3,20,29,2,2,4,8
150828,2022,Netherlands,Italy,0,0,4,4,3/6/2022,0,0,0,0,3,5,10,18,1,0,1,2,1,0,10,11,1,1,0,2
150828,2022,Bulgaria,Netherlands,1,0,8,9,2/6/2022,0,0,0,0,10,4,22,36,3,3,1,7,15,2,29,46,10,5,7,22
150828,2022,China,Netherlands,0,0,17,17,1/6/2022,0,0,1,1,14,7,13,34,0,1,3,4,15,1,36,52,7,5,3,15
189046,2022,,,-,-,-,-,-,-,-,-,-,-,-,-,-,-,-,-,-,-,-,-,-,-,-,-,-
142880,2022,Netherlands,Canada,1,0,9,10,3/7/2022,0,0,3,3,16,7,19,42,2,2,1,5,0,0,0,0,13,1,0,14
142880,2022,Belgium,Netherlands,0,1,3,4,1/7/2022,0,0,1,1,2,3,5,10,0,2,0,2,0,0,1,1,2,0,0,2
142880,2022,Türkiye,Netherlands,0,1,7,8,30/06/2022,0,0,1,1,7,3,13,23,3,2,1,6,0,0,0,0,1,1,1,3
142880,2022,Japan,Netherlands,0,0,17,17,29/06/2022,0,0,1,1,16,4,19,39,0,0,1,1,2,0,0,2,9,1,1,11
142880,2022,Netherlands,Korea,0,0,12,12,19/06/2022,0,0,0,0,14,2,7,23,1,2,3,6,0,0,2,2,5,2,0,7
142880,2022,Netherlands,Dominican Republic,0,0,3,3,18/06/2022,0,0,0,0,10,2,8,20,0,1,0,1,0,0,0,0,3,1,1,5
142880,2022,Netherlands,Brazil,0,0,0,0,17/06/2022,0,0,0,0,0,0,0,0,0,0,0,0,0,0,0,0,0,0,0,0
142880,2022,Netherlands,Germany,0,0,1,1,14/06/2022,0,0,0,0,0,2,1,3,0,0,0,0,1,0,0,1,2,0,0,2
142880,2022,Serbia,Netherlands,0,3,9,12,5/6/2022,0,0,0,0,17,2,17,36,2,3,0,5,3,1,24,28,8,0,1,9
142880,2022,Netherlands,Italy,1,0,4,5,3/6/2022,0,0,0,0,4,2,3,9,0,0,0,0,0,0,0,0,1,0,1,2
142880,2022,Bulgaria,Netherlands,0,0,3,3,2/6/2022,0,0,0,0,3,3,6,12,0,2,0,2,0,0,1,1,1,0,0,1
142880,2022,China,Netherlands,0,1,8,9,1/6/2022,0,2,2,4,22,5,17,44,2,1,7,10,0,0,0,0,3,6,4,13
167482,2022,Netherlands,Canada,0,0,0,0,3/7/2022,0,0,0,0,0,0,0,0,0,0,0,0,0,0,0,0,0,0,0,0
167482,2022,Belgium,Netherlands,0,0,0,0,1/7/2022,0,0,0,0,0,0,0,0,0,0,0,0,0,0,0,0,0,0,0,0
167482,2022,Türkiye,Netherlands,0,0,0,0,30/06/2022,0,0,0,0,0,1,1,2,0,0,0,0,2,0,1,3,0,0,0,0
167482,2022,Japan,Netherlands,0,0,0,0,29/06/2022,0,0,0,0,0,0,0,0,0,0,0,0,0,0,0,0,0,0,0,0
167482,2022,Netherlands,Korea,0,0,0,0,19/06/2022,0,0,0,0,0,0,0,0,0,0,0,0,0,0,0,0,0,0,0,0
167482,2022,Netherlands,Dominican Republic,0,0,6,6,18/06/2022,0,0,0,0,6,3,8,17,0,3,1,4,1,0,8,9,3,0,0,3
167482,2022,Netherlands,Brazil,1,0,3,4,17/06/2022,0,0,0,0,9,3,12,24,2,0,0,2,7,1,9,17,4,0,1,5
167482,2022,Netherlands,Germany,0,0,0,0,14/06/2022,0,0,0,0,0,0,0,0,0,0,0,0,0,0,0,0,0,0,0,0
167482,2022,Serbia,Netherlands,0,0,0,0,5/6/2022,0,0,0,0,0,2,0,2,0,0,0,0,0,0,0,0,0,0,0,0
167482,2022,Netherlands,Italy,0,0,4,4,3/6/2022,0,0,0,0,3,3,6,12,1,2,1,4,2,1,20,23,3,5,1,9
167482,2022,Bulgaria,Netherlands,0,0,1,1,2/6/2022,0,0,0,0,3,0,3,6,0,0,1,1,1,2,1,4,0,2,0,2
167482,2022,China,Netherlands,0,0,0,0,1/6/2022,0,0,0,0,0,0,1,1,0,0,0,0,0,0,1,1,0,0,0,0
151194,2022,Netherlands,Canada,1,2,8,11,3/7/2022,0,0,2,2,4,2,10,16,1,5,3,9,0,0,0,0,2,0,0,2
151194,2022,Belgium,Netherlands,3,0,13,16,1/7/2022,0,0,2,2,14,1,5,20,2,3,3,8,0,0,0,0,4,0,0,4
151194,2022,Türkiye,Netherlands,0,0,5,5,30/06/2022,0,0,0,0,5,0,2,7,0,0,1,1,0,0,0,0,0,1,0,1
151194,2022,Japan,Netherlands,3,2,13,18,29/06/2022,0,0,2,2,9,0,7,16,4,4,4,12,1,0,0,1,1,0,0,1
151194,2022,Netherlands,Korea,1,0,12,13,19/06/2022,0,0,1,1,7,1,5,13,2,1,1,4,0,0,0,0,6,0,0,6
151194,2022,Netherlands,Dominican Republic,0,1,18,19,18/06/2022,0,0,1,1,5,0,10,15,0,5,2,7,1,0,0,1,6,0,0,6
151194,2022,Netherlands,Brazil,0,2,4,6,17/06/2022,0,0,0,0,3,1,4,8,3,5,3,11,0,0,0,0,0,0,0,0
151194,2022,Netherlands,Germany,1,2,9,12,14/06/2022,0,0,0,0,3,1,5,9,4,6,3,13,0,0,0,0,2,0,0,2
151194,2022,Serbia,Netherlands,0,0,12,12,5/6/2022,1,0,1,2,8,0,5,13,3,10,15,28,0,0,3,3,2,1,2,5
151194,2022,Netherlands,Italy,1,1,5,7,3/6/2022,1,0,0,1,3,1,7,11,0,6,3,9,0,0,0,0,0,1,0,1
151194,2022,Bulgaria,Netherlands,0,0,13,13,2/6/2022,0,0,6,6,5,1,6,12,3,3,10,16,0,0,0,0,3,2,1,6
151194,2022,China,Netherlands,0,0,12,12,1/6/2022,0,0,2,2,9,1,3,13,3,2,5,10,1,0,1,2,0,0,0,0
167777,2022,Netherlands,Canada,0,0,0,0,3/7/2022,0,0,0,0,0,0,0,0,0,0,0,0,0,0,0,0,0,0,0,0
167777,2022,Belgium,Netherlands,0,0,0,0,1/7/2022,0,0,0,0,0,0,0,0,0,0,0,0,0,0,0,0,0,0,0,0
167777,2022,Türkiye,Netherlands,0,0,0,0,30/06/2022,0,0,0,0,0,0,0,0,0,0,0,0,0,0,0,0,0,0,0,0
167777,2022,Japan,Netherlands,0,0,0,0,29/06/2022,0,0,0,0,0,0,0,0,0,0,0,0,0,0,0,0,0,0,0,0
123468,2022,Netherlands,Canada,0,0,0,0,3/7/2022,0,1,13,14,0,0,0,0,0,0,0,0,11,0,6,17,22,2,1,25
123468,2022,Belgium,Netherlands,0,0,0,0,1/7/2022,0,1,8,9,0,0,0,0,0,0,0,0,8,0,9,17,23,3,0,26
123468,2022,Türkiye,Netherlands,0,0,0,0,30/06/2022,0,0,10,10,0,0,0,0,0,0,0,0,9,1,4,14,8,3,0,11
123468,2022,Japan,Netherlands,0,0,0,0,29/06/2022,0,0,6,6,0,0,0,0,0,0,0,0,10,1,6,17,18,3,0,21
123468,2022,Netherlands,Korea,0,0,0,0,19/06/2022,0,0,2,2,0,0,0,0,0,0,0,0,9,1,8,18,10,3,0,13
123468,2022,Netherlands,Dominican Republic,0,0,0,0,18/06/2022,0,0,7,7,0,0,0,0,0,0,0,0,13,2,10,25,11,3,2,16
123468,2022,Netherlands,Brazil,0,0,0,0,17/06/2022,0,0,9,9,0,0,0,0,0,0,0,0,5,0,3,8,8,2,2,12
123468,2022,Netherlands,Germany,0,0,0,0,14/06/2022,0,0,0,0,0,0,0,0,0,0,0,0,7,0,9,16,8,6,1,15
123468,2022,Serbia,Netherlands,0,0,0,0,5/6/2022,1,0,10,11,0,0,0,0,0,0,0,0,0,0,15,15,20,3,5,28
123468,2022,Netherlands,Italy,0,0,0,0,3/6/2022,1,0,3,4,0,0,0,0,0,0,0,0,5,1,14,20,10,7,3,20
123468,2022,Bulgaria,Netherlands,0,0,0,0,2/6/2022,0,0,13,13,0,0,0,0,0,0,0,0,5,0,12,17,14,5,7,26
123468,2022,China,Netherlands,0,0,0,0,1/6/2022,0,0,5,5,0,0,0,0,0,0,0,0,3,1,8,12,9,15,14,38
162356,2022,Serbia,Netherlands,0,0,0,0,5/6/2022,0,0,0,0,0,0,0,0,0,0,0,0,0,0,0,0,0,0,0,0
162356,2022,Netherlands,Italy,0,0,0,0,3/6/2022,0,0,9,9,0,0,0,0,0,0,0,0,0,0,0,0,1,0,0,1
162356,2022,Bulgaria,Netherlands,0,0,2,2,2/6/2022,3,0,13,16,0,0,0,0,0,0,2,2,0,0,0,0,4,1,1,6
162356,2022,China,Netherlands,0,0,1,1,1/6/2022,0,0,8,8,0,0,0,0,0,0,0,0,0,0,0,0,1,0,0,1
120503,2022,Netherlands,Canada,1,0,18,19,3/7/2022,0,0,6,6,12,5,21,38,1,2,1,4,21,2,20,43,18,4,1,23
120503,2022,Belgium,Netherlands,0,0,14,14,1/7/2022,0,0,3,3,11,4,23,38,0,3,4,7,13,0,9,22,11,1,0,12
120503,2022,Türkiye,Netherlands,0,1,10,11,30/06/2022,0,0,0,0,7,2,16,25,0,0,0,0,14,3,22,39,4,1,0,5
120503,2022,Japan,Netherlands,0,1,16,17,29/06/2022,0,0,1,1,19,4,21,44,3,2,3,8,33,2,18,53,10,3,0,13
120503,2022,Netherlands,Korea,0,0,12,12,19/06/2022,0,0,1,1,15,1,10,26,0,1,3,4,4,0,2,6,7,2,0,9
120503,2022,Netherlands,Dominican Republic,0,1,13,14,18/06/2022,0,0,0,0,19,5,23,47,0,2,3,5,17,0,13,30,8,0,2,10
120503,2022,Netherlands,Brazil,0,1,6,7,17/06/2022,0,0,0,0,7,5,23,35,0,1,1,2,15,1,17,33,1,7,2,10
120503,2022,Netherlands,Germany,0,0,14,14,14/06/2022,0,0,0,0,18,3,17,38,1,3,2,6,12,0,16,28,6,5,1,12
147432,2022,Netherlands,Canada,1,0,17,18,3/7/2022,3,1,134,138,1,0,2,3,0,1,1,2,0,0,0,0,11,4,0,15
147432,2022,Belgium,Netherlands,0,0,16,16,1/7/2022,8,1,119,128,2,0,2,4,0,5,1,6,0,0,0,0,15,0,0,15
147432,2022,Türkiye,Netherlands,0,1,8,9,30/06/2022,4,0,77,81,0,0,1,1,0,0,0,0,0,0,0,0,2,1,0,3
147432,2022,Japan,Netherlands,0,1,9,10,29/06/2022,24,0,114,138,2,0,1,3,1,3,0,4,0,0,0,0,1,1,0,2
147432,2022,Netherlands,Korea,1,2,11,14,19/06/2022,23,1,53,77,0,0,0,0,0,1,3,4,0,1,0,1,5,0,1,6
147432,2022,Netherlands,Dominican Republic,0,1,14,15,18/06/2022,44,1,100,145,1,2,2,5,0,2,3,5,0,0,0,0,8,3,2,13
147432,2022,Netherlands,Brazil,1,0,7,8,17/06/2022,11,1,37,49,1,1,0,2,0,1,1,2,0,0,0,0,1,2,1,4
147432,2022,Netherlands,Germany,0,0,12,12,14/06/2022,27,0,82,109,0,0,1,1,0,3,3,6,0,0,0,0,4,5,0,9
147432,2022,Serbia,Netherlands,2,0,15,17,5/6/2022,64,1,71,136,0,0,4,4,1,1,6,8,0,1,0,1,9,5,4,18
147432,2022,Netherlands,Italy,0,0,5,5,3/6/2022,22,0,45,67,0,0,2,2,1,4,5,10,0,0,0,0,4,2,3,9
147432,2022,Bulgaria,Netherlands,0,1,19,20,2/6/2022,17,1,81,99,1,0,2,3,0,4,9,13,0,0,0,0,6,6,7,19
147432,2022,China,Netherlands,0,1,12,13,1/6/2022,15,0,96,111,2,1,3,6,1,3,6,10,0,0,0,0,5,3,3,11
176465,2022,,,-,-,-,-,-,-,-,-,-,-,-,-,-,-,-,-,-,-,-,-,-,-,-,-,-
124070,2022,Netherlands,Canada,0,0,0,0,3/7/2022,0,0,1,1,0,0,0,0,0,0,0,0,0,0,0,0,0,0,0,0
124070,2022,Belgium,Netherlands,0,0,3,3,1/7/2022,0,0,3,3,0,0,0,0,0,0,0,0,0,0,0,0,1,0,0,1
124070,2022,Türkiye,Netherlands,0,0,0,0,30/06/2022,0,1,12,13,0,0,0,0,0,1,0,1,0,0,0,0,4,1,0,5
124070,2022,Japan,Netherlands,0,0,6,6,29/06/2022,1,0,12,13,0,0,0,0,0,0,0,0,0,0,0,0,0,0,0,0
124070,2022,Netherlands,Korea,0,0,0,0,19/06/2022,0,0,0,0,0,0,0,0,0,0,0,0,0,0,0,0,0,0,0,0
124070,2022,Netherlands,Dominican Republic,0,0,0,0,18/06/2022,5,0,9,14,0,0,0,0,0,0,0,0,0,0,0,0,2,0,0,2
124070,2022,Netherlands,Brazil,0,1,6,7,17/06/2022,14,1,30,45,0,0,0,0,0,0,0,0,0,0,0,0,2,2,1,5
124070,2022,Netherlands,Germany,0,0,1,1,14/06/2022,1,0,7,8,0,0,0,0,0,0,0,0,0,0,0,0,0,0,0,0
168148,2022,Netherlands,Canada,0,0,0,0,3/7/2022,0,0,0,0,0,0,0,0,0,0,0,0,0,0,0,0,0,0,0,0
168148,2022,Belgium,Netherlands,0,0,0,0,1/7/2022,0,0,0,0,0,0,0,0,0,0,0,0,0,0,0,0,0,0,0,0
168148,2022,Türkiye,Netherlands,0,2,2,4,30/06/2022,0,0,0,0,2,2,4,8,1,0,0,1,0,0,0,0,1,0,0,1
168148,2022,Japan,Netherlands,0,0,0,0,29/06/2022,0,0,0,0,0,0,0,0,0,0,0,0,0,0,0,0,0,0,0,0
168148,2022,Netherlands,Korea,0,0,0,0,19/06/2022,0,0,0,0,0,0,0,0,0,0,0,0,0,0,0,0,0,0,0,0
168148,2022,Netherlands,Dominican Republic,0,0,0,0,18/06/2022,0,0,0,0,0,0,0,0,0,0,0,0,0,0,0,0,0,0,0,0
168148,2022,Netherlands,Brazil,0,0,0,0,17/06/2022,0,0,0,0,0,0,0,0,0,0,0,0,0,0,0,0,0,0,0,0
168148,2022,Netherlands,Germany,0,0,0,0,14/06/2022,0,0,0,0,0,0,0,0,0,0,0,0,0,0,0,0,0,0,0,0
168148,2022,Serbia,Netherlands,0,0,0,0,5/6/2022,0,0,0,0,1,0,0,1,0,0,0,0,0,0,0,0,0,0,0,0
168148,2022,Netherlands,Italy,0,0,0,0,3/6/2022,0,0,0,0,0,0,0,0,0,0,0,0,0,0,0,0,0,0,0,0
168148,2022,Bulgaria,Netherlands,0,0,0,0,2/6/2022,0,0,0,0,0,0,0,0,0,0,0,0,0,0,0,0,0,0,0,0
168148,2022,China,Netherlands,0,0,0,0,1/6/2022,0,0,0,0,0,0,0,0,0,0,0,0,0,0,0,0,0,0,0,0
181648,2022,Serbia,Netherlands,0,0,0,0,5/6/2022,0,0,0,0,0,0,0,0,0,0,0,0,0,0,0,0,0,0,0,0
181648,2022,Netherlands,Italy,0,0,0,0,3/6/2022,0,0,0,0,0,0,0,0,0,0,0,0,0,0,0,0,0,0,0,0
181648,2022,Bulgaria,Netherlands,0,0,0,0,2/6/2022,0,0,0,0,0,0,0,0,0,0,0,0,0,0,0,0,0,0,0,0
181648,2022,China,Netherlands,0,0,0,0,1/6/2022,0,0,0,0,0,0,0,0,0,0,0,0,0,0,0,0,0,0,0,0
159904,2022,Netherlands,Canada,0,0,0,0,3/7/2022,0,0,1,1,0,0,0,0,0,0,0,0,1,0,2,3,4,0,0,4
159904,2022,Belgium,Netherlands,0,1,1,2,1/7/2022,0,0,0,0,2,2,4,8,2,0,0,2,5,0,1,6,1,2,0,3
159904,2022,Türkiye,Netherlands,0,0,10,10,30/06/2022,0,0,0,0,5,3,13,21,1,4,0,5,5,0,5,10,2,1,0,3
159904,2022,Japan,Netherlands,0,0,0,0,29/06/2022,0,0,0,0,0,0,0,0,0,0,0,0,1,0,2,3,1,1,0,2
159904,2022,Netherlands,Korea,0,0,1,1,19/06/2022,0,0,0,0,0,0,0,0,0,0,0,0,0,0,0,0,0,0,0,0
159904,2022,Netherlands,Dominican Republic,0,0,2,2,18/06/2022,0,0,0,0,0,0,0,0,0,0,0,0,0,1,2,3,0,0,0,0
159904,2022,Netherlands,Brazil,0,0,6,6,17/06/2022,0,0,0,0,0,0,0,0,0,0,0,0,2,0,4,6,4,0,0,4
159904,2022,Netherlands,Germany,1,1,6,8,14/06/2022,0,0,0,0,1,3,5,9,0,0,1,1,5,0,10,15,1,2,1,4
159904,2022,Serbia,Netherlands,0,1,19,20,5/6/2022,0,0,3,3,6,7,17,30,1,2,2,5,7,0,12,19,11,4,3,18
159904,2022,Netherlands,Italy,0,1,7,8,3/6/2022,0,0,0,0,2,2,4,8,0,0,0,0,3,1,6,10,3,0,0,3
159904,2022,Bulgaria,Netherlands,0,0,12,12,2/6/2022,0,0,5,5,10,5,12,27,0,1,0,1,4,2,12,18,15,9,3,27
159904,2022,China,Netherlands,1,0,19,20,1/6/2022,0,0,2,2,11,1,9,21,0,2,5,7,4,1,14,19,11,5,9,25
150809,2022,Netherlands,Korea,0,0,0,0,19/06/2022,0,0,0,0,0,0,0,0,0,0,0,0,0,0,0,0,0,0,0,0
150809,2022,Netherlands,Dominican Republic,0,0,0,0,18/06/2022,0,0,0,0,0,0,0,0,0,0,0,0,0,0,0,0,0,0,0,0
150809,2022,Netherlands,Brazil,0,0,0,0,17/06/2022,0,0,0,0,0,0,0,0,0,0,0,0,0,0,0,0,0,0,0,0
150809,2022,Netherlands,Germany,0,0,0,0,14/06/2022,0,0,0,0,0,0,0,0,0,0,0,0,0,0,0,0,0,0,0,0
150808,2022,,,-,-,-,-,-,-,-,-,-,-,-,-,-,-,-,-,-,-,-,-,-,-,-,-,-
181647,2022,,,-,-,-,-,-,-,-,-,-,-,-,-,-,-,-,-,-,-,-,-,-,-,-,-,-
172894,2022,Netherlands,Canada,0,1,17,18,3/7/2022,0,0,2,2,5,1,6,12,6,6,1,13,0,0,0,0,3,2,0,5
172894,2022,Belgium,Netherlands,1,2,15,18,1/7/2022,0,0,2,2,5,2,6,13,4,7,8,19,0,0,0,0,5,1,0,6
172894,2022,Türkiye,Netherlands,0,1,6,7,30/06/2022,0,1,0,1,5,1,4,10,3,5,1,9,1,0,1,2,2,0,0,2
172894,2022,Japan,Netherlands,1,2,17,20,29/06/2022,0,0,1,1,12,1,7,20,3,4,1,8,1,1,1,3,1,1,0,2
172894,2022,Netherlands,Korea,0,2,9,11,19/06/2022,0,0,2,2,7,0,3,10,2,6,3,11,2,0,0,2,1,0,0,1
172894,2022,Netherlands,Dominican Republic,1,0,18,19,18/06/2022,0,0,1,1,6,1,9,16,5,5,6,16,3,0,0,3,8,1,1,10
172894,2022,Netherlands,Brazil,1,2,8,11,17/06/2022,0,0,1,1,5,1,3,9,1,3,1,5,0,0,0,0,1,0,0,1
172894,2022,Netherlands,Germany,0,2,13,15,14/06/2022,0,0,0,0,6,1,6,13,1,10,6,17,0,0,1,1,2,1,0,3
172894,2022,Serbia,Netherlands,2,1,14,17,5/6/2022,0,0,3,3,11,3,8,22,5,12,17,34,0,0,1,1,4,1,1,6
172894,2022,Netherlands,Italy,0,2,7,9,3/6/2022,0,0,1,1,2,1,4,7,0,3,0,3,1,0,0,1,1,0,1,2
172894,2022,Bulgaria,Netherlands,1,0,11,12,2/6/2022,0,0,2,2,8,0,4,12,3,9,7,19,0,0,0,0,3,4,1,8
172894,2022,China,Netherlands,0,0,19,19,1/6/2022,0,0,1,1,6,1,6,13,3,9,6,18,0,0,0,0,4,5,4,13
162357,2022,Serbia,Netherlands,0,0,0,0,5/6/2022,0,0,0,0,0,0,0,0,0,0,0,0,0,0,0,0,0,0,0,0
162357,2022,Netherlands,Italy,0,0,0,0,3/6/2022,0,0,0,0,0,0,0,0,0,0,0,0,0,0,0,0,0,0,0,0
162357,2022,Bulgaria,Netherlands,0,0,0,0,2/6/2022,0,0,0,0,0,0,0,0,0,0,0,0,0,0,0,0,0,0,0,0
162357,2022,China,Netherlands,0,0,0,0,1/6/2022,0,0,0,0,0,0,0,0,0,0,0,0,0,0,0,0,0,0,0,0
148581,2022,Netherlands,Canada,0,0,0,0,3/7/2022,0,0,0,0,0,0,0,0,0,0,0,0,0,0,0,0,0,0,0,0
148581,2022,Belgium,Netherlands,0,0,0,0,1/7/2022,0,0,0,0,0,0,0,0,0,0,0,0,0,0,0,0,0,0,0,0
148581,2022,Türkiye,Netherlands,0,0,0,0,30/06/2022,0,0,0,0,0,0,0,0,0,0,0,0,0,0,0,0,0,0,0,0
148581,2022,Japan,Netherlands,0,0,0,0,29/06/2022,0,0,0,0,0,0,0,0,0,0,0,0,0,0,0,0,0,0,0,0
148581,2022,Netherlands,Korea,0,0,0,0,19/06/2022,0,0,0,0,0,0,0,0,0,0,0,0,0,0,0,0,0,0,0,0
148581,2022,Netherlands,Dominican Republic,0,0,0,0,18/06/2022,0,0,0,0,0,0,0,0,0,0,0,0,0,0,0,0,0,0,0,0
148581,2022,Netherlands,Brazil,0,0,0,0,17/06/2022,0,0,1,1,0,0,0,0,0,0,0,0,0,0,1,1,1,2,1,4
148581,2022,Netherlands,Germany,0,0,0,0,14/06/2022,0,0,0,0,1,0,0,1,0,0,0,0,0,0,0,0,0,0,0,0
148581,2022,Serbia,Netherlands,0,0,0,0,5/6/2022,0,0,0,0,0,0,0,0,0,0,0,0,0,0,0,0,0,0,0,0
148581,2022,Netherlands,Italy,0,0,0,0,3/6/2022,0,0,0,0,0,0,0,0,0,0,0,0,0,0,0,0,0,0,0,0
148581,2022,Bulgaria,Netherlands,0,0,0,0,2/6/2022,0,0,0,0,0,0,1,1,0,0,0,0,0,0,0,0,1,0,1,2
148581,2022,China,Netherlands,0,0,0,0,1/6/2022,0,0,0,0,0,0,1,1,0,0,0,0,0,0,0,0,0,0,0,0
181248,2022,Netherlands,Canada,0,1,2,3,3/7/2022,0,1,0,1,2,1,4,7,0,1,0,1,0,0,0,0,1,0,0,1
181248,2022,Belgium,Netherlands,1,2,5,8,1/7/2022,0,0,5,5,8,3,9,20,3,2,2,7,0,0,0,0,7,1,0,8
181248,2022,Türkiye,Netherlands,0,1,1,2,30/06/2022,0,0,0,0,0,0,4,4,0,0,0,0,0,0,0,0,0,0,0,0
181248,2022,Japan,Netherlands,0,0,0,0,29/06/2022,0,0,1,1,0,0,1,1,2,0,2,4,0,0,0,0,0,0,0,0
181248,2022,Netherlands,Korea,0,0,0,0,19/06/2022,0,0,0,0,0,0,0,0,0,0,0,0,0,0,0,0,0,0,0,0
181248,2022,Netherlands,Dominican Republic,1,5,9,15,18/06/2022,0,0,1,1,8,2,19,29,0,3,3,6,0,0,1,1,6,3,2,11
181248,2022,Netherlands,Brazil,0,2,5,7,17/06/2022,0,0,0,0,1,9,9,19,1,3,0,4,0,0,1,1,4,0,0,4
181248,2022,Netherlands,Germany,1,3,11,15,14/06/2022,0,0,0,0,14,3,19,36,0,1,1,2,0,0,0,0,1,2,1,4
181248,2022,Serbia,Netherlands,1,3,13,17,5/6/2022,2,0,1,3,17,6,13,36,1,5,3,9,0,0,0,0,14,2,2,18
181248,2022,Netherlands,Italy,0,0,9,9,3/6/2022,0,0,1,1,11,4,5,20,0,0,1,1,0,0,0,0,4,3,2,9
181248,2022,Bulgaria,Netherlands,0,4,10,14,2/6/2022,0,0,2,2,13,5,16,34,1,1,4,6,0,0,0,0,7,3,3,13
181248,2022,China,Netherlands,0,0,2,2,1/6/2022,0,0,0,0,5,0,3,8,0,0,0,0,0,0,0,0,0,1,1,2
162372,2022,,,-,-,-,-,-,-,-,-,-,-,-,-,-,-,-,-,-,-,-,-,-,-,-,-,-
181249,2022,,,-,-,-,-,-,-,-,-,-,-,-,-,-,-,-,-,-,-,-,-,-,-,-,-,-
152233,2022,Poland,Bulgaria,0,0,0,0,3/7/2022,0,1,2,3,0,0,0,0,0,0,0,0,8,0,16,24,6,2,2,10
152233,2022,Dominican Republic,Poland,0,0,0,0,2/7/2022,0,0,4,4,0,0,0,0,0,0,0,0,18,2,29,49,16,4,4,24
152233,2022,Poland,China,0,0,0,0,30/06/2022,0,0,7,7,0,0,0,0,0,0,0,0,9,2,16,27,8,1,4,13
152233,2022,Italy,Poland,0,0,0,0,29/06/2022,7,0,0,7,0,0,0,0,0,0,0,0,5,0,20,25,17,3,1,21
152233,2022,Belgium,Poland,0,0,0,0,18/06/2022,0,0,12,12,0,0,0,0,0,0,0,0,6,1,21,28,27,4,2,33
152233,2022,Poland,USA,0,0,0,0,17/06/2022,0,0,10,10,0,0,0,0,0,0,0,0,9,0,16,25,9,1,0,10
152233,2022,Poland,Thailand,0,0,0,0,16/06/2022,1,0,16,17,0,0,0,0,0,0,0,0,10,3,16,29,27,2,2,31
152233,2022,Japan,Poland,0,0,0,0,14/06/2022,1,0,7,8,0,0,0,0,0,0,0,0,11,0,7,18,13,3,0,16
152233,2022,Poland,Germany,0,0,0,0,5/6/2022,0,0,8,8,0,0,0,0,0,0,0,0,18,1,12,31,14,3,1,18
152233,2022,Korea,Poland,0,0,0,0,4/6/2022,0,0,2,2,0,0,0,0,0,0,0,0,4,0,1,5,4,1,0,5
152233,2022,Brazil,Poland,0,0,0,0,2/6/2022,0,0,11,11,0,0,0,0,0,0,0,0,15,2,4,21,12,2,0,14
152233,2022,Poland,Canada,0,0,0,0,1/6/2022,0,0,13,13,0,0,0,0,0,0,0,0,19,0,4,23,23,1,1,25
172984,2022,Poland,Bulgaria,0,0,0,0,3/7/2022,0,0,0,0,0,1,0,1,0,0,0,0,0,0,0,0,0,0,0,0
172984,2022,Dominican Republic,Poland,1,3,18,22,2/7/2022,0,0,0,0,5,1,6,12,2,8,2,12,0,0,0,0,3,0,0,3
172984,2022,Poland,China,0,0,0,0,30/06/2022,0,0,0,0,0,3,0,3,0,0,1,1,0,0,0,0,0,0,0,0
172984,2022,Italy,Poland,1,2,16,19,29/06/2022,0,0,0,0,5,5,4,14,0,7,2,9,0,0,0,0,1,1,1,3
162398,2022,Belgium,Poland,0,2,14,16,18/06/2022,0,0,1,1,4,3,4,11,3,4,3,10,0,0,0,0,6,2,0,8
162398,2022,Poland,USA,0,0,2,2,17/06/2022,0,0,1,1,1,0,0,1,1,2,1,4,0,0,0,0,1,1,0,2
162398,2022,Poland,Thailand,0,2,8,10,16/06/2022,1,0,2,3,11,2,7,20,2,4,5,11,0,0,0,0,1,0,3,4
162398,2022,Japan,Poland,0,0,2,2,14/06/2022,0,0,1,1,2,0,0,2,0,0,1,1,0,0,1,1,1,0,0,1
162398,2022,Poland,Germany,0,0,0,0,5/6/2022,0,0,0,0,0,0,0,0,0,0,0,0,0,0,0,0,0,0,0,0
162398,2022,Korea,Poland,1,0,15,16,4/6/2022,0,0,4,4,4,1,3,8,3,0,5,8,0,0,0,0,2,0,0,2
162398,2022,Brazil,Poland,0,0,0,0,2/6/2022,0,0,0,0,0,0,0,0,0,0,0,0,0,0,0,0,0,0,0,0
162398,2022,Poland,Canada,0,1,7,8,1/6/2022,0,0,1,1,0,1,1,2,0,3,3,6,0,0,0,0,1,0,0,1
136317,2022,Poland,Bulgaria,0,2,7,9,3/7/2022,0,0,0,0,3,0,3,6,4,4,2,10,0,0,0,0,1,1,0,2
136317,2022,Dominican Republic,Poland,2,1,15,18,2/7/2022,0,1,1,2,7,3,8,18,8,7,6,21,1,0,1,2,3,1,2,6
136317,2022,Poland,China,0,1,4,5,30/06/2022,0,0,2,2,1,3,0,4,1,0,0,1,0,0,0,0,0,0,0,0
136317,2022,Italy,Poland,1,0,10,11,29/06/2022,0,0,0,0,4,2,6,12,2,7,7,16,0,2,1,3,1,0,2,3
136317,2022,Poland,Germany,2,3,20,25,5/6/2022,0,0,3,3,10,2,6,18,0,7,8,15,0,0,0,0,1,0,0,1
136317,2022,Korea,Poland,0,0,0,0,4/6/2022,0,0,0,0,0,0,0,0,0,0,0,0,0,0,0,0,0,0,0,0
136317,2022,Brazil,Poland,1,2,9,12,2/6/2022,0,0,0,0,6,0,3,9,2,3,1,6,0,0,0,0,2,0,0,2
136317,2022,Poland,Canada,2,2,11,15,1/6/2022,0,0,0,0,9,1,6,16,3,4,6,13,0,0,0,0,4,1,0,5
156479,2022,Belgium,Poland,1,1,12,14,18/06/2022,0,0,3,3,7,0,5,12,3,5,3,11,0,0,0,0,2,1,1,4
156479,2022,Poland,USA,0,0,1,1,17/06/2022,0,0,0,0,1,0,0,1,0,0,0,0,0,0,0,0,0,0,0,0
156479,2022,Poland,Thailand,0,1,22,23,16/06/2022,0,0,0,0,13,3,5,21,2,3,3,8,0,0,0,0,4,2,0,6
156479,2022,Japan,Poland,0,0,0,0,14/06/2022,0,0,0,0,0,0,0,0,0,0,0,0,0,0,0,0,0,0,0,0
156479,2022,Poland,Germany,0,0,3,3,5/6/2022,0,0,0,0,2,0,2,4,1,1,2,4,0,0,0,0,0,0,0,0
156479,2022,Korea,Poland,0,0,1,1,4/6/2022,0,0,0,0,1,0,1,2,2,1,1,4,0,0,0,0,1,0,0,1
156479,2022,Brazil,Poland,0,0,0,0,2/6/2022,0,0,0,0,0,0,0,0,0,0,0,0,0,0,0,0,0,0,0,0
156479,2022,Poland,Canada,0,0,4,4,1/6/2022,0,0,0,0,0,1,2,3,1,6,0,7,0,0,0,0,0,1,0,1
173996,2022,,,-,-,-,-,-,-,-,-,-,-,-,-,-,-,-,-,-,-,-,-,-,-,-,-,-
152223,2022,Poland,Bulgaria,0,1,5,6,3/7/2022,0,0,0,0,2,2,2,6,0,0,1,1,4,1,10,15,1,2,1,4
152223,2022,Dominican Republic,Poland,0,0,2,2,2/7/2022,0,0,0,0,0,0,1,1,1,0,0,1,0,0,2,2,1,2,0,3
152223,2022,Poland,China,0,1,6,7,30/06/2022,0,0,0,0,4,3,6,13,0,0,0,0,1,0,13,14,2,1,2,5
152223,2022,Italy,Poland,0,0,3,3,29/06/2022,1,0,0,1,1,0,0,1,0,0,0,0,0,1,0,1,2,1,0,3
152223,2022,Belgium,Poland,0,0,0,0,18/06/2022,0,0,0,0,0,0,0,0,0,0,0,0,0,0,0,0,0,0,0,0
152223,2022,Poland,USA,0,2,10,12,17/06/2022,0,0,1,1,6,3,14,23,0,6,2,8,3,0,3,6,3,1,0,4
152223,2022,Poland,Thailand,1,0,4,5,16/06/2022,0,0,3,3,1,0,1,2,0,0,1,1,2,2,8,12,3,1,0,4
152223,2022,Japan,Poland,0,1,6,7,14/06/2022,0,0,0,0,3,2,4,9,0,2,1,3,3,2,11,16,2,1,0,3
152223,2022,Poland,Germany,0,2,9,11,5/6/2022,0,0,3,3,11,3,14,28,0,4,3,7,20,1,6,27,12,4,0,16
152223,2022,Korea,Poland,0,0,2,2,4/6/2022,0,0,1,1,1,0,3,4,0,0,0,0,3,0,1,4,7,0,1,8
152223,2022,Brazil,Poland,0,2,8,10,2/6/2022,0,0,4,4,10,4,9,23,1,2,0,3,10,1,8,19,5,0,0,5
152223,2022,Poland,Canada,1,3,16,20,1/6/2022,0,0,1,1,7,5,5,17,1,2,0,3,14,2,6,22,12,1,0,13
152217,2022,,,-,-,-,-,-,-,-,-,-,-,-,-,-,-,-,-,-,-,-,-,-,-,-,-,-
152231,2022,Poland,Bulgaria,0,2,10,12,3/7/2022,0,0,1,1,9,3,8,20,0,2,4,6,5,0,23,28,6,0,1,7
152231,2022,Dominican Republic,Poland,0,0,2,2,2/7/2022,0,0,0,0,1,0,0,1,0,0,0,0,0,0,0,0,1,0,0,1
152231,2022,Poland,China,0,0,1,1,30/06/2022,0,0,0,0,1,0,1,2,0,0,0,0,0,0,1,1,0,0,0,0
152231,2022,Italy,Poland,0,0,1,1,29/06/2022,1,0,0,1,1,0,2,3,0,0,1,1,0,0,5,5,0,0,1,1
152231,2022,Belgium,Poland,0,0,0,0,18/06/2022,0,0,0,0,0,0,0,0,0,0,0,0,0,0,0,0,0,0,0,0
152231,2022,Poland,USA,0,0,0,0,17/06/2022,0,0,0,0,0,0,0,0,0,0,0,0,0,0,0,0,0,0,0,0
152231,2022,Poland,Thailand,0,0,0,0,16/06/2022,0,0,0,0,0,0,0,0,0,0,0,0,0,0,0,0,0,0,0,0
152231,2022,Japan,Poland,0,0,6,6,14/06/2022,0,0,0,0,1,1,2,4,0,0,0,0,0,0,4,4,0,3,0,3
152231,2022,Poland,Germany,0,2,0,2,5/6/2022,0,0,0,0,0,2,2,4,0,0,0,0,0,0,2,2,1,0,0,1
152231,2022,Korea,Poland,0,2,12,14,4/6/2022,0,0,1,1,7,4,11,22,2,2,1,5,6,1,2,9,3,0,0,3
152231,2022,Brazil,Poland,0,1,2,3,2/6/2022,0,0,0,0,0,0,0,0,0,0,0,0,0,0,0,0,0,0,0,0
152231,2022,Poland,Canada,0,0,2,2,1/6/2022,0,0,0,0,0,0,0,0,0,0,0,0,0,0,0,0,0,1,0,1
163098,2022,Poland,Bulgaria,0,0,0,0,3/7/2022,0,0,0,0,0,0,0,0,0,0,0,0,0,0,0,0,0,0,0,0
163098,2022,Dominican Republic,Poland,0,0,0,0,2/7/2022,0,0,0,0,0,0,0,0,0,0,0,0,0,0,0,0,0,0,0,0
163098,2022,Poland,China,0,0,0,0,30/06/2022,0,0,0,0,0,0,0,0,0,0,0,0,0,0,0,0,0,0,0,0
163098,2022,Italy,Poland,0,0,0,0,29/06/2022,0,0,0,0,0,0,0,0,0,0,0,0,0,0,0,0,0,0,0,0
163098,2022,Belgium,Poland,2,2,16,20,18/06/2022,1,0,2,3,22,9,17,48,1,2,2,5,8,2,12,22,16,2,0,18
163098,2022,Poland,USA,0,0,6,6,17/06/2022,0,0,0,0,8,2,10,20,0,2,0,2,5,0,27,32,4,5,1,10
163098,2022,Poland,Thailand,0,0,0,0,16/06/2022,0,0,0,0,0,1,1,2,0,1,2,3,0,0,0,0,0,0,0,0
163098,2022,Japan,Poland,1,2,6,9,14/06/2022,0,0,0,0,2,1,11,14,0,0,0,0,3,0,12,15,1,3,1,5
163098,2022,Poland,Germany,1,1,15,17,5/6/2022,0,0,2,2,13,5,10,28,2,1,4,7,23,2,5,30,8,3,2,13
163098,2022,Korea,Poland,0,0,10,10,4/6/2022,0,0,0,0,1,1,0,2,0,0,0,0,2,0,2,4,2,0,0,2
163098,2022,Brazil,Poland,0,2,10,12,2/6/2022,0,0,1,1,10,7,8,25,0,1,1,2,12,0,11,23,8,3,0,11
163098,2022,Poland,Canada,0,3,9,12,1/6/2022,0,0,0,0,17,4,15,36,0,5,1,6,13,1,11,25,8,1,0,9
185609,2022,Poland,Bulgaria,0,0,0,0,3/7/2022,0,0,2,2,0,0,0,0,0,0,0,0,0,0,1,1,1,0,1,2
185609,2022,Dominican Republic,Poland,0,0,0,0,2/7/2022,0,0,0,0,0,0,0,0,0,0,0,0,0,0,2,2,1,0,0,1
185609,2022,Poland,China,0,0,0,0,30/06/2022,0,0,0,0,0,0,0,0,0,0,0,0,0,0,0,0,0,0,0,0
185609,2022,Italy,Poland,0,0,0,0,29/06/2022,0,0,0,0,0,0,0,0,0,0,0,0,0,0,0,0,0,0,0,0
185609,2022,Belgium,Poland,0,0,0,0,18/06/2022,0,0,0,0,0,0,0,0,0,0,0,0,0,0,0,0,0,0,0,0
185609,2022,Poland,USA,0,0,0,0,17/06/2022,0,0,0,0,0,0,0,0,0,0,0,0,0,0,0,0,0,0,0,0
185609,2022,Poland,Thailand,0,0,0,0,16/06/2022,0,0,0,0,0,0,0,0,0,0,0,0,0,0,0,0,0,0,0,0
185609,2022,Japan,Poland,0,0,0,0,14/06/2022,0,0,0,0,0,0,0,0,0,0,0,0,0,0,0,0,0,0,0,0
185609,2022,Poland,Germany,0,0,0,0,5/6/2022,0,0,0,0,0,0,0,0,0,0,0,0,0,0,0,0,0,0,0,0
185609,2022,Korea,Poland,0,0,0,0,4/6/2022,0,0,4,4,0,0,0,0,0,0,0,0,7,0,0,7,7,0,0,7
185609,2022,Brazil,Poland,0,0,0,0,2/6/2022,0,0,0,0,0,0,0,0,0,0,0,0,0,0,0,0,0,0,0,0
185609,2022,Poland,Canada,0,0,0,0,1/6/2022,0,0,0,0,0,0,0,0,0,0,0,0,0,0,0,0,0,0,0,0
118591,2022,Poland,Bulgaria,0,0,5,5,3/7/2022,2,0,19,21,0,0,0,0,0,0,0,0,0,0,0,0,2,2,0,4
118591,2022,Dominican Republic,Poland,2,0,18,20,2/7/2022,24,0,121,145,0,0,0,0,0,3,3,6,0,0,0,0,11,2,1,14
118591,2022,Poland,China,0,0,7,7,30/06/2022,0,2,70,72,0,0,0,0,0,5,0,5,0,0,0,0,3,2,5,10
118591,2022,Italy,Poland,1,0,15,16,29/06/2022,109,1,2,112,1,0,2,3,2,3,2,7,0,0,0,0,5,2,2,9
118591,2022,Belgium,Poland,0,1,20,21,18/06/2022,37,2,97,136,0,0,2,2,0,4,8,12,0,0,0,0,10,5,1,16
118591,2022,Poland,USA,0,0,0,0,17/06/2022,1,0,2,3,0,0,0,0,0,0,0,0,0,0,0,0,1,1,0,2
118591,2022,Poland,Thailand,1,1,17,19,16/06/2022,52,1,90,143,2,0,2,4,4,0,6,10,0,0,1,1,14,3,1,18
118591,2022,Japan,Poland,0,1,10,11,14/06/2022,36,0,47,83,2,0,1,3,0,1,6,7,0,1,0,1,7,1,0,8
118591,2022,Poland,Germany,2,0,16,18,5/6/2022,30,1,80,111,0,2,2,4,2,3,2,7,0,0,1,1,10,3,0,13
118591,2022,Korea,Poland,1,1,4,6,4/6/2022,14,0,22,36,1,0,1,2,0,0,0,0,0,0,0,0,4,1,0,5
118591,2022,Brazil,Poland,0,0,0,0,2/6/2022,0,0,0,0,0,0,0,0,0,0,0,0,0,0,0,0,0,0,0,0
118591,2022,Poland,Canada,0,0,0,0,1/6/2022,0,0,0,0,0,0,0,0,0,0,0,0,0,0,0,0,0,0,0,0
181268,2022,Poland,Bulgaria,0,0,8,8,3/7/2022,0,0,1,1,5,4,9,18,2,0,0,2,0,0,6,6,5,1,0,6
181268,2022,Dominican Republic,Poland,3,2,27,32,2/7/2022,0,0,2,2,22,8,29,59,2,2,2,6,1,1,2,4,6,2,4,12
181268,2022,Poland,China,0,3,4,7,30/06/2022,0,0,0,0,9,6,20,35,0,1,0,1,0,0,4,4,7,2,3,12
181268,2022,Italy,Poland,0,2,9,11,29/06/2022,3,0,0,3,10,8,16,34,2,4,0,6,2,0,7,9,7,2,1,10
181268,2022,Belgium,Poland,3,4,9,16,18/06/2022,0,0,0,0,18,2,13,33,0,0,2,2,1,0,0,1,4,4,0,8
181268,2022,Poland,USA,1,2,5,8,17/06/2022,0,1,0,1,10,8,12,30,1,0,2,3,0,0,0,0,4,1,0,5
181268,2022,Poland,Thailand,2,3,16,21,16/06/2022,1,0,2,3,16,3,30,49,0,3,4,7,0,0,3,3,11,3,1,15
181268,2022,Japan,Poland,0,1,1,2,14/06/2022,1,0,0,1,6,3,3,12,1,1,1,3,0,0,0,0,0,1,0,1
152232,2022,,,-,-,-,-,-,-,-,-,-,-,-,-,-,-,-,-,-,-,-,-,-,-,-,-,-
173994,2022,,,-,-,-,-,-,-,-,-,-,-,-,-,-,-,-,-,-,-,-,-,-,-,-,-,-
163097,2022,Poland,Bulgaria,1,2,11,14,3/7/2022,0,0,0,0,9,5,3,17,0,6,2,8,0,0,1,1,0,2,0,2
163097,2022,Dominican Republic,Poland,0,0,0,0,2/7/2022,0,0,0,0,0,0,0,0,0,0,0,0,0,0,0,0,0,0,0,0
163097,2022,Poland,China,1,2,3,6,30/06/2022,0,0,0,0,0,1,0,1,0,0,1,1,0,0,0,0,0,0,0,0
163097,2022,Italy,Poland,0,0,0,0,29/06/2022,0,0,0,0,1,0,0,1,0,0,0,0,0,0,0,0,0,0,0,0
163097,2022,Belgium,Poland,0,0,0,0,18/06/2022,0,0,0,0,0,0,0,0,0,0,0,0,0,0,0,0,0,0,0,0
163097,2022,Poland,USA,0,0,4,4,17/06/2022,0,0,3,3,2,1,7,10,0,1,2,3,0,0,0,0,2,0,0,2
163097,2022,Poland,Thailand,0,0,0,0,16/06/2022,0,0,0,0,0,0,0,0,0,0,0,0,0,0,0,0,0,0,0,0
163097,2022,Japan,Poland,0,0,7,7,14/06/2022,0,0,2,2,7,1,8,16,1,5,5,11,0,0,0,0,2,0,0,2
163097,2022,Poland,Germany,1,1,10,12,5/6/2022,0,0,2,2,6,2,5,13,3,2,3,8,0,0,1,1,3,1,0,4
163097,2022,Korea,Poland,0,1,2,3,4/6/2022,0,0,2,2,4,1,0,5,1,1,1,3,1,0,0,1,2,0,0,2
163097,2022,Brazil,Poland,1,3,5,9,2/6/2022,0,0,2,2,9,2,2,13,0,4,2,6,0,0,0,0,5,0,0,5
163097,2022,Poland,Canada,0,0,0,0,1/6/2022,0,0,0,0,0,0,0,0,0,0,0,0,0,0,0,0,0,0,0,0
136321,2022,,,-,-,-,-,-,-,-,-,-,-,-,-,-,-,-,-,-,-,-,-,-,-,-,-,-
156480,2022,Poland,Bulgaria,1,1,8,10,3/7/2022,7,0,93,100,0,0,1,1,2,1,4,7,0,0,0,0,4,2,3,9
156480,2022,Dominican Republic,Poland,0,1,1,2,2/7/2022,1,0,4,5,0,0,0,0,0,0,0,0,0,0,0,0,0,0,0,0
156480,2022,Poland,China,0,0,0,0,30/06/2022,0,0,5,5,0,0,0,0,0,1,0,1,0,0,0,0,0,0,0,0
156480,2022,Italy,Poland,0,0,0,0,29/06/2022,0,0,0,0,0,0,0,0,0,0,0,0,0,0,0,0,0,0,0,0
156480,2022,Poland,Germany,0,0,1,1,5/6/2022,0,0,0,0,0,0,0,0,0,0,0,0,0,0,0,0,0,0,0,0
156480,2022,Korea,Poland,0,0,0,0,4/6/2022,0,0,0,0,0,0,0,0,0,0,0,0,0,0,0,0,0,0,0,0
156480,2022,Brazil,Poland,0,1,11,12,2/6/2022,18,1,68,87,1,0,1,2,2,0,5,7,0,0,0,0,10,1,0,11
156480,2022,Poland,Canada,0,1,3,4,1/6/2022,1,0,14,15,0,0,0,0,0,0,0,0,0,0,0,0,1,0,0,1
164107,2022,Poland,Bulgaria,0,0,2,2,3/7/2022,0,0,0,0,1,3,1,5,0,2,0,2,0,0,3,3,1,0,0,1
164107,2022,Dominican Republic,Poland,0,1,8,9,2/7/2022,0,0,0,0,10,4,7,21,2,3,0,5,12,1,24,37,6,4,3,13
164107,2022,Poland,China,0,1,2,3,30/06/2022,0,0,0,0,2,2,3,7,0,1,0,1,2,1,4,7,1,0,0,1
164107,2022,Italy,Poland,1,2,14,17,29/06/2022,2,0,1,3,6,4,16,26,1,4,0,5,2,0,29,31,1,1,1,3
164107,2022,Belgium,Poland,0,3,7,10,18/06/2022,0,0,3,3,9,6,10,25,2,7,7,16,11,0,23,34,8,5,0,13
164107,2022,Poland,USA,0,0,0,0,17/06/2022,0,0,0,0,0,0,0,0,0,0,0,0,2,1,2,5,0,1,0,1
164107,2022,Poland,Thailand,2,6,9,17,16/06/2022,2,0,4,6,13,3,14,30,3,0,0,3,9,0,24,33,7,5,1,13
164107,2022,Japan,Poland,0,0,2,2,14/06/2022,0,0,0,0,2,2,3,7,0,1,0,1,0,1,3,4,2,0,0,2
164107,2022,Poland,Germany,0,0,0,0,5/6/2022,0,0,1,1,2,2,4,8,0,0,0,0,0,0,0,0,1,0,0,1
164107,2022,Korea,Poland,2,1,8,11,4/6/2022,0,0,1,1,4,1,12,17,1,1,1,3,4,0,3,7,3,0,1,4
164107,2022,Brazil,Poland,0,0,3,3,2/6/2022,0,0,1,1,4,2,7,13,1,1,2,4,2,1,2,5,0,0,0,0
164107,2022,Poland,Canada,0,1,1,2,1/6/2022,0,0,0,0,3,2,4,9,2,0,3,5,0,0,0,0,0,0,0,0
181267,2022,,,-,-,-,-,-,-,-,-,-,-,-,-,-,-,-,-,-,-,-,-,-,-,-,-,-
164104,2022,,,-,-,-,-,-,-,-,-,-,-,-,-,-,-,-,-,-,-,-,-,-,-,-,-,-
152222,2022,,,-,-,-,-,-,-,-,-,-,-,-,-,-,-,-,-,-,-,-,-,-,-,-,-,-
181263,2022,Belgium,Poland,0,0,0,0,18/06/2022,0,0,0,0,0,0,0,0,0,0,0,0,0,0,0,0,0,0,0,0
181263,2022,Poland,USA,0,2,9,11,17/06/2022,3,0,75,78,0,0,1,1,0,2,1,3,0,0,1,1,7,3,1,11
181263,2022,Poland,Thailand,0,0,3,3,16/06/2022,1,0,7,8,0,0,0,0,0,0,0,0,0,0,0,0,1,1,0,2
181263,2022,Japan,Poland,0,0,1,1,14/06/2022,0,0,0,0,0,0,0,0,0,0,0,0,0,0,0,0,0,0,0,0
181263,2022,Poland,Germany,0,0,1,1,5/6/2022,0,0,7,7,0,0,0,0,0,0,0,0,0,0,0,0,0,0,0,0
181263,2022,Korea,Poland,0,0,3,3,4/6/2022,3,0,17,20,1,0,0,1,1,0,0,1,0,0,0,0,1,1,0,2
181263,2022,Brazil,Poland,0,0,0,0,2/6/2022,0,0,0,0,0,0,0,0,0,0,0,0,0,0,0,0,0,0,0,0
181263,2022,Poland,Canada,2,1,14,17,1/6/2022,7,0,82,89,1,0,0,1,0,1,2,3,0,0,1,1,6,3,1,10
151231,2022,Poland,Bulgaria,0,2,5,7,3/7/2022,1,0,3,4,19,7,20,46,0,3,1,4,2,0,5,7,5,1,0,6
151231,2022,Dominican Republic,Poland,0,5,3,8,2/7/2022,0,0,0,0,19,8,24,51,2,9,5,16,1,0,2,3,11,2,1,14
151231,2022,Poland,China,0,2,5,7,30/06/2022,0,0,3,3,8,2,12,22,1,3,1,5,2,0,10,12,4,2,2,8
151231,2022,Italy,Poland,0,5,8,13,29/06/2022,2,0,0,2,17,6,21,44,2,1,1,4,2,1,7,10,11,1,2,14
151231,2022,Belgium,Poland,0,1,4,5,18/06/2022,0,1,1,2,10,2,20,32,3,1,5,9,1,1,7,9,6,1,1,8
151231,2022,Poland,USA,0,0,1,1,17/06/2022,0,0,0,0,5,1,2,8,0,0,2,2,0,0,0,0,1,0,0,1
151231,2022,Poland,Thailand,1,4,9,14,16/06/2022,0,0,2,2,17,10,28,55,2,4,2,8,6,0,7,13,16,0,0,16
151231,2022,Japan,Poland,0,1,7,8,14/06/2022,1,0,1,2,8,5,12,25,1,0,2,3,0,0,2,2,1,3,0,4
151231,2022,Poland,Germany,0,3,10,13,5/6/2022,0,0,1,1,18,2,23,43,4,3,3,10,0,0,0,0,10,1,2,13
151231,2022,Korea,Poland,0,3,3,6,4/6/2022,0,0,1,1,9,0,9,18,2,0,3,5,0,0,0,0,4,0,0,4
151231,2022,Brazil,Poland,0,1,5,6,2/6/2022,0,0,0,0,9,9,8,26,0,4,2,6,0,0,0,0,6,2,0,8
151231,2022,Poland,Canada,1,1,8,10,1/6/2022,0,1,0,1,9,10,23,42,2,0,0,2,0,0,0,0,6,0,0,6
185611,2022,Poland,Bulgaria,0,0,5,5,3/7/2022,0,0,0,0,0,0,0,0,0,2,1,3,0,1,0,1,0,0,0,0
185611,2022,Dominican Republic,Poland,0,0,0,0,2/7/2022,0,0,0,0,0,0,0,0,0,0,0,0,0,0,0,0,0,0,0,0
185611,2022,Poland,China,0,1,9,10,30/06/2022,0,0,0,0,5,0,0,5,2,1,0,3,0,0,0,0,1,1,0,2
185611,2022,Italy,Poland,0,0,1,1,29/06/2022,0,0,0,0,0,0,0,0,0,0,0,0,0,0,0,0,1,0,0,1
185611,2022,Belgium,Poland,0,0,3,3,18/06/2022,0,0,1,1,1,0,0,1,0,1,1,2,0,1,0,1,1,0,0,1
185611,2022,Poland,USA,0,1,5,6,17/06/2022,0,0,2,2,2,0,3,5,1,4,2,7,0,0,1,1,1,0,0,1
185611,2022,Poland,Thailand,0,0,2,2,16/06/2022,0,0,0,0,0,2,2,4,0,0,0,0,0,0,0,0,0,0,0,0
185611,2022,Japan,Poland,0,0,10,10,14/06/2022,0,0,0,0,8,0,3,11,1,5,5,11,1,0,1,2,2,2,0,4
136024,2022,Türkiye,Serbia,1,0,13,14,17/07/2022,0,0,1,1,12,7,12,31,1,1,3,5,8,2,9,19,14,0,0,14
136024,2022,Serbia,Brazil,0,2,5,7,16/07/2022,0,0,0,0,2,0,4,6,0,0,2,2,4,0,3,7,2,1,0,3
136024,2022,USA,Serbia,0,0,0,0,13/07/2022,0,0,0,0,0,0,0,0,0,0,0,0,0,0,0,0,0,0,0,0
136024,2022,Japan,Serbia,0,1,10,11,2/7/2022,0,0,0,0,5,2,6,13,0,1,0,1,4,0,3,7,7,3,0,10
136024,2022,Serbia,Canada,2,4,10,16,2/7/2022,0,1,1,2,4,7,8,19,1,0,0,1,1,1,17,19,2,1,0,3
136024,2022,USA,Serbia,2,1,9,12,1/7/2022,0,0,0,0,12,3,11,26,0,1,3,4,14,3,16,33,6,0,0,6
136024,2022,Serbia,Germany,1,1,12,14,28/06/2022,0,0,2,2,11,2,13,26,1,1,1,3,8,3,23,34,7,1,1,9
136024,2022,Brazil,Serbia,0,0,1,1,19/06/2022,0,0,0,0,1,3,3,7,0,1,0,1,0,1,0,1,0,1,0,1
136024,2022,Serbia,Türkiye,0,0,7,7,17/06/2022,0,0,2,2,5,5,8,18,2,1,3,6,6,2,16,24,4,0,1,5
136024,2022,Serbia,Korea,0,1,13,14,16/06/2022,0,0,2,2,9,4,17,30,0,2,3,5,4,2,15,21,1,3,2,6
136024,2022,Serbia,Italy,0,0,1,1,15/06/2022,0,0,0,0,2,0,6,8,0,0,1,1,2,0,4,6,3,0,0,3
152168,2022,Türkiye,Serbia,0,0,3,3,17/07/2022,0,0,0,0,0,0,0,0,0,0,0,0,0,0,0,0,0,0,0,0
152168,2022,Serbia,Brazil,1,0,2,3,16/07/2022,0,0,0,0,1,1,0,2,0,1,0,1,0,1,2,3,0,2,0,2
152168,2022,USA,Serbia,1,1,7,9,13/07/2022,0,0,0,0,0,0,0,0,0,0,0,0,0,0,1,1,0,0,0,0
152168,2022,Japan,Serbia,0,1,17,18,2/7/2022,0,1,1,2,20,1,26,47,2,2,1,5,21,2,16,39,14,4,0,18
152168,2022,Serbia,Canada,0,0,6,6,2/7/2022,0,0,2,2,5,0,5,10,1,0,0,1,1,0,3,4,2,0,2,4
152168,2022,USA,Serbia,0,0,3,3,1/7/2022,0,0,0,0,2,2,6,10,0,0,1,1,2,1,3,6,4,0,0,4
152168,2022,Serbia,Germany,0,3,9,12,28/06/2022,0,0,4,4,11,3,12,26,0,1,2,3,4,1,10,15,7,0,1,8
152168,2022,Brazil,Serbia,0,0,2,2,19/06/2022,0,0,0,0,0,0,0,0,0,0,0,0,0,0,0,0,0,0,0,0
152168,2022,Serbia,Türkiye,0,0,10,10,17/06/2022,0,0,1,1,3,8,7,18,0,1,1,2,2,0,6,8,3,2,3,8
152168,2022,Serbia,Korea,1,1,3,5,16/06/2022,0,0,0,0,0,2,0,2,0,1,0,1,2,0,4,6,2,1,0,3
152168,2022,Serbia,Italy,1,1,11,13,15/06/2022,0,0,0,0,10,4,13,27,2,0,3,5,5,2,15,22,5,0,2,7
152168,2022,Serbia,Netherlands,1,0,16,17,5/6/2022,1,0,2,3,17,4,13,34,0,1,2,3,12,3,23,38,8,2,5,15
152168,2022,Serbia,Bulgaria,1,0,11,12,3/6/2022,0,0,2,2,11,4,4,19,0,4,1,5,7,0,13,20,8,2,2,12
152168,2022,Thailand,Serbia,1,0,9,10,2/6/2022,0,0,3,3,4,2,7,13,0,3,1,4,0,0,9,9,4,1,2,7
152168,2022,Belgium,Serbia,0,1,10,11,1/6/2022,0,0,1,1,12,4,17,33,1,4,4,9,6,1,10,17,10,6,1,17
163120,2022,,,-,-,-,-,-,-,-,-,-,-,-,-,-,-,-,-,-,-,-,-,-,-,-,-,-
120326,2022,Türkiye,Serbia,1,0,15,16,17/07/2022,9,2,88,99,0,2,1,3,1,2,2,5,0,0,1,1,6,1,1,8
120326,2022,Serbia,Brazil,0,0,9,9,16/07/2022,25,2,62,89,1,0,3,4,2,4,6,12,0,0,1,1,7,5,4,16
120326,2022,USA,Serbia,0,1,14,15,13/07/2022,12,2,91,105,3,0,0,3,1,6,1,8,0,0,1,1,11,9,0,20
120326,2022,Serbia,Netherlands,1,3,14,18,5/6/2022,56,0,56,112,4,1,4,9,1,2,3,6,0,0,0,0,13,4,4,21
120326,2022,Serbia,Bulgaria,1,1,10,12,3/6/2022,14,0,62,76,1,0,1,2,0,3,0,3,0,0,1,1,5,3,3,11
120326,2022,Thailand,Serbia,0,0,6,6,2/6/2022,3,0,21,24,1,0,0,1,0,0,0,0,0,0,0,0,4,0,0,4
120326,2022,Belgium,Serbia,1,0,16,17,1/6/2022,22,1,71,94,1,0,3,4,0,1,1,2,0,0,0,0,8,1,4,13
136030,2022,Türkiye,Serbia,0,0,0,0,17/07/2022,0,0,0,0,0,0,0,0,0,0,0,0,0,0,0,0,0,0,0,0
136030,2022,Serbia,Brazil,0,0,2,2,16/07/2022,0,0,0,0,1,0,0,1,0,0,0,0,0,0,0,0,0,1,0,1
136030,2022,USA,Serbia,0,0,0,0,13/07/2022,0,0,0,0,0,0,0,0,0,0,0,0,0,0,0,0,0,0,0,0
152169,2022,Japan,Serbia,0,0,2,2,2/7/2022,1,0,4,5,0,0,0,0,0,0,0,0,0,0,0,0,0,0,0,0
152169,2022,Serbia,Canada,0,0,0,0,2/7/2022,0,0,0,0,0,0,0,0,0,0,0,0,0,0,0,0,0,0,0,0
152169,2022,USA,Serbia,0,1,0,1,1/7/2022,0,0,13,13,0,0,0,0,0,0,0,0,0,0,0,0,1,1,0,2
152169,2022,Serbia,Germany,0,0,1,1,28/06/2022,0,0,2,2,0,0,0,0,0,0,0,0,0,0,0,0,1,0,0,1
152169,2022,Brazil,Serbia,0,0,0,0,19/06/2022,2,0,3,5,0,0,0,0,0,0,0,0,0,0,0,0,0,0,0,0
152169,2022,Serbia,Türkiye,0,0,0,0,17/06/2022,3,0,7,10,0,0,0,0,0,1,0,1,0,0,0,0,0,0,0,0
152169,2022,Serbia,Korea,0,0,3,3,16/06/2022,3,1,19,23,0,0,2,2,0,0,1,1,0,0,0,0,1,1,0,2
152169,2022,Serbia,Italy,0,0,1,1,15/06/2022,0,3,3,6,0,0,0,0,0,0,0,0,0,0,0,0,1,0,0,1
136812,2022,Türkiye,Serbia,0,0,0,0,17/07/2022,0,0,0,0,0,0,0,0,0,0,0,0,0,0,0,0,0,0,0,0
136812,2022,Serbia,Brazil,0,1,4,5,16/07/2022,1,1,11,13,2,0,1,3,0,0,0,0,0,0,0,0,1,4,1,6
136812,2022,USA,Serbia,0,1,2,3,13/07/2022,1,0,18,19,0,0,0,0,0,0,0,0,0,0,0,0,1,2,1,4
136812,2022,Japan,Serbia,1,1,13,15,2/7/2022,9,1,120,130,1,1,7,9,1,1,6,8,0,0,0,0,16,1,0,17
136812,2022,Serbia,Canada,0,2,11,13,2/7/2022,2,0,73,75,5,1,2,8,0,0,0,0,0,0,3,3,3,0,0,3
136812,2022,USA,Serbia,0,2,7,9,1/7/2022,6,1,62,69,1,1,4,6,0,0,1,1,0,0,0,0,4,2,0,6
136812,2022,Serbia,Germany,1,0,19,20,28/06/2022,16,0,79,95,6,0,2,8,0,2,0,2,0,0,0,0,8,0,0,8
136812,2022,Brazil,Serbia,0,1,9,10,19/06/2022,19,1,76,96,3,0,1,4,0,2,3,5,0,0,0,0,4,3,1,8
136812,2022,Serbia,Türkiye,0,1,13,14,17/06/2022,18,1,101,120,0,1,2,3,1,9,1,11,0,0,0,0,4,2,1,7
136812,2022,Serbia,Korea,0,3,8,11,16/06/2022,21,1,60,82,2,0,0,2,0,2,4,6,0,0,0,0,1,0,0,1
136812,2022,Serbia,Italy,0,0,12,12,15/06/2022,0,2,66,68,2,1,1,4,0,0,3,3,0,0,1,1,4,0,2,6
136812,2022,Serbia,Netherlands,0,0,4,4,5/6/2022,8,0,10,18,0,0,0,0,0,0,0,0,0,0,0,0,2,0,0,2
136812,2022,Serbia,Bulgaria,1,1,2,4,3/6/2022,4,0,15,19,0,0,0,0,0,0,0,0,0,0,0,0,2,1,0,3
136812,2022,Thailand,Serbia,1,0,16,17,2/6/2022,15,0,98,113,4,0,1,5,1,0,2,3,0,0,0,0,0,2,2,4
136812,2022,Belgium,Serbia,0,0,6,6,1/6/2022,4,0,16,20,0,0,0,0,0,0,0,0,0,0,0,0,1,1,1,3
121593,2022,Türkiye,Serbia,0,0,0,0,17/07/2022,0,0,0,0,0,0,0,0,0,0,0,0,0,0,0,0,0,0,0,0
121593,2022,Serbia,Brazil,0,0,1,1,16/07/2022,0,0,0,0,3,1,6,10,2,2,0,4,0,0,0,0,1,0,0,1
121593,2022,USA,Serbia,0,0,1,1,13/07/2022,0,0,0,0,7,4,2,13,0,0,0,0,0,0,0,0,0,0,0,0
121593,2022,Serbia,Netherlands,0,0,4,4,5/6/2022,0,0,1,1,3,0,6,9,0,2,0,2,0,0,2,2,2,1,0,3
121593,2022,Serbia,Bulgaria,0,0,0,0,3/6/2022,0,0,0,0,0,0,0,0,0,0,0,0,0,0,0,0,0,0,0,0
121593,2022,Thailand,Serbia,0,1,2,3,2/6/2022,0,1,0,1,5,2,8,15,1,2,2,5,1,0,5,6,2,0,2,4
121593,2022,Belgium,Serbia,0,0,0,0,1/6/2022,0,0,0,0,0,1,3,4,1,0,0,1,0,1,1,2,1,0,0,1
123709,2022,Türkiye,Serbia,0,0,0,0,17/07/2022,0,0,10,10,0,0,0,0,0,0,0,0,6,0,10,16,7,6,0,13
123709,2022,Serbia,Brazil,0,0,0,0,16/07/2022,1,0,12,13,0,0,0,0,0,0,0,0,6,0,11,17,12,6,3,21
123709,2022,USA,Serbia,0,0,0,0,13/07/2022,0,0,5,5,0,0,0,0,0,0,0,0,21,2,25,48,15,2,0,17
123709,2022,Japan,Serbia,0,0,0,0,2/7/2022,0,0,19,19,0,0,1,1,0,0,0,0,6,1,8,15,15,2,0,17
123709,2022,Serbia,Canada,0,0,0,0,2/7/2022,0,0,6,6,0,0,0,0,0,0,0,0,4,0,26,30,4,0,0,4
123709,2022,USA,Serbia,0,0,0,0,1/7/2022,0,0,7,7,0,0,0,0,0,0,0,0,6,0,3,9,4,1,0,5
123709,2022,Serbia,Germany,0,0,0,0,28/06/2022,0,0,7,7,0,0,0,0,0,0,0,0,3,0,16,19,13,6,1,20
123709,2022,Brazil,Serbia,0,0,0,0,19/06/2022,0,0,8,8,0,0,0,0,0,0,0,0,4,0,4,8,11,5,2,18
123709,2022,Serbia,Türkiye,0,0,0,0,17/06/2022,0,0,13,13,0,0,0,0,0,0,0,0,7,0,10,17,16,2,4,22
123709,2022,Serbia,Korea,0,0,0,0,16/06/2022,0,0,7,7,0,0,0,0,0,0,0,0,11,0,12,23,10,3,1,14
123709,2022,Serbia,Italy,0,0,0,0,15/06/2022,0,0,0,0,0,0,0,0,0,0,0,0,12,3,15,30,15,1,5,21
123709,2022,Serbia,Netherlands,0,0,0,0,5/6/2022,2,0,12,14,0,0,0,0,0,0,0,0,5,0,15,20,16,4,3,23
123709,2022,Serbia,Bulgaria,0,0,0,0,3/6/2022,0,0,4,4,0,0,0,0,0,0,0,0,4,1,12,17,19,1,0,20
123709,2022,Thailand,Serbia,0,0,0,0,2/6/2022,0,0,9,9,0,0,0,0,0,0,0,0,5,2,17,24,12,5,1,18
123709,2022,Belgium,Serbia,0,0,0,0,1/6/2022,0,0,10,10,0,0,0,0,0,0,0,0,5,1,21,27,11,3,3,17
123694,2022,Türkiye,Serbia,0,0,10,10,17/07/2022,0,0,4,4,11,6,14,31,1,2,2,5,0,0,0,0,8,1,1,10
123694,2022,Serbia,Brazil,1,1,10,12,16/07/2022,0,0,1,1,15,7,18,40,1,0,1,2,0,0,0,0,3,1,3,7
123694,2022,USA,Serbia,0,1,8,9,13/07/2022,0,0,0,0,17,8,23,48,3,4,1,8,0,0,1,1,3,1,0,4
123694,2022,Japan,Serbia,0,0,0,0,2/7/2022,0,0,0,0,0,0,0,0,0,0,0,0,0,0,0,0,0,0,0,0
123694,2022,Serbia,Canada,1,1,12,14,2/7/2022,0,0,2,2,26,6,30,62,0,0,0,0,0,0,0,0,4,0,0,4
123694,2022,USA,Serbia,0,1,6,7,1/7/2022,0,0,2,2,12,11,12,35,1,2,2,5,0,0,0,0,1,0,0,1
123694,2022,Serbia,Germany,0,3,11,14,28/06/2022,0,0,3,3,12,8,15,35,3,2,1,6,0,0,0,0,4,1,1,6
123694,2022,Brazil,Serbia,0,2,8,10,19/06/2022,0,0,1,1,8,9,22,39,0,1,2,3,0,0,0,0,5,1,2,8
123694,2022,Serbia,Türkiye,2,3,13,18,17/06/2022,0,0,0,0,15,5,27,47,2,5,0,7,0,0,0,0,6,3,1,10
123694,2022,Serbia,Korea,0,0,12,12,16/06/2022,0,0,0,0,19,2,12,33,4,2,6,12,0,0,0,0,3,1,0,4
123694,2022,Serbia,Italy,0,2,8,10,15/06/2022,0,0,2,2,16,6,14,36,1,0,6,7,0,0,0,0,6,0,0,6
123694,2022,Serbia,Netherlands,1,0,12,13,5/6/2022,0,0,2,2,15,8,22,45,1,3,4,8,0,0,0,0,14,1,2,17
123694,2022,Serbia,Bulgaria,0,1,5,6,3/6/2022,0,0,0,0,16,5,18,39,1,3,4,8,0,0,0,0,3,1,1,5
123694,2022,Thailand,Serbia,0,0,3,3,2/6/2022,0,0,0,0,5,1,14,20,1,0,0,1,0,0,0,0,1,0,0,1
123694,2022,Belgium,Serbia,0,0,9,9,1/6/2022,0,0,0,0,21,4,21,46,0,2,4,6,0,0,0,0,5,3,1,9
143548,2022,Türkiye,Serbia,0,0,9,9,17/07/2022,0,0,1,1,5,1,2,8,3,2,7,12,1,0,0,1,4,1,1,6
143548,2022,Serbia,Brazil,1,1,16,18,16/07/2022,0,0,1,1,5,2,2,9,2,5,7,14,0,0,0,0,3,1,2,6
143548,2022,USA,Serbia,0,2,19,21,13/07/2022,0,0,2,2,12,2,2,16,2,12,7,21,1,0,1,2,4,1,1,6
143548,2022,Japan,Serbia,1,2,14,17,2/7/2022,0,0,0,0,12,1,6,19,4,6,6,16,0,0,2,2,4,0,0,4
143548,2022,Serbia,Canada,0,0,4,4,2/7/2022,0,0,2,2,2,2,4,8,2,3,1,6,0,0,0,0,1,0,0,1
143548,2022,USA,Serbia,0,1,7,8,1/7/2022,0,0,2,2,4,1,1,6,3,6,3,12,0,0,0,0,1,0,0,1
143548,2022,Serbia,Germany,1,1,12,14,28/06/2022,1,0,1,2,10,1,3,14,2,6,5,13,0,0,2,2,3,0,0,3
143548,2022,Brazil,Serbia,0,0,6,6,19/06/2022,0,0,2,2,2,2,2,6,1,4,3,8,0,0,0,0,2,1,0,3
143548,2022,Serbia,Türkiye,1,1,14,16,17/06/2022,0,0,1,1,7,2,4,13,4,4,4,12,1,0,1,2,3,1,0,4
143548,2022,Serbia,Korea,0,2,11,13,16/06/2022,0,0,2,2,2,2,8,12,3,7,8,18,0,0,0,0,1,0,0,1
143548,2022,Serbia,Italy,1,3,14,18,15/06/2022,0,0,0,0,2,0,6,8,3,1,11,15,0,0,0,0,4,0,1,5
143548,2022,Serbia,Netherlands,0,2,14,16,5/6/2022,0,0,2,2,6,2,5,13,1,3,5,9,0,0,0,0,4,0,3,7
143548,2022,Serbia,Bulgaria,0,1,12,13,3/6/2022,0,0,2,2,3,0,4,7,4,3,10,17,0,0,0,0,4,1,0,5
143548,2022,Thailand,Serbia,1,2,12,15,2/6/2022,0,0,1,1,11,1,5,17,6,6,4,16,0,0,1,1,5,0,0,5
143548,2022,Belgium,Serbia,1,2,13,16,1/6/2022,0,0,1,1,3,2,1,6,7,4,11,22,0,0,1,1,1,0,1,2
123700,2022,Türkiye,Serbia,0,2,8,10,17/07/2022,0,0,1,1,6,1,6,13,3,8,6,17,0,0,0,0,5,2,0,7
123700,2022,Serbia,Brazil,2,0,11,13,16/07/2022,0,0,3,3,9,2,3,14,4,11,7,22,0,0,1,1,3,1,1,5
123700,2022,USA,Serbia,2,1,13,16,13/07/2022,0,0,0,0,5,4,3,12,2,8,4,14,0,0,0,0,3,2,0,5
123700,2022,Japan,Serbia,0,2,7,9,2/7/2022,0,0,3,3,9,0,11,20,3,7,6,16,2,0,1,3,5,1,0,6
123700,2022,Serbia,Canada,0,2,6,8,2/7/2022,0,0,1,1,5,2,3,10,3,1,3,7,0,0,0,0,0,0,0,0
123700,2022,USA,Serbia,1,0,11,12,1/7/2022,0,0,2,2,4,2,5,11,0,8,3,11,2,0,0,2,2,0,0,2
123700,2022,Serbia,Germany,0,1,11,12,28/06/2022,0,0,1,1,7,4,2,13,2,4,7,13,0,0,0,0,4,0,0,4
123700,2022,Brazil,Serbia,0,1,4,5,19/06/2022,0,0,0,0,4,3,4,11,3,2,5,10,0,0,0,0,0,0,0,0
123700,2022,Serbia,Türkiye,0,3,11,14,17/06/2022,0,0,0,0,3,3,4,10,9,7,5,21,1,0,1,2,0,0,0,0
123700,2022,Serbia,Korea,1,2,11,14,16/06/2022,0,0,0,0,6,1,5,12,1,4,4,9,1,0,1,2,4,2,1,7
123700,2022,Serbia,Italy,0,3,7,10,15/06/2022,0,0,1,1,3,4,5,12,1,0,9,10,0,0,0,0,6,0,3,9
123700,2022,Serbia,Netherlands,1,2,15,18,5/6/2022,1,0,0,1,4,1,5,10,5,17,10,32,0,0,0,0,3,0,1,4
123700,2022,Serbia,Bulgaria,1,1,12,14,3/6/2022,0,0,3,3,3,1,3,7,1,5,6,12,0,0,0,0,1,0,1,2
123700,2022,Thailand,Serbia,2,0,14,16,2/6/2022,0,0,1,1,4,3,13,20,3,8,10,21,0,0,0,0,1,0,0,1
123700,2022,Belgium,Serbia,0,0,11,11,1/6/2022,0,0,1,1,4,1,6,11,0,8,12,20,0,0,0,0,6,1,0,7
152173,2022,,,-,-,-,-,-,-,-,-,-,-,-,-,-,-,-,-,-,-,-,-,-,-,-,-,-
142478,2022,Türkiye,Serbia,0,0,0,0,17/07/2022,0,0,0,0,0,0,0,0,0,0,0,0,1,0,2,3,2,0,1,3
142478,2022,Serbia,Brazil,0,0,8,8,16/07/2022,0,0,4,4,4,4,9,17,1,0,0,1,5,1,15,21,1,4,2,7
142478,2022,USA,Serbia,0,0,12,12,13/07/2022,0,0,2,2,8,5,15,28,2,4,1,7,14,1,20,35,9,4,0,13
142478,2022,Japan,Serbia,0,1,9,10,2/7/2022,1,0,4,5,5,1,14,20,0,0,1,1,6,1,7,14,12,3,0,15
142478,2022,Serbia,Canada,2,1,20,23,2/7/2022,0,0,3,3,9,6,12,27,2,2,2,6,3,0,15,18,4,0,0,4
142478,2022,USA,Serbia,0,1,9,10,1/7/2022,0,0,0,0,7,1,8,16,1,0,2,3,13,0,12,25,4,1,0,5
142478,2022,Serbia,Germany,0,0,0,0,28/06/2022,0,0,0,0,1,0,2,3,0,0,0,0,2,1,1,4,0,0,0,0
142478,2022,Brazil,Serbia,0,0,8,8,19/06/2022,0,0,2,2,8,6,17,31,0,2,2,4,4,0,13,17,9,3,0,12
142478,2022,Serbia,Türkiye,0,0,0,0,17/06/2022,0,0,0,0,0,0,3,3,0,0,0,0,0,1,0,1,0,0,0,0
142478,2022,Serbia,Korea,0,0,0,0,16/06/2022,0,0,0,0,0,0,0,0,0,0,0,0,0,0,0,0,0,0,0,0
142478,2022,Serbia,Italy,0,0,0,0,15/06/2022,0,0,0,0,0,0,0,0,0,0,0,0,0,0,0,0,0,0,0,0
183533,2022,Serbia,Netherlands,0,0,0,0,5/6/2022,0,0,0,0,2,1,6,9,0,0,2,2,0,0,0,0,1,0,0,1
183533,2022,Serbia,Bulgaria,0,0,0,0,3/6/2022,0,0,1,1,2,3,1,6,0,0,0,0,0,0,0,0,0,0,0,0
183533,2022,Thailand,Serbia,2,2,10,14,2/6/2022,0,0,0,0,18,6,26,50,2,3,2,7,0,0,0,0,3,0,2,5
183533,2022,Belgium,Serbia,0,0,0,0,1/6/2022,0,0,0,0,3,0,4,7,1,2,2,5,0,0,0,0,0,1,0,1
152167,2022,Türkiye,Serbia,0,0,0,0,17/07/2022,0,0,0,0,0,0,0,0,0,0,0,0,0,0,0,0,0,0,0,0
152167,2022,Serbia,Brazil,0,0,0,0,16/07/2022,0,0,0,0,0,0,0,0,0,0,0,0,0,0,0,0,0,0,0,0
152167,2022,USA,Serbia,0,0,0,0,13/07/2022,0,0,0,0,0,0,0,0,0,0,0,0,0,0,0,0,0,0,0,0
152167,2022,Japan,Serbia,0,0,0,0,2/7/2022,0,0,0,0,0,0,0,0,0,0,0,0,0,0,0,0,0,0,0,0
152167,2022,Serbia,Canada,0,0,4,4,2/7/2022,0,0,0,0,0,0,0,0,0,0,0,0,0,0,0,0,2,0,0,2
152167,2022,USA,Serbia,0,0,0,0,1/7/2022,0,0,0,0,0,0,0,0,0,0,0,0,0,0,0,0,0,0,0,0
152167,2022,Serbia,Germany,0,0,0,0,28/06/2022,0,0,0,0,0,0,0,0,0,0,0,0,0,0,0,0,0,0,0,0
152167,2022,Brazil,Serbia,0,0,0,0,19/06/2022,0,0,0,0,0,0,0,0,0,0,0,0,0,0,0,0,0,0,0,0
152167,2022,Serbia,Türkiye,0,0,0,0,17/06/2022,0,0,0,0,0,0,0,0,0,0,0,0,0,0,0,0,0,0,0,0
152167,2022,Serbia,Korea,0,0,0,0,16/06/2022,0,0,0,0,0,0,0,0,0,0,0,0,0,0,0,0,0,0,0,0
152167,2022,Serbia,Italy,0,0,0,0,15/06/2022,0,0,0,0,0,0,0,0,0,0,0,0,0,0,0,0,0,0,0,0
152167,2022,Serbia,Netherlands,0,0,0,0,5/6/2022,0,0,0,0,0,0,0,0,0,0,0,0,0,0,0,0,0,0,0,0
152167,2022,Serbia,Bulgaria,0,0,0,0,3/6/2022,0,0,0,0,0,0,0,0,0,0,0,0,0,0,0,0,0,0,0,0
152167,2022,Thailand,Serbia,0,0,0,0,2/6/2022,0,0,0,0,0,0,0,0,0,0,0,0,0,0,0,0,0,0,0,0
152167,2022,Belgium,Serbia,0,0,0,0,1/6/2022,0,0,0,0,0,0,0,0,0,0,0,0,0,0,0,0,0,0,0,0
142479,2022,Türkiye,Serbia,0,3,11,14,17/07/2022,0,0,2,2,18,2,9,29,1,4,0,5,6,1,20,27,5,0,0,5
142479,2022,Serbia,Brazil,0,1,8,9,16/07/2022,0,0,4,4,10,3,9,22,0,0,0,0,10,0,24,34,9,2,1,12
142479,2022,USA,Serbia,3,2,18,23,13/07/2022,0,0,2,2,15,9,14,38,4,4,3,11,11,0,6,17,10,2,0,12
142479,2022,Brazil,Serbia,0,1,10,11,19/06/2022,0,0,0,0,6,4,5,15,0,0,0,0,17,0,26,43,5,1,1,7
142479,2022,Serbia,Türkiye,1,0,19,20,17/06/2022,0,0,1,1,17,5,15,37,0,2,1,3,10,0,30,40,7,1,0,8
142479,2022,Serbia,Korea,0,0,16,16,16/06/2022,0,0,2,2,7,4,7,18,1,0,0,1,6,1,12,19,11,2,2,15
142479,2022,Serbia,Italy,0,2,8,10,15/06/2022,0,0,0,0,6,5,7,18,1,0,3,4,8,2,14,24,3,0,0,3
142479,2022,Serbia,Netherlands,1,3,12,16,5/6/2022,0,0,3,3,16,4,16,36,4,5,4,13,3,2,30,35,14,1,5,20
142479,2022,Serbia,Bulgaria,0,1,12,13,3/6/2022,0,1,3,4,13,2,13,28,2,4,2,8,3,2,14,19,6,1,4,11
142479,2022,Thailand,Serbia,0,1,17,18,2/6/2022,0,0,0,0,11,3,19,33,2,3,3,8,16,2,31,49,4,3,0,7
142479,2022,Belgium,Serbia,1,1,16,18,1/6/2022,0,0,0,0,18,4,15,37,0,2,4,6,9,2,15,26,8,5,0,13
163056,2022,,,-,-,-,-,-,-,-,-,-,-,-,-,-,-,-,-,-,-,-,-,-,-,-,-,-
153452,2022,,,-,-,-,-,-,-,-,-,-,-,-,-,-,-,-,-,-,-,-,-,-,-,-,-,-
173974,2022,,,-,-,-,-,-,-,-,-,-,-,-,-,-,-,-,-,-,-,-,-,-,-,-,-,-
163967,2022,Japan,Serbia,0,0,0,0,2/7/2022,0,0,0,0,0,0,0,0,0,0,0,0,0,0,0,0,0,0,0,0
163967,2022,Serbia,Canada,0,0,0,0,2/7/2022,0,0,0,0,0,0,0,0,0,0,0,0,0,0,0,0,0,0,0,0
163967,2022,USA,Serbia,0,0,0,0,1/7/2022,0,0,0,0,0,0,0,0,0,0,0,0,0,0,0,0,0,0,0,0
163967,2022,Serbia,Germany,0,0,0,0,28/06/2022,0,0,0,0,0,0,0,0,0,0,0,0,0,0,0,0,0,0,0,0
163967,2022,Brazil,Serbia,0,0,0,0,19/06/2022,0,0,0,0,0,0,0,0,0,0,0,0,0,0,0,0,0,0,0,0
163967,2022,Serbia,Türkiye,0,0,0,0,17/06/2022,0,0,0,0,0,0,0,0,0,0,0,0,0,0,0,0,0,0,0,0
163967,2022,Serbia,Korea,0,0,0,0,16/06/2022,0,0,0,0,0,0,0,0,0,0,0,0,0,0,0,0,0,0,0,0
163967,2022,Serbia,Italy,0,0,0,0,15/06/2022,0,0,0,0,0,0,0,0,0,0,0,0,0,0,0,0,0,0,0,0
163967,2022,Serbia,Netherlands,0,0,0,0,5/6/2022,0,0,0,0,0,0,0,0,0,0,0,0,0,0,0,0,0,0,0,0
163967,2022,Serbia,Bulgaria,0,0,0,0,3/6/2022,0,0,0,0,0,0,0,0,0,0,0,0,0,0,0,0,0,0,0,0
163967,2022,Thailand,Serbia,0,0,0,0,2/6/2022,0,0,0,0,0,0,0,0,0,0,0,0,0,0,0,0,0,0,0,0
163967,2022,Belgium,Serbia,0,0,0,0,1/6/2022,0,0,0,0,0,0,0,0,0,0,0,0,0,0,0,0,0,0,0,0
163117,2022,Türkiye,Serbia,0,0,0,0,17/07/2022,0,0,0,0,0,0,0,0,0,0,0,0,0,0,0,0,0,0,0,0
163117,2022,Serbia,Brazil,0,0,0,0,16/07/2022,0,0,0,0,0,0,0,0,0,0,0,0,0,0,0,0,0,0,0,0
163117,2022,USA,Serbia,0,0,0,0,13/07/2022,0,0,0,0,0,0,0,0,0,0,0,0,0,0,0,0,0,0,0,0
163117,2022,Japan,Serbia,0,0,0,0,2/7/2022,0,0,0,0,0,0,0,0,0,0,0,0,0,0,0,0,0,0,0,0
163117,2022,Serbia,Canada,0,0,0,0,2/7/2022,0,0,0,0,0,0,0,0,0,0,0,0,0,0,0,0,0,0,0,0
163117,2022,USA,Serbia,0,0,0,0,1/7/2022,0,0,0,0,0,0,0,0,0,0,0,0,0,0,0,0,0,0,0,0
163117,2022,Serbia,Germany,0,0,0,0,28/06/2022,0,0,0,0,0,0,0,0,0,0,0,0,0,0,0,0,0,0,0,0
163117,2022,Brazil,Serbia,0,0,0,0,19/06/2022,0,0,0,0,0,0,0,0,0,0,0,0,0,0,0,0,0,0,0,0
163117,2022,Serbia,Türkiye,0,0,0,0,17/06/2022,0,0,0,0,0,0,0,0,0,0,0,0,0,0,0,0,0,0,0,0
163117,2022,Serbia,Korea,0,0,0,0,16/06/2022,0,0,0,0,0,0,0,0,0,0,0,0,0,0,0,0,0,0,0,0
163117,2022,Serbia,Italy,0,0,0,0,15/06/2022,0,0,0,0,0,0,0,0,0,0,0,0,0,0,0,0,0,0,0,0
163117,2022,Serbia,Netherlands,0,0,0,0,5/6/2022,0,0,0,0,0,0,0,0,0,0,0,0,0,0,0,0,0,0,0,0
163117,2022,Serbia,Bulgaria,0,0,0,0,3/6/2022,0,0,0,0,0,0,0,0,0,0,0,0,0,0,0,0,0,0,0,0
163117,2022,Thailand,Serbia,0,0,0,0,2/6/2022,0,0,0,0,0,0,0,0,0,0,0,0,0,0,0,0,0,0,0,0
163117,2022,Belgium,Serbia,0,0,0,0,1/6/2022,0,0,0,0,0,0,0,0,0,0,0,0,0,0,0,0,0,0,0,0
173979,2022,,,-,-,-,-,-,-,-,-,-,-,-,-,-,-,-,-,-,-,-,-,-,-,-,-,-
163119,2022,Japan,Serbia,0,0,8,8,2/7/2022,0,1,1,2,8,2,8,18,0,0,1,1,0,0,0,0,11,3,0,14
163119,2022,Serbia,Canada,0,1,5,6,2/7/2022,0,0,0,0,0,0,0,0,0,0,0,0,0,0,0,0,0,0,0,0
163119,2022,USA,Serbia,1,0,2,3,1/7/2022,0,0,0,0,0,0,0,0,0,0,0,0,0,0,0,0,0,0,0,0
163119,2022,Serbia,Germany,0,0,4,4,28/06/2022,0,0,0,0,0,0,0,0,0,0,0,0,0,0,0,0,0,0,0,0
163119,2022,Brazil,Serbia,0,0,0,0,19/06/2022,0,0,0,0,0,0,1,1,0,1,0,1,0,0,0,0,0,0,0,0
163119,2022,Serbia,Türkiye,0,0,1,1,17/06/2022,0,0,0,0,1,0,3,4,0,0,0,0,0,0,0,0,0,0,1,1
163119,2022,Serbia,Korea,0,0,0,0,16/06/2022,0,0,0,0,1,0,1,2,0,0,0,0,0,0,0,0,0,0,0,0
163119,2022,Serbia,Italy,0,0,0,0,15/06/2022,0,0,0,0,0,1,3,4,0,0,0,0,0,0,0,0,0,0,0,0
163119,2022,Serbia,Netherlands,0,0,0,0,5/6/2022,0,0,0,0,0,0,0,0,0,0,0,0,0,0,1,1,0,0,0,0
163119,2022,Serbia,Bulgaria,0,0,2,2,3/6/2022,0,0,0,0,1,0,1,2,0,1,1,2,0,0,2,2,0,1,0,1
163119,2022,Thailand,Serbia,1,0,4,5,2/6/2022,0,0,0,0,4,0,4,8,1,0,0,1,2,0,12,14,1,2,0,3
163119,2022,Belgium,Serbia,0,0,0,0,1/6/2022,0,0,0,0,0,0,0,0,0,0,0,0,0,0,0,0,0,0,0,0
173179,2022,Japan,Serbia,0,1,5,6,2/7/2022,0,0,1,1,4,3,10,17,0,1,3,4,0,0,0,0,3,0,1,4
173179,2022,Serbia,Canada,0,0,0,0,2/7/2022,0,0,0,0,0,0,0,0,0,0,0,0,0,0,0,0,0,0,0,0
173179,2022,USA,Serbia,0,1,0,1,1/7/2022,0,0,0,0,2,0,2,4,0,0,0,0,0,0,0,0,0,0,0,0
173179,2022,Serbia,Germany,0,0,0,0,28/06/2022,0,0,0,0,1,0,1,2,0,0,0,0,0,0,0,0,0,0,0,0
151120,2022,Thailand,USA,0,0,0,0,19/06/2022,0,0,0,0,0,0,0,0,0,0,0,0,0,0,0,0,0,0,0,0
151120,2022,Japan,Thailand,0,0,0,0,17/06/2022,0,0,0,0,0,0,0,0,0,0,0,0,0,0,0,0,0,0,0,0
151120,2022,Poland,Thailand,0,0,3,3,16/06/2022,0,0,1,1,0,1,0,1,0,0,0,0,1,0,1,2,1,1,0,2
131866,2022,Türkiye,Thailand,0,0,0,0,14/07/2022,0,0,6,6,0,0,0,0,0,0,0,0,5,1,10,16,2,1,4,7
131866,2022,Thailand,Italy,0,0,0,0,3/7/2022,0,0,2,2,0,0,0,0,0,0,0,0,5,0,2,7,2,1,0,3
131866,2022,Brazil,Thailand,0,0,0,0,2/7/2022,0,0,5,5,0,0,0,0,0,0,0,0,6,0,9,15,7,3,6,16
131866,2022,Thailand,Dominican Republic,0,0,0,0,30/06/2022,6,0,0,6,0,0,0,0,0,0,0,0,5,1,9,15,5,1,7,13
131866,2022,Thailand,Korea,0,0,0,0,29/06/2022,1,0,0,1,0,0,0,0,0,0,0,0,1,0,10,11,3,0,0,3
131866,2022,Thailand,USA,0,0,0,0,19/06/2022,1,1,12,14,0,0,0,0,0,0,0,0,4,1,12,17,7,3,2,12
131866,2022,Japan,Thailand,0,0,0,0,17/06/2022,0,2,8,10,0,0,0,0,0,0,0,0,2,0,2,4,6,0,1,7
131866,2022,Thailand,China,0,0,0,0,5/6/2022,2,1,7,10,0,0,0,0,0,0,0,0,11,1,10,22,6,1,3,10
131866,2022,Thailand,Belgium,0,0,0,0,4/6/2022,9,1,6,16,0,0,0,0,0,0,0,0,4,1,11,16,12,2,4,18
131866,2022,Thailand,Serbia,0,0,0,0,2/6/2022,0,0,4,4,0,0,0,0,0,0,0,0,8,1,9,18,9,3,4,16
131866,2022,Thailand,Bulgaria,0,0,0,0,31/05/2022,0,0,2,2,0,0,0,0,0,0,0,0,4,0,9,13,3,1,1,5
123019,2022,Türkiye,Thailand,0,1,8,9,14/07/2022,28,0,74,102,2,0,1,3,2,1,3,6,0,1,0,1,4,6,3,13
123019,2022,Thailand,Italy,0,0,8,8,3/7/2022,7,1,70,78,0,0,0,0,0,0,0,0,0,0,1,1,1,1,1,3
123019,2022,Brazil,Thailand,0,1,13,14,2/7/2022,19,2,108,129,1,0,2,3,1,7,4,12,0,0,0,0,3,1,0,4
123019,2022,Thailand,Dominican Republic,0,2,6,8,30/06/2022,93,0,1,94,0,1,3,4,0,6,1,7,0,0,0,0,6,4,6,16
123019,2022,Thailand,Korea,0,1,16,17,29/06/2022,66,0,2,68,3,0,0,3,2,0,4,6,0,0,0,0,3,0,1,4
123019,2022,Thailand,USA,1,0,10,11,19/06/2022,22,0,85,107,2,0,0,2,0,4,3,7,0,0,1,1,14,3,2,19
123019,2022,Japan,Thailand,0,1,8,9,17/06/2022,31,2,56,89,1,0,2,3,1,3,5,9,0,0,0,0,4,5,1,10
123019,2022,Poland,Thailand,1,0,21,22,16/06/2022,19,1,97,117,0,1,3,4,0,2,6,8,0,0,0,0,10,2,0,12
123019,2022,Canada,Thailand,0,0,5,5,14/06/2022,6,0,11,17,0,0,0,0,0,0,0,0,0,0,0,0,0,1,0,1
123019,2022,Thailand,China,0,2,9,11,5/6/2022,64,2,42,108,1,0,2,3,0,2,2,4,0,0,0,0,8,5,2,15
123019,2022,Thailand,Belgium,0,1,16,17,4/6/2022,80,1,52,133,3,0,0,3,0,1,6,7,0,1,0,1,6,0,3,9
123019,2022,Thailand,Serbia,2,0,14,16,2/6/2022,40,0,117,157,0,1,2,3,1,1,2,4,0,0,0,0,1,4,3,8
123019,2022,Thailand,Bulgaria,0,2,8,10,31/05/2022,28,0,53,81,0,0,2,2,1,3,4,8,0,0,0,0,3,2,2,7
142172,2022,Thailand,Belgium,0,2,1,3,4/6/2022,0,0,0,0,1,0,2,3,0,1,2,3,0,0,0,0,3,0,0,3
142172,2022,Thailand,Serbia,1,1,18,20,2/6/2022,0,0,2,2,6,2,4,12,3,6,2,11,0,0,0,0,0,1,1,2
142172,2022,Thailand,Bulgaria,0,1,9,10,31/05/2022,0,0,0,0,5,0,1,6,0,3,2,5,0,0,1,1,1,1,0,2
147187,2022,Thailand,USA,0,0,0,0,19/06/2022,0,0,0,0,0,0,0,0,0,0,0,0,0,0,0,0,0,0,0,0
147187,2022,Japan,Thailand,0,0,0,0,17/06/2022,0,0,0,0,0,0,0,0,0,0,0,0,0,0,0,0,0,0,0,0
147187,2022,Poland,Thailand,0,0,2,2,16/06/2022,0,0,0,0,1,0,1,2,1,0,0,1,0,0,0,0,1,1,0,2
143051,2022,,,-,-,-,-,-,-,-,-,-,-,-,-,-,-,-,-,-,-,-,-,-,-,-,-,-
142178,2022,,,-,-,-,-,-,-,-,-,-,-,-,-,-,-,-,-,-,-,-,-,-,-,-,-,-
143002,2022,Türkiye,Thailand,0,1,9,10,14/07/2022,0,1,1,2,0,1,1,2,0,5,3,8,0,0,0,0,1,1,0,2
143002,2022,Thailand,Italy,0,0,4,4,3/7/2022,0,0,0,0,1,0,1,2,0,0,0,0,0,0,0,0,0,0,0,0
143002,2022,Brazil,Thailand,0,1,1,2,2/7/2022,0,0,0,0,1,2,0,3,0,1,0,1,0,0,0,0,0,0,0,0
143002,2022,Thailand,Dominican Republic,1,1,15,17,30/06/2022,1,0,1,2,4,0,1,5,2,2,2,6,1,0,0,1,0,1,0,1
143002,2022,Thailand,Korea,0,0,12,12,29/06/2022,0,0,0,0,4,2,1,7,2,3,2,7,0,0,1,1,1,0,0,1
143002,2022,Thailand,USA,0,0,17,17,19/06/2022,0,0,4,4,0,2,7,9,0,6,2,8,0,0,0,0,2,1,1,4
143002,2022,Japan,Thailand,0,0,10,10,17/06/2022,0,0,1,1,5,1,2,8,0,5,4,9,0,0,1,1,0,0,0,0
143002,2022,Poland,Thailand,2,0,16,18,16/06/2022,0,0,1,1,4,1,3,8,3,4,5,12,0,2,0,2,1,0,1,2
152206,2022,,,-,-,-,-,-,-,-,-,-,-,-,-,-,-,-,-,-,-,-,-,-,-,-,-,-
142180,2022,Thailand,USA,0,0,0,0,19/06/2022,0,0,0,0,0,0,0,0,0,0,0,0,0,0,0,0,0,0,0,0
142180,2022,Japan,Thailand,0,0,0,0,17/06/2022,0,0,0,0,0,1,2,3,0,0,0,0,0,0,0,0,1,0,0,1
142180,2022,Poland,Thailand,0,0,0,0,16/06/2022,0,0,1,1,0,0,0,0,0,0,0,0,0,0,1,1,1,0,1,2
145244,2022,Türkiye,Thailand,1,3,8,12,14/07/2022,0,0,0,0,4,2,4,10,1,4,4,9,0,0,0,0,4,0,3,7
145244,2022,Thailand,Italy,0,0,10,10,3/7/2022,0,0,0,0,5,1,7,13,0,3,3,6,0,0,0,0,3,0,1,4
145244,2022,Brazil,Thailand,0,2,13,15,2/7/2022,0,0,0,0,8,2,6,16,2,5,6,13,0,0,0,0,1,1,1,3
145244,2022,Thailand,Dominican Republic,0,1,9,10,30/06/2022,0,1,0,1,3,1,4,8,2,11,2,15,0,0,0,0,2,0,2,4
145244,2022,Thailand,Korea,0,2,9,11,29/06/2022,2,0,0,2,3,0,2,5,2,3,2,7,0,0,0,0,1,1,0,2
145244,2022,Canada,Thailand,0,1,9,10,14/06/2022,0,0,2,2,4,0,4,8,1,2,3,6,0,0,0,0,4,0,0,4
145244,2022,Thailand,China,1,1,14,16,5/6/2022,1,0,1,2,2,0,4,6,1,8,6,15,0,0,2,2,6,0,3,9
145244,2022,Thailand,Belgium,0,0,20,20,4/6/2022,0,0,2,2,5,2,5,12,3,7,10,20,0,0,1,1,7,1,2,10
145244,2022,Thailand,Serbia,0,2,11,13,2/6/2022,0,0,0,0,9,1,13,23,1,2,8,11,1,0,1,2,3,3,1,7
145244,2022,Thailand,Bulgaria,1,1,9,11,31/05/2022,0,0,0,0,7,2,2,11,1,4,3,8,1,0,0,1,0,1,1,2
152179,2022,Canada,Thailand,0,0,0,0,14/06/2022,0,0,0,0,0,0,0,0,0,0,0,0,0,0,0,0,0,0,0,0
122866,2022,Türkiye,Thailand,0,0,0,0,14/07/2022,0,0,0,0,0,0,0,0,0,0,0,0,0,0,0,0,0,0,0,0
122866,2022,Thailand,Italy,0,0,1,1,3/7/2022,0,0,0,0,0,0,1,1,0,0,0,0,0,0,0,0,1,1,1,3
122866,2022,Brazil,Thailand,0,0,0,0,2/7/2022,0,0,0,0,0,0,0,0,0,0,0,0,0,0,0,0,0,0,0,0
122866,2022,Thailand,Dominican Republic,0,1,1,2,30/06/2022,0,0,0,0,0,0,0,0,0,0,0,0,1,0,1,2,1,1,3,5
122866,2022,Thailand,Korea,0,0,0,0,29/06/2022,0,0,0,0,0,0,0,0,0,0,0,0,0,0,0,0,0,0,0,0
122866,2022,Thailand,China,0,0,0,0,5/6/2022,0,0,0,0,0,0,0,0,0,0,0,0,0,0,0,0,0,0,0,0
122866,2022,Thailand,Belgium,0,0,1,1,4/6/2022,0,0,2,2,0,0,0,0,0,0,0,0,0,0,1,1,1,0,0,1
122866,2022,Thailand,Serbia,0,0,0,0,2/6/2022,0,0,0,0,0,0,0,0,0,0,0,0,0,0,3,3,0,0,0,0
122866,2022,Thailand,Bulgaria,0,0,0,0,31/05/2022,0,0,0,0,0,0,0,0,0,0,0,0,0,0,0,0,0,0,0,0
142185,2022,Türkiye,Thailand,0,0,3,3,14/07/2022,0,0,0,0,0,0,2,2,0,3,1,4,1,0,0,1,1,2,0,3
142185,2022,Thailand,Italy,0,0,3,3,3/7/2022,0,0,0,0,2,0,1,3,0,0,0,0,0,0,0,0,1,0,0,1
142185,2022,Brazil,Thailand,1,2,9,12,2/7/2022,0,0,0,0,5,0,3,8,1,3,3,7,0,0,0,0,2,1,1,4
142185,2022,Thailand,Dominican Republic,0,0,0,0,30/06/2022,0,0,0,0,0,0,0,0,0,0,0,0,0,0,0,0,0,0,0,0
142185,2022,Thailand,Korea,0,0,0,0,29/06/2022,0,0,0,0,0,0,0,0,0,0,0,0,0,0,0,0,0,0,0,0
142185,2022,Thailand,USA,0,2,7,9,19/06/2022,1,0,0,1,3,0,5,8,0,3,7,10,1,0,0,1,2,0,2,4
142185,2022,Japan,Thailand,0,0,8,8,17/06/2022,1,0,0,1,3,0,14,17,1,3,10,14,1,0,1,2,6,0,0,6
142185,2022,Poland,Thailand,0,2,11,13,16/06/2022,1,0,3,4,1,2,6,9,0,11,13,24,0,0,1,1,2,2,1,5
142185,2022,Canada,Thailand,0,0,14,14,14/06/2022,0,0,0,0,0,1,1,2,0,4,3,7,0,0,0,0,2,0,0,2
142185,2022,Thailand,China,0,1,18,19,5/6/2022,2,0,2,4,1,0,4,5,2,4,8,14,0,2,1,3,1,3,4,8
142185,2022,Thailand,Belgium,0,1,4,5,4/6/2022,0,0,2,2,0,0,4,4,0,2,2,4,0,0,0,0,0,0,1,1
142185,2022,Thailand,Serbia,0,0,0,0,2/6/2022,0,0,0,0,0,0,0,0,0,0,0,0,0,0,0,0,0,0,0,0
142185,2022,Thailand,Bulgaria,0,0,0,0,31/05/2022,0,0,0,0,0,0,0,0,0,0,0,0,0,0,0,0,0,0,0,0
151121,2022,Türkiye,Thailand,1,1,12,14,14/07/2022,0,0,2,2,8,5,12,25,1,0,1,2,0,0,0,0,5,6,3,14
151121,2022,Thailand,Italy,0,1,4,5,3/7/2022,0,0,2,2,8,7,14,29,0,0,0,0,0,0,1,1,3,0,2,5
151121,2022,Brazil,Thailand,0,0,16,16,2/7/2022,0,1,0,1,22,7,16,45,1,5,0,6,0,0,0,0,4,0,2,6
151121,2022,Thailand,Dominican Republic,3,1,17,21,30/06/2022,2,2,1,5,26,4,17,47,1,3,2,6,0,0,0,0,4,1,3,8
151121,2022,Thailand,Korea,0,0,11,11,29/06/2022,1,0,0,1,7,2,11,20,4,2,3,9,0,0,0,0,3,1,0,4
151121,2022,Thailand,USA,0,0,11,11,19/06/2022,0,0,0,0,8,8,15,31,0,4,2,6,1,0,6,7,8,1,3,12
151121,2022,Japan,Thailand,0,1,9,10,17/06/2022,0,0,1,1,8,6,15,29,0,3,3,6,3,0,3,6,14,1,1,16
151121,2022,Poland,Thailand,1,2,12,15,16/06/2022,0,1,2,3,12,3,15,30,0,1,7,8,0,0,0,0,12,0,1,13
151121,2022,Canada,Thailand,1,0,14,15,14/06/2022,0,0,2,2,19,1,13,33,0,2,4,6,0,0,0,0,4,1,2,7
151121,2022,Thailand,China,1,3,10,14,5/6/2022,2,0,1,3,27,5,23,55,1,2,6,9,3,0,4,7,6,0,2,8
151121,2022,Thailand,Belgium,1,1,19,21,4/6/2022,1,0,2,3,21,9,21,51,2,1,2,5,0,0,0,0,15,3,3,21
151121,2022,Thailand,Serbia,1,0,17,18,2/6/2022,0,0,0,0,31,7,19,57,0,2,4,6,0,0,2,2,6,3,5,14
151121,2022,Thailand,Bulgaria,3,2,16,21,31/05/2022,0,0,0,0,7,2,12,21,2,0,6,8,0,0,0,0,7,6,2,15
143053,2022,Türkiye,Thailand,0,0,0,0,14/07/2022,0,0,0,0,0,0,0,0,0,0,0,0,0,0,0,0,0,0,0,0
143053,2022,Thailand,USA,0,0,0,0,19/06/2022,0,0,0,0,0,0,0,0,0,0,0,0,0,0,0,0,0,0,0,0
143053,2022,Japan,Thailand,0,0,0,0,17/06/2022,3,0,4,7,0,0,0,0,0,0,0,0,0,0,0,0,0,0,0,0
143053,2022,Poland,Thailand,0,0,0,0,16/06/2022,0,0,0,0,0,0,0,0,0,0,0,0,0,0,0,0,0,0,0,0
143053,2022,Thailand,China,0,1,0,1,5/6/2022,4,0,5,9,0,0,0,0,0,1,0,1,0,0,0,0,1,0,0,1
143053,2022,Thailand,Belgium,0,0,0,0,4/6/2022,4,0,4,8,0,0,0,0,0,0,0,0,0,0,0,0,0,0,0,0
143053,2022,Thailand,Serbia,0,1,0,1,2/6/2022,0,0,0,0,0,0,0,0,0,0,0,0,0,0,0,0,0,0,0,0
143053,2022,Thailand,Bulgaria,0,0,0,0,31/05/2022,0,0,0,0,0,0,0,0,0,0,0,0,0,0,0,0,0,0,0,0
133511,2022,Türkiye,Thailand,1,0,18,19,14/07/2022,0,0,1,1,20,6,18,44,0,2,3,5,1,1,14,16,5,2,5,12
133511,2022,Thailand,Italy,0,0,6,6,3/7/2022,0,0,1,1,4,1,15,20,0,2,0,2,2,1,12,15,5,1,1,7
133511,2022,Brazil,Thailand,2,0,12,14,2/7/2022,0,0,1,1,14,6,19,39,0,0,0,0,13,0,31,44,9,1,2,12
133511,2022,Thailand,Dominican Republic,0,1,9,10,30/06/2022,1,0,0,1,14,4,17,35,1,2,1,4,5,3,19,27,7,1,3,11
133511,2022,Thailand,Korea,0,1,7,8,29/06/2022,1,0,0,1,11,3,12,26,2,3,3,8,0,0,11,11,7,3,1,11
133511,2022,Thailand,USA,0,0,10,10,19/06/2022,0,0,0,0,24,7,21,52,1,1,6,8,3,1,12,16,11,3,3,17
133511,2022,Japan,Thailand,0,1,7,8,17/06/2022,0,0,1,1,8,2,21,31,2,0,1,3,6,0,9,15,9,7,1,17
133511,2022,Poland,Thailand,0,0,8,8,16/06/2022,0,0,5,5,9,7,24,40,0,0,2,2,6,0,9,15,15,2,4,21
133511,2022,Canada,Thailand,0,2,10,12,14/06/2022,0,0,0,0,6,3,18,27,1,2,1,4,8,2,13,23,5,2,0,7
133511,2022,Thailand,China,0,0,5,5,5/6/2022,1,0,0,1,8,1,7,16,0,1,2,3,1,0,11,12,6,0,1,7
133511,2022,Thailand,Belgium,0,2,14,16,4/6/2022,2,0,1,3,16,3,21,40,0,2,6,8,8,2,21,31,21,2,0,23
133511,2022,Thailand,Serbia,0,1,24,25,2/6/2022,0,0,0,0,11,9,17,37,3,3,3,9,12,5,43,60,9,1,0,10
133511,2022,Thailand,Bulgaria,1,1,11,13,31/05/2022,0,0,0,0,17,2,13,32,2,4,1,7,2,1,10,13,7,3,0,10
147213,2022,Türkiye,Thailand,0,3,8,11,14/07/2022,0,0,0,0,16,8,14,38,0,2,1,3,17,3,31,51,6,3,3,12
147213,2022,Thailand,Italy,0,2,4,6,3/7/2022,0,0,0,0,10,4,6,20,0,3,0,3,7,5,22,34,6,2,3,11
147213,2022,Brazil,Thailand,0,4,11,15,2/7/2022,0,0,0,0,12,4,13,29,2,1,1,4,12,1,22,35,14,2,2,18
147213,2022,Thailand,Dominican Republic,2,3,15,20,30/06/2022,3,0,1,4,7,4,19,30,0,2,0,2,9,0,31,40,7,3,1,11
147213,2022,Thailand,Korea,1,2,12,15,29/06/2022,3,0,1,4,8,3,9,20,5,4,1,10,6,1,13,20,4,0,1,5
147213,2022,Thailand,USA,2,2,18,22,19/06/2022,0,1,4,5,10,3,22,35,1,4,1,6,12,3,22,37,12,3,2,17
147213,2022,Japan,Thailand,0,3,5,8,17/06/2022,0,0,2,2,9,3,13,25,2,1,2,5,13,0,25,38,10,3,0,13
147213,2022,Poland,Thailand,1,3,11,15,16/06/2022,0,0,2,2,20,5,27,52,5,4,3,12,15,2,42,59,11,1,3,15
147213,2022,Canada,Thailand,2,3,9,14,14/06/2022,0,0,1,1,16,2,14,32,0,2,1,3,5,2,15,22,5,1,2,8
147213,2022,Thailand,China,0,2,15,17,5/6/2022,2,0,5,7,16,5,18,39,2,2,4,8,8,2,33,43,11,3,3,17
147213,2022,Thailand,Belgium,1,1,14,16,4/6/2022,0,0,1,1,21,7,23,51,6,3,4,13,12,2,33,47,13,5,0,18
147213,2022,Thailand,Serbia,0,2,15,17,2/6/2022,0,0,1,1,24,4,21,49,4,4,2,10,4,2,10,16,8,3,3,14
147213,2022,Thailand,Bulgaria,0,1,7,8,31/05/2022,0,0,1,1,11,3,10,24,2,2,0,4,5,0,20,25,8,4,2,14
162681,2022,Türkiye,Thailand,0,0,0,0,14/07/2022,0,0,5,5,0,0,0,0,0,0,0,0,0,0,0,0,7,9,3,19
162681,2022,Thailand,Italy,0,0,0,0,3/7/2022,0,0,0,0,0,0,0,0,0,0,0,0,0,0,0,0,1,3,0,4
162681,2022,Brazil,Thailand,0,0,0,0,2/7/2022,0,0,1,1,0,0,0,0,0,0,0,0,0,0,0,0,1,2,1,4
162681,2022,Thailand,Dominican Republic,0,0,0,0,30/06/2022,3,0,0,3,0,0,0,0,0,0,0,0,0,0,0,0,11,1,0,12
162681,2022,Thailand,Korea,0,0,0,0,29/06/2022,0,0,1,1,0,0,0,0,0,0,0,0,0,0,0,0,5,2,3,10
162681,2022,Thailand,China,0,0,0,0,5/6/2022,1,0,0,1,0,0,0,0,0,0,0,0,0,0,0,0,7,1,1,9
162681,2022,Thailand,Belgium,0,0,0,0,4/6/2022,0,0,0,0,0,0,0,0,0,0,0,0,0,0,0,0,2,2,0,4
162681,2022,Thailand,Serbia,0,0,0,0,2/6/2022,0,0,0,0,0,0,0,0,0,0,0,0,0,0,0,0,3,1,0,4
162681,2022,Thailand,Bulgaria,0,0,0,0,31/05/2022,0,0,4,4,0,0,0,0,0,0,0,0,0,0,0,0,7,6,1,14
152205,2022,Türkiye,Thailand,0,0,1,1,14/07/2022,0,0,0,0,1,0,0,1,0,0,0,0,0,0,0,0,0,0,0,0
152205,2022,Thailand,Italy,0,0,1,1,3/7/2022,0,0,0,0,2,0,1,3,0,1,0,1,0,0,0,0,0,0,0,0
152205,2022,Brazil,Thailand,0,1,0,1,2/7/2022,0,0,1,1,0,2,0,2,0,0,0,0,0,0,0,0,0,0,0,0
152205,2022,Thailand,Dominican Republic,0,0,2,2,30/06/2022,1,0,0,1,2,0,1,3,0,1,0,1,0,0,0,0,0,1,0,1
152205,2022,Thailand,Korea,0,0,0,0,29/06/2022,0,0,0,0,0,0,0,0,0,0,0,0,0,0,0,0,0,0,0,0
152205,2022,Thailand,USA,0,0,0,0,19/06/2022,0,0,0,0,0,0,0,0,0,0,0,0,0,0,0,0,0,0,0,0
152205,2022,Japan,Thailand,0,1,0,1,17/06/2022,0,0,0,0,0,0,2,2,0,1,0,1,0,0,0,0,0,0,0,0
152205,2022,Poland,Thailand,0,1,2,3,16/06/2022,0,0,2,2,5,4,4,13,0,1,0,1,0,0,1,1,2,2,0,4
152205,2022,Canada,Thailand,0,0,0,0,14/06/2022,0,0,0,0,0,0,1,1,0,0,0,0,0,0,0,0,0,0,0,0
152205,2022,Thailand,China,0,0,0,0,5/6/2022,0,0,0,0,2,0,0,2,0,1,0,1,0,0,1,1,0,0,0,0
152205,2022,Thailand,Belgium,0,1,0,1,4/6/2022,1,0,0,1,2,0,1,3,0,0,2,2,0,0,0,0,0,0,0,0
152205,2022,Thailand,Serbia,0,0,0,0,2/6/2022,0,0,0,0,0,0,0,0,0,0,0,0,0,0,0,0,0,0,0,0
152205,2022,Thailand,Bulgaria,0,0,0,0,31/05/2022,0,0,0,0,0,0,0,0,0,0,0,0,0,0,0,0,0,0,0,0
148711,2022,Thailand,USA,0,0,0,0,19/06/2022,0,0,7,7,0,0,0,0,0,0,0,0,0,0,0,0,9,1,1,11
148711,2022,Japan,Thailand,0,0,0,0,17/06/2022,0,0,4,4,0,0,0,0,0,0,0,0,0,0,0,0,3,0,1,4
148711,2022,Poland,Thailand,0,0,0,0,16/06/2022,0,0,11,11,0,0,0,0,0,0,0,0,1,3,12,16,11,3,3,17
148711,2022,Canada,Thailand,0,0,0,0,14/06/2022,1,0,5,6,0,0,0,0,0,0,0,0,2,1,5,8,5,0,1,6
181410,2022,Türkiye,Thailand,0,0,0,0,14/07/2022,0,0,3,3,0,0,0,0,0,0,0,0,0,0,0,0,0,1,0,1
181410,2022,Thailand,Italy,0,0,2,2,3/7/2022,1,0,13,14,0,0,0,0,0,0,0,0,0,0,0,0,1,0,0,1
181410,2022,Brazil,Thailand,1,0,1,2,2/7/2022,0,0,2,2,0,0,0,0,0,0,0,0,0,0,0,0,0,0,0,0
181410,2022,Thailand,Dominican Republic,0,0,1,1,30/06/2022,4,0,0,4,0,0,0,0,0,0,0,0,0,0,0,0,0,0,0,0
181410,2022,Thailand,Korea,0,0,0,0,29/06/2022,0,0,0,0,0,0,0,0,0,0,0,0,0,0,0,0,0,0,0,0
181410,2022,Thailand,USA,0,0,0,0,19/06/2022,0,0,1,1,0,0,0,0,0,0,0,0,0,0,0,0,0,0,1,1
181410,2022,Poland,Thailand,0,0,0,0,16/06/2022,1,0,5,6,0,0,0,0,0,0,0,0,0,0,0,0,2,0,0,2
181410,2022,Canada,Thailand,0,0,6,6,14/06/2022,12,2,60,74,0,0,0,0,0,2,3,5,0,1,0,1,4,3,1,8
163495,2022,Thailand,Italy,0,0,3,3,3/7/2022,0,0,0,0,0,0,2,2,0,1,1,2,0,0,0,0,1,1,0,2
163495,2022,Brazil,Thailand,0,0,0,0,2/7/2022,0,0,0,0,0,0,0,0,0,0,0,0,0,0,0,0,0,0,0,0
163495,2022,Thailand,Dominican Republic,0,1,1,2,30/06/2022,1,0,0,1,0,0,0,0,0,0,0,0,0,0,0,0,0,0,0,0
163495,2022,Thailand,Korea,0,0,0,0,29/06/2022,0,0,0,0,0,0,0,0,0,0,0,0,0,0,0,0,0,0,0,0
163495,2022,Canada,Thailand,0,0,0,0,14/06/2022,0,0,0,0,0,0,0,0,0,0,0,0,0,0,0,0,0,0,0,0
163495,2022,Thailand,China,0,0,2,2,5/6/2022,0,0,0,0,1,1,2,4,0,1,0,1,0,0,0,0,1,0,0,1
163495,2022,Thailand,Belgium,0,1,5,6,4/6/2022,0,0,0,0,1,0,1,2,0,3,5,8,0,0,1,1,1,0,1,2
163495,2022,Thailand,Serbia,0,0,0,0,2/6/2022,0,0,0,0,0,0,0,0,0,0,0,0,0,0,0,0,0,0,0,0
163495,2022,Thailand,Bulgaria,0,0,0,0,31/05/2022,0,0,0,0,0,0,0,0,0,0,0,0,0,0,0,0,0,0,0,0
180383,2022,Türkiye,Thailand,0,0,1,1,14/07/2022,0,0,0,0,0,1,2,3,0,0,0,0,0,0,1,1,1,0,1,2
180383,2022,Thailand,Italy,0,0,1,1,3/7/2022,0,0,0,0,2,1,1,4,0,0,0,0,2,1,5,8,1,0,0,1
180383,2022,Brazil,Thailand,0,0,0,0,2/7/2022,0,0,0,0,0,0,0,0,0,0,0,0,0,0,0,0,0,0,0,0
180383,2022,Thailand,Dominican Republic,0,0,0,0,30/06/2022,0,0,0,0,0,0,0,0,0,0,0,0,0,0,0,0,0,0,0,0
180383,2022,Thailand,Korea,0,0,0,0,29/06/2022,0,0,0,0,0,0,0,0,0,0,0,0,0,0,0,0,0,0,0,0
180383,2022,Canada,Thailand,0,0,0,0,14/06/2022,0,0,0,0,0,0,0,0,0,0,0,0,0,0,0,0,0,0,0,0
180383,2022,Thailand,China,0,3,3,6,5/6/2022,2,0,2,4,6,2,8,16,0,1,1,2,3,2,10,15,3,5,3,11
180383,2022,Thailand,Belgium,0,0,0,0,4/6/2022,0,0,0,0,0,0,0,0,0,0,0,0,0,0,0,0,0,0,0,0
180383,2022,Thailand,Serbia,0,0,0,0,2/6/2022,0,0,0,0,0,0,0,0,0,0,0,0,0,0,0,0,0,0,0,0
180383,2022,Thailand,Bulgaria,0,0,0,0,31/05/2022,0,0,0,0,0,0,0,0,0,0,0,0,0,0,0,0,0,0,0,0
183330,2022,,,-,-,-,-,-,-,-,-,-,-,-,-,-,-,-,-,-,-,-,-,-,-,-,-,-
163178,2022,Türkiye,Serbia,0,0,0,0,17/07/2022,0,0,0,0,0,0,0,0,0,0,0,0,0,0,0,0,0,0,0,0
163178,2022,Türkiye,Italy,0,0,0,0,16/07/2022,0,0,0,0,0,0,0,0,0,0,0,0,0,0,0,0,0,0,0,0
163178,2022,Türkiye,Thailand,0,0,0,0,14/07/2022,0,0,0,0,0,0,0,0,0,0,0,0,0,0,0,0,0,0,0,0
163178,2022,Türkiye,Korea,0,0,4,4,19/06/2022,0,0,0,0,0,1,3,4,0,2,1,3,0,0,0,0,0,0,0,0
163178,2022,Germany,Türkiye,0,0,0,0,18/06/2022,0,0,0,0,0,0,0,0,0,0,0,0,0,0,0,0,0,0,0,0
163178,2022,Serbia,Türkiye,0,1,3,4,17/06/2022,0,0,1,1,0,0,1,1,2,5,4,11,0,0,0,0,0,1,0,1
163178,2022,Brazil,Türkiye,0,0,0,0,16/06/2022,0,0,0,0,0,0,0,0,0,0,0,0,0,0,0,0,0,0,0,0
163178,2022,Türkiye,Belgium,0,0,0,0,5/6/2022,0,0,0,0,0,0,0,0,0,0,0,0,0,0,0,0,0,0,0,0
163178,2022,Bulgaria,Türkiye,0,0,0,0,4/6/2022,0,0,0,0,0,0,0,0,0,0,0,0,0,0,0,0,0,0,0,0
163178,2022,Türkiye,China,0,0,0,0,3/6/2022,0,0,0,0,0,0,0,0,0,0,0,0,0,0,0,0,0,0,0,0
163178,2022,Türkiye,Italy,0,0,0,0,31/05/2022,0,0,0,0,0,0,0,0,0,0,0,0,0,0,0,0,0,0,0,0
158840,2022,Türkiye,Serbia,0,0,0,0,17/07/2022,0,0,10,10,0,0,0,0,0,0,0,0,5,0,4,9,6,4,0,10
158840,2022,Türkiye,Italy,0,0,0,0,16/07/2022,0,0,9,9,0,0,0,0,0,0,0,0,3,2,1,6,11,1,1,13
158840,2022,Türkiye,Thailand,0,0,0,0,14/07/2022,0,1,4,5,0,0,0,0,0,0,0,0,8,0,13,21,13,6,2,21
158840,2022,Türkiye,USA,0,0,0,0,2/7/2022,0,0,3,3,0,0,0,0,0,0,0,0,0,0,0,0,0,0,0,0
158840,2022,Türkiye,Japan,0,0,0,0,1/7/2022,0,0,7,7,0,0,0,0,0,0,0,0,24,1,8,33,7,2,0,9
158840,2022,Türkiye,Netherlands,0,0,0,0,30/06/2022,0,0,4,4,0,0,0,0,0,0,0,0,6,0,2,8,8,1,0,9
158840,2022,Canada,Türkiye,0,0,0,0,29/06/2022,0,0,2,2,0,0,0,0,0,0,0,0,8,0,6,14,6,1,0,7
158840,2022,Türkiye,Korea,0,0,0,0,19/06/2022,0,0,0,0,0,0,0,0,0,0,0,0,0,0,0,0,0,0,0,0
158840,2022,Germany,Türkiye,0,0,0,0,18/06/2022,0,0,4,4,0,0,0,0,0,0,0,0,5,2,6,13,10,2,2,14
158840,2022,Serbia,Türkiye,0,0,1,1,17/06/2022,0,0,0,0,0,0,0,0,0,0,0,0,3,0,0,3,1,1,1,3
158840,2022,Brazil,Türkiye,0,0,0,0,16/06/2022,0,0,0,0,0,0,0,0,0,0,0,0,0,0,0,0,0,0,0,0
158840,2022,Türkiye,Belgium,0,0,0,0,5/6/2022,0,1,10,11,0,0,0,0,0,0,0,0,5,1,9,15,15,1,5,21
158840,2022,Bulgaria,Türkiye,0,0,0,0,4/6/2022,0,0,0,0,0,0,0,0,0,0,0,0,0,0,0,0,0,0,0,0
158840,2022,Türkiye,China,0,0,0,0,3/6/2022,2,0,10,12,0,0,0,0,0,0,0,0,8,0,3,11,14,6,2,22
158840,2022,Türkiye,Italy,0,0,0,0,31/05/2022,0,0,6,6,0,0,0,0,0,0,0,0,3,0,7,10,7,2,2,11
143590,2022,Türkiye,Serbia,0,0,6,6,17/07/2022,6,0,51,57,0,0,1,1,0,3,1,4,0,0,0,0,5,0,0,5
143590,2022,Türkiye,Italy,0,1,9,10,16/07/2022,11,1,56,68,0,0,1,1,0,2,2,4,0,0,0,0,7,2,1,10
143590,2022,Türkiye,Thailand,1,3,10,14,14/07/2022,31,1,67,99,3,0,0,3,2,6,3,11,0,0,0,0,6,1,4,11
143590,2022,Türkiye,USA,0,2,20,22,2/7/2022,8,1,113,122,1,0,4,5,1,5,1,7,0,0,1,1,8,1,0,9
143590,2022,Türkiye,Japan,0,2,19,21,1/7/2022,7,1,104,112,1,1,1,3,2,1,0,3,0,0,0,0,8,1,0,9
143590,2022,Türkiye,Netherlands,1,0,12,13,30/06/2022,7,1,81,89,1,0,0,1,2,2,0,4,0,0,0,0,1,0,0,1
143590,2022,Canada,Türkiye,0,0,9,9,29/06/2022,0,0,78,78,0,0,0,0,1,3,1,5,0,0,0,0,7,1,0,8
143590,2022,Türkiye,Korea,2,0,9,11,19/06/2022,18,0,65,83,0,0,0,0,1,2,1,4,0,0,0,0,4,1,0,5
143590,2022,Germany,Türkiye,1,2,22,25,18/06/2022,26,0,51,77,3,0,1,4,0,3,3,6,0,0,0,0,4,1,1,6
143590,2022,Serbia,Türkiye,1,1,13,15,17/06/2022,14,3,120,137,1,0,0,1,2,1,6,9,0,0,1,1,7,1,2,10
143590,2022,Brazil,Türkiye,0,1,11,12,16/06/2022,22,0,77,99,0,0,0,0,3,4,0,7,0,0,1,1,3,0,0,3
143590,2022,Türkiye,Belgium,1,0,13,14,5/6/2022,36,0,61,97,0,1,3,4,5,4,4,13,0,0,0,0,8,2,3,13
143590,2022,Bulgaria,Türkiye,0,0,10,10,4/6/2022,29,1,40,70,0,1,2,3,0,1,3,4,0,0,0,0,6,1,1,8
143590,2022,Türkiye,China,0,1,7,8,3/6/2022,25,0,40,65,0,0,1,1,1,0,1,2,0,0,0,0,4,2,2,8
143590,2022,Türkiye,Italy,0,2,6,8,31/05/2022,14,1,58,73,1,0,2,3,0,4,1,5,0,0,0,0,6,0,1,7
152311,2022,Türkiye,Serbia,0,0,8,8,17/07/2022,0,0,0,0,5,6,6,17,0,0,2,2,2,0,21,23,9,3,0,12
152311,2022,Türkiye,Italy,0,0,0,0,16/07/2022,0,0,0,0,0,0,0,0,0,0,0,0,0,0,0,0,0,0,0,0
152311,2022,Türkiye,Thailand,0,1,1,2,14/07/2022,0,0,0,0,0,0,0,0,0,0,0,0,1,0,0,1,0,0,0,0
152311,2022,Türkiye,USA,0,0,0,0,2/7/2022,0,0,0,0,0,0,0,0,0,0,0,0,0,0,0,0,0,0,0,0
152311,2022,Türkiye,Japan,0,0,13,13,1/7/2022,0,1,0,1,3,4,2,9,2,1,2,5,6,0,10,16,6,0,0,6
152311,2022,Türkiye,Netherlands,2,0,15,17,30/06/2022,0,0,2,2,4,2,7,13,1,4,2,7,4,0,8,12,7,0,0,7
152311,2022,Canada,Türkiye,0,0,2,2,29/06/2022,0,0,0,0,3,0,7,10,0,2,1,3,4,0,3,7,0,0,0,0
152311,2022,Türkiye,Korea,0,0,5,5,19/06/2022,0,0,0,0,1,1,4,6,1,1,0,2,5,1,5,11,3,1,0,4
152311,2022,Germany,Türkiye,0,0,14,14,18/06/2022,0,0,0,0,5,3,4,12,1,2,0,3,4,3,12,19,6,0,0,6
152311,2022,Serbia,Türkiye,0,0,4,4,17/06/2022,0,0,0,0,4,3,2,9,0,0,1,1,2,0,2,4,1,0,0,1
152311,2022,Brazil,Türkiye,0,1,10,11,16/06/2022,0,0,0,0,9,6,8,23,1,1,1,3,7,3,13,23,5,1,0,6
189139,2022,Türkiye,USA,0,0,0,0,2/7/2022,0,0,0,0,0,0,0,0,0,0,0,0,0,0,0,0,0,0,0,0
189139,2022,Türkiye,Japan,0,0,0,0,1/7/2022,0,0,0,0,0,0,0,0,0,0,0,0,0,0,0,0,0,0,0,0
189139,2022,Türkiye,Netherlands,0,0,0,0,30/06/2022,0,0,0,0,0,0,0,0,0,0,0,0,0,0,0,0,0,0,0,0
189139,2022,Canada,Türkiye,0,0,0,0,29/06/2022,0,0,0,0,0,0,0,0,0,0,0,0,0,0,0,0,0,0,0,0
189139,2022,Türkiye,Korea,0,0,0,0,19/06/2022,0,0,0,0,0,0,0,0,0,0,0,0,0,0,0,0,0,0,0,0
189139,2022,Germany,Türkiye,0,0,0,0,18/06/2022,0,0,0,0,0,0,0,0,0,0,0,0,0,0,0,0,0,0,0,0
189139,2022,Serbia,Türkiye,0,0,0,0,17/06/2022,0,0,0,0,0,0,0,0,0,0,0,0,0,0,0,0,0,0,0,0
189139,2022,Brazil,Türkiye,0,0,0,0,16/06/2022,0,0,0,0,0,0,0,0,0,0,0,0,0,0,0,0,0,0,0,0
189139,2022,Türkiye,Belgium,0,0,0,0,5/6/2022,0,0,0,0,0,0,0,0,0,0,0,0,0,0,0,0,0,0,0,0
189139,2022,Bulgaria,Türkiye,0,0,0,0,4/6/2022,0,0,0,0,0,0,0,0,0,0,0,0,0,0,0,0,0,0,0,0
189139,2022,Türkiye,China,0,0,0,0,3/6/2022,0,0,0,0,0,0,0,0,0,0,0,0,0,0,0,0,0,0,0,0
189139,2022,Türkiye,Italy,0,0,0,0,31/05/2022,0,0,0,0,0,0,0,0,0,0,0,0,0,0,0,0,0,0,0,0
152312,2022,Türkiye,Serbia,0,0,1,1,17/07/2022,0,0,0,0,0,1,1,2,0,0,0,0,0,0,5,5,3,0,0,3
152312,2022,Türkiye,Italy,0,0,3,3,16/07/2022,0,0,2,2,4,1,5,10,1,2,1,4,2,0,6,8,2,0,0,2
152312,2022,Türkiye,Thailand,1,2,12,15,14/07/2022,0,0,2,2,9,6,4,19,0,2,3,5,7,3,11,21,3,1,2,6
152312,2022,Türkiye,USA,1,1,19,21,2/7/2022,0,0,2,2,15,1,10,26,1,1,2,4,12,0,3,15,4,1,0,5
152312,2022,Türkiye,Japan,1,0,7,8,1/7/2022,0,1,0,1,1,0,7,8,2,2,0,4,5,1,3,9,11,0,0,11
152312,2022,Türkiye,Netherlands,0,0,0,0,30/06/2022,0,0,0,0,0,0,0,0,0,0,0,0,0,0,0,0,0,0,0,0
152312,2022,Canada,Türkiye,0,0,4,4,29/06/2022,0,0,0,0,2,1,0,3,0,0,0,0,2,0,1,3,1,0,0,1
152312,2022,Türkiye,Belgium,0,0,0,0,5/6/2022,0,0,0,0,0,0,0,0,0,0,0,0,0,0,0,0,0,0,0,0
152312,2022,Bulgaria,Türkiye,0,1,9,10,4/6/2022,0,0,1,1,6,6,10,22,2,2,1,5,10,0,11,21,2,2,1,5
152312,2022,Türkiye,China,1,2,11,14,3/6/2022,0,0,0,0,4,4,13,21,1,2,0,3,8,2,17,27,1,1,1,3
152312,2022,Türkiye,Italy,0,0,11,11,31/05/2022,0,1,0,1,8,3,5,16,0,1,1,2,7,1,16,24,4,0,0,4
143585,2022,Türkiye,Serbia,1,1,6,8,17/07/2022,0,0,1,1,3,5,4,12,1,2,2,5,10,2,12,24,6,3,0,9
143585,2022,Türkiye,Italy,0,2,7,9,16/07/2022,0,0,1,1,5,5,9,19,2,1,3,6,11,0,17,28,4,3,0,7
143585,2022,Türkiye,Thailand,0,2,18,20,14/07/2022,0,0,6,6,8,1,5,14,2,3,1,6,9,0,12,21,5,6,5,16
143585,2022,Türkiye,USA,0,0,0,0,2/7/2022,0,0,0,0,0,0,0,0,0,0,0,0,0,0,0,0,0,0,0,0
143585,2022,Türkiye,Japan,0,2,8,10,1/7/2022,0,0,1,1,17,3,18,38,1,1,1,3,7,0,5,12,8,1,0,9
143585,2022,Türkiye,Netherlands,0,2,5,7,30/06/2022,0,0,1,1,17,5,11,33,0,1,1,2,14,0,10,24,10,0,0,10
143585,2022,Canada,Türkiye,1,1,10,12,29/06/2022,0,0,1,1,8,2,8,18,0,2,0,2,8,3,14,25,3,0,0,3
143585,2022,Türkiye,Korea,0,0,10,10,19/06/2022,0,0,0,0,9,6,4,19,1,2,1,4,8,1,16,25,4,1,0,5
143585,2022,Germany,Türkiye,1,0,10,11,18/06/2022,0,0,2,2,8,3,11,22,2,3,3,8,6,1,13,20,0,1,0,1
143585,2022,Serbia,Türkiye,0,1,16,17,17/06/2022,0,0,2,2,17,7,13,37,1,1,3,5,16,2,22,40,6,2,0,8
143585,2022,Brazil,Türkiye,0,1,3,4,16/06/2022,0,0,0,0,8,1,2,11,1,0,1,2,4,0,7,11,0,1,1,2
143585,2022,Türkiye,Belgium,0,0,1,1,5/6/2022,0,0,0,0,0,1,3,4,0,0,0,0,1,0,4,5,0,0,0,0
143585,2022,Bulgaria,Türkiye,0,0,14,14,4/6/2022,1,0,2,3,6,5,3,14,1,3,2,6,5,1,12,18,8,0,2,10
143585,2022,Türkiye,China,0,2,9,11,3/6/2022,0,0,0,0,3,6,3,12,0,0,1,1,4,0,16,20,5,0,0,5
143585,2022,Türkiye,Italy,3,2,10,15,31/05/2022,0,0,2,2,12,3,9,24,1,1,1,3,8,0,8,16,2,2,1,5
153618,2022,,,-,-,-,-,-,-,-,-,-,-,-,-,-,-,-,-,-,-,-,-,-,-,-,-,-
148070,2022,Türkiye,Serbia,0,0,0,0,17/07/2022,0,0,0,0,0,0,0,0,0,0,0,0,1,0,1,2,0,1,0,1
148070,2022,Türkiye,Italy,0,0,0,0,16/07/2022,0,0,0,0,0,0,0,0,0,0,0,0,0,0,0,0,0,0,0,0
148070,2022,Türkiye,Thailand,0,0,4,4,14/07/2022,0,0,0,0,0,0,0,0,0,0,0,0,2,0,4,6,1,0,0,1
148070,2022,Türkiye,USA,0,2,18,20,2/7/2022,0,0,1,1,5,2,7,14,0,4,1,5,25,1,22,48,9,2,0,11
148070,2022,Türkiye,Japan,0,0,0,0,1/7/2022,0,0,0,0,0,0,0,0,0,0,0,0,0,0,0,0,0,0,0,0
148070,2022,Türkiye,Netherlands,0,0,0,0,30/06/2022,0,0,1,1,0,0,0,0,0,0,0,0,1,0,2,3,2,1,0,3
148070,2022,Canada,Türkiye,1,0,11,12,29/06/2022,0,0,3,3,3,2,2,7,0,2,0,2,15,1,13,29,4,0,0,4
148070,2022,Türkiye,Korea,0,0,0,0,19/06/2022,0,0,0,0,0,0,0,0,0,0,0,0,1,0,2,3,1,0,1,2
148070,2022,Germany,Türkiye,0,0,0,0,18/06/2022,0,0,0,0,0,0,0,0,0,0,0,0,3,0,1,4,0,0,0,0
148070,2022,Serbia,Türkiye,2,1,15,18,17/06/2022,0,0,0,0,10,7,10,27,1,0,3,4,11,2,24,37,7,2,3,12
148070,2022,Brazil,Türkiye,1,0,25,26,16/06/2022,0,0,1,1,3,4,2,9,1,1,0,2,15,2,23,40,7,1,2,10
148070,2022,Türkiye,Belgium,0,2,19,21,5/6/2022,1,0,3,4,3,1,11,15,0,3,2,5,4,3,16,23,10,1,0,11
148070,2022,Bulgaria,Türkiye,0,0,0,0,4/6/2022,0,0,0,0,0,0,0,0,0,0,0,0,0,0,0,0,0,0,0,0
148070,2022,Türkiye,China,0,0,6,6,3/6/2022,0,0,0,0,3,2,1,6,0,1,0,1,7,1,11,19,5,1,1,7
148070,2022,Türkiye,Italy,0,0,0,0,31/05/2022,0,0,0,0,0,0,0,0,0,0,0,0,0,0,0,0,0,0,0,0
143592,2022,Türkiye,Serbia,0,0,0,0,17/07/2022,0,0,0,0,0,0,0,0,0,0,0,0,0,0,0,0,0,1,0,1
143592,2022,Türkiye,Italy,0,0,0,0,16/07/2022,0,0,0,0,0,0,0,0,0,0,0,0,0,0,0,0,0,0,0,0
143592,2022,Türkiye,Thailand,0,0,0,0,14/07/2022,0,0,0,0,0,0,0,0,0,0,0,0,0,0,0,0,0,0,0,0
143592,2022,Türkiye,USA,0,0,0,0,2/7/2022,0,1,7,8,0,0,0,0,0,0,0,0,10,3,10,23,13,1,0,14
143592,2022,Türkiye,Japan,0,0,0,0,1/7/2022,0,0,0,0,0,0,0,0,0,0,0,0,0,0,0,0,0,0,0,0
143592,2022,Türkiye,Netherlands,0,0,0,0,30/06/2022,0,0,0,0,0,0,0,0,0,0,0,0,0,0,0,0,0,0,0,0
143592,2022,Canada,Türkiye,0,0,0,0,29/06/2022,0,0,0,0,0,0,0,0,0,0,0,0,0,0,0,0,0,0,0,0
143592,2022,Türkiye,Korea,0,0,0,0,19/06/2022,0,0,6,6,0,0,0,0,0,0,0,0,10,1,5,16,9,2,2,13
143592,2022,Germany,Türkiye,0,0,0,0,18/06/2022,0,0,0,0,0,0,0,0,0,0,0,0,0,0,0,0,0,0,0,0
143592,2022,Serbia,Türkiye,0,0,0,0,17/06/2022,0,0,8,8,0,0,0,0,0,0,0,0,1,0,6,7,18,4,4,26
143592,2022,Brazil,Türkiye,0,0,0,0,16/06/2022,0,1,12,13,0,0,0,0,0,0,0,0,3,1,4,8,9,4,3,16
143592,2022,Türkiye,Belgium,0,0,0,0,5/6/2022,0,0,0,0,0,0,0,0,0,0,0,0,0,0,0,0,0,0,0,0
143592,2022,Bulgaria,Türkiye,0,0,0,0,4/6/2022,0,0,3,3,0,0,0,0,0,0,0,0,2,0,8,10,12,2,2,16
143592,2022,Türkiye,China,0,0,0,0,3/6/2022,0,0,0,0,0,0,0,0,0,0,0,0,0,0,0,0,0,0,0,0
143592,2022,Türkiye,Italy,0,0,0,0,31/05/2022,0,0,0,0,0,0,1,1,0,0,0,0,0,0,0,0,0,0,0,0
163094,2022,Türkiye,Korea,0,0,16,16,19/06/2022,0,0,0,0,11,4,8,23,1,7,2,10,10,0,2,12,7,0,2,9
163094,2022,Germany,Türkiye,0,0,0,0,18/06/2022,0,0,0,0,0,0,0,0,0,0,0,0,0,0,0,0,0,0,0,0
163094,2022,Serbia,Türkiye,0,0,0,0,17/06/2022,0,0,0,0,0,0,0,0,0,0,0,0,0,0,0,0,0,0,0,0
163094,2022,Brazil,Türkiye,0,0,0,0,16/06/2022,0,0,0,0,1,1,1,3,1,0,0,1,1,0,1,2,0,0,1,1
163975,2022,Türkiye,Serbia,0,0,3,3,17/07/2022,1,0,17,18,0,0,1,1,0,2,0,2,0,0,0,0,0,1,0,1
163975,2022,Türkiye,Italy,0,0,2,2,16/07/2022,3,0,9,12,1,0,1,2,0,0,0,0,0,0,0,0,0,0,0,0
163975,2022,Türkiye,Thailand,0,0,0,0,14/07/2022,0,0,0,0,0,0,0,0,0,0,0,0,0,0,0,0,0,1,0,1
163975,2022,Türkiye,Korea,1,0,5,6,19/06/2022,4,0,15,19,0,0,0,0,1,0,1,2,0,0,0,0,0,0,0,0
163975,2022,Germany,Türkiye,0,0,0,0,18/06/2022,0,0,0,0,0,0,0,0,0,0,0,0,0,0,0,0,0,0,0,0
163975,2022,Serbia,Türkiye,0,0,3,3,17/06/2022,2,0,14,16,0,0,0,0,0,0,0,0,0,0,0,0,0,0,0,0
163975,2022,Brazil,Türkiye,0,0,2,2,16/06/2022,0,0,5,5,0,0,0,0,0,0,0,0,0,0,0,0,0,0,1,1
151195,2022,Türkiye,Serbia,0,0,1,1,17/07/2022,0,0,0,0,1,0,3,4,0,0,1,1,0,0,0,0,0,0,0,0
151195,2022,Türkiye,Italy,0,0,2,2,16/07/2022,0,0,0,0,1,0,2,3,0,0,0,0,0,0,0,0,0,0,0,0
151195,2022,Türkiye,Thailand,0,0,2,2,14/07/2022,0,0,0,0,0,0,0,0,0,0,0,0,0,0,0,0,0,0,0,0
151195,2022,Türkiye,USA,0,0,0,0,2/7/2022,0,0,1,1,2,0,1,3,0,0,1,1,0,0,0,0,0,0,0,0
151195,2022,Türkiye,Japan,0,1,6,7,1/7/2022,0,0,1,1,8,5,15,28,1,2,5,8,0,0,0,0,5,0,0,5
151195,2022,Türkiye,Netherlands,1,0,14,15,30/06/2022,0,0,0,0,11,4,7,22,0,4,2,6,0,0,0,0,5,0,0,5
151195,2022,Canada,Türkiye,0,0,3,3,29/06/2022,0,0,1,1,0,0,0,0,0,0,0,0,0,0,0,0,0,0,0,0
151195,2022,Türkiye,Korea,1,0,3,4,19/06/2022,0,0,0,0,1,0,2,3,2,1,4,7,0,0,0,0,0,0,0,0
151195,2022,Germany,Türkiye,0,0,0,0,18/06/2022,0,0,0,0,0,2,0,2,0,0,0,0,0,0,0,0,0,0,0,0
151195,2022,Serbia,Türkiye,0,2,4,6,17/06/2022,0,0,0,0,6,3,9,18,0,0,0,0,0,0,0,0,3,0,0,3
151195,2022,Brazil,Türkiye,0,0,0,0,16/06/2022,0,0,1,1,0,0,0,0,0,0,0,0,0,0,0,0,0,0,0,0
138782,2022,Türkiye,Serbia,2,0,13,15,17/07/2022,0,0,3,3,5,2,1,8,3,7,4,14,0,0,1,1,3,1,1,5
138782,2022,Türkiye,Italy,0,2,6,8,16/07/2022,0,1,2,3,10,2,3,15,1,6,9,16,0,0,0,0,3,2,0,5
138782,2022,Türkiye,Thailand,3,1,9,13,14/07/2022,0,0,1,1,12,0,6,18,2,7,15,24,0,0,1,1,2,1,2,5
138782,2022,Türkiye,USA,1,1,15,17,2/7/2022,0,0,0,0,11,2,5,18,2,5,4,11,0,0,0,0,0,1,0,1
138782,2022,Türkiye,Japan,0,2,11,13,1/7/2022,0,0,2,2,10,3,7,20,5,5,4,14,0,0,0,0,4,1,0,5
138782,2022,Türkiye,Netherlands,1,1,9,11,30/06/2022,0,0,2,2,6,1,6,13,2,2,6,10,0,0,0,0,2,0,0,2
138782,2022,Canada,Türkiye,0,0,12,12,29/06/2022,0,1,0,1,1,4,6,11,1,3,2,6,0,0,0,0,0,0,0,0
138782,2022,Türkiye,Korea,2,1,11,14,19/06/2022,0,0,0,0,7,1,4,12,1,4,1,6,0,0,0,0,0,0,0,0
138782,2022,Germany,Türkiye,0,2,8,10,18/06/2022,0,0,0,0,7,2,5,14,0,3,8,11,0,0,0,0,2,1,0,3
138782,2022,Serbia,Türkiye,0,0,13,13,17/06/2022,0,0,0,0,3,2,10,15,5,4,5,14,0,0,0,0,1,0,0,1
138782,2022,Brazil,Türkiye,1,3,9,13,16/06/2022,0,0,3,3,8,1,4,13,1,4,5,10,0,0,0,0,0,1,1,2
138782,2022,Türkiye,Belgium,1,0,15,16,5/6/2022,0,0,1,1,7,0,4,11,3,10,9,22,0,0,0,0,2,0,2,4
138782,2022,Bulgaria,Türkiye,2,1,7,10,4/6/2022,0,0,1,1,8,1,4,13,3,2,8,13,1,0,0,1,2,0,0,2
138782,2022,Türkiye,China,0,2,9,11,3/6/2022,0,0,3,3,7,1,7,15,1,6,7,14,0,0,0,0,2,1,0,3
138782,2022,Türkiye,Italy,1,1,13,15,31/05/2022,0,0,1,1,6,3,4,13,3,4,5,12,0,0,0,0,3,0,1,4
143580,2022,Türkiye,USA,0,0,0,0,2/7/2022,1,0,4,5,0,0,0,0,0,0,0,0,0,0,0,0,1,0,0,1
143580,2022,Türkiye,Japan,0,0,1,1,1/7/2022,0,0,3,3,0,0,0,0,0,0,0,0,0,0,0,0,1,0,0,1
143580,2022,Türkiye,Netherlands,0,0,0,0,30/06/2022,0,0,0,0,0,0,0,0,0,0,0,0,0,0,0,0,0,0,0,0
143580,2022,Canada,Türkiye,0,1,4,5,29/06/2022,0,0,12,12,0,0,0,0,0,0,0,0,0,0,0,0,0,0,0,0
143580,2022,Türkiye,Belgium,0,0,0,0,5/6/2022,3,0,1,4,0,0,0,0,0,0,0,0,0,0,0,0,0,0,0,0
143580,2022,Bulgaria,Türkiye,0,0,0,0,4/6/2022,1,0,1,2,0,0,0,0,0,0,0,0,0,0,0,0,0,0,0,0
143580,2022,Türkiye,China,0,0,5,5,3/6/2022,18,1,16,35,1,0,0,1,0,2,1,3,0,0,0,0,3,0,0,3
143580,2022,Türkiye,Italy,0,0,1,1,31/05/2022,1,0,2,3,0,0,0,0,0,0,0,0,0,0,2,2,0,0,0,0
152263,2022,Türkiye,Serbia,0,0,11,11,17/07/2022,0,0,3,3,8,0,6,14,5,5,14,24,0,0,0,0,3,2,0,5
152263,2022,Türkiye,Italy,0,1,11,12,16/07/2022,0,0,1,1,7,1,5,13,1,2,7,10,0,0,0,0,3,2,1,6
152263,2022,Türkiye,Thailand,1,1,14,16,14/07/2022,0,0,2,2,11,1,8,20,2,4,8,14,0,0,0,0,4,2,2,8
152263,2022,Türkiye,USA,0,3,13,16,2/7/2022,0,1,1,2,14,1,8,23,5,7,4,16,0,0,0,0,0,1,0,1
152263,2022,Türkiye,Japan,1,0,16,17,1/7/2022,0,0,3,3,9,1,3,13,6,4,5,15,0,0,0,0,2,0,0,2
152263,2022,Türkiye,Netherlands,0,2,9,11,30/06/2022,0,0,1,1,8,5,4,17,3,3,3,9,0,0,0,0,1,0,0,1
152263,2022,Canada,Türkiye,1,1,13,15,29/06/2022,0,0,2,2,14,1,8,23,2,7,1,10,0,0,0,0,1,0,0,1
152263,2022,Türkiye,Korea,0,3,9,12,19/06/2022,0,0,0,0,11,2,4,17,4,3,8,15,1,0,0,1,0,0,1,1
152263,2022,Germany,Türkiye,0,3,4,7,18/06/2022,0,1,3,4,12,1,3,16,9,3,3,15,0,0,1,1,1,0,0,1
152263,2022,Serbia,Türkiye,0,1,12,13,17/06/2022,0,0,1,1,8,2,2,12,2,9,6,17,0,0,0,0,1,2,0,3
152263,2022,Brazil,Türkiye,0,0,13,13,16/06/2022,0,0,2,2,7,1,3,11,3,4,7,14,0,0,0,0,1,3,0,4
152263,2022,Türkiye,Belgium,0,2,10,12,5/6/2022,1,0,1,2,7,3,5,15,5,10,12,27,0,0,0,0,5,1,4,10
152263,2022,Bulgaria,Türkiye,1,3,10,14,4/6/2022,0,0,2,2,7,0,3,10,1,2,7,10,0,0,1,1,2,0,1,3
152263,2022,Türkiye,China,0,3,7,10,3/6/2022,0,0,2,2,9,2,5,16,1,6,7,14,0,0,0,0,1,0,0,1
152263,2022,Türkiye,Italy,0,0,13,13,31/05/2022,0,0,4,4,6,0,4,10,2,5,2,9,0,0,0,0,2,2,2,6
123798,2022,Türkiye,Belgium,0,0,0,0,5/6/2022,1,0,0,1,2,0,1,3,0,1,0,1,0,0,0,0,0,0,0,0
123798,2022,Bulgaria,Türkiye,0,0,0,0,4/6/2022,0,0,0,0,0,0,0,0,0,0,0,0,0,0,0,0,0,0,0,0
123798,2022,Türkiye,China,0,0,0,0,3/6/2022,0,0,0,0,0,0,0,0,0,0,0,0,0,0,0,0,0,0,0,0
123798,2022,Türkiye,Italy,0,0,0,0,31/05/2022,0,0,0,0,0,0,0,0,0,0,0,0,0,0,0,0,0,0,0,0
168151,2022,Türkiye,USA,0,0,0,0,2/7/2022,0,0,0,0,0,0,0,0,0,0,0,0,4,1,1,6,3,0,0,3
168151,2022,Türkiye,Japan,0,0,0,0,1/7/2022,0,0,0,0,0,0,0,0,0,0,0,0,1,0,3,4,1,0,0,1
168151,2022,Türkiye,Netherlands,0,0,0,0,30/06/2022,0,0,1,1,0,0,0,0,0,0,0,0,0,0,2,2,3,0,0,3
168151,2022,Canada,Türkiye,0,0,0,0,29/06/2022,0,0,0,0,0,0,0,0,0,0,0,0,1,0,0,1,1,0,0,1
123803,2022,,,-,-,-,-,-,-,-,-,-,-,-,-,-,-,-,-,-,-,-,-,-,-,-,-,-
163089,2022,Türkiye,Serbia,0,0,5,5,17/07/2022,0,0,4,4,1,0,2,3,0,1,0,1,2,0,4,6,2,0,0,2
163089,2022,Türkiye,Italy,0,1,9,10,16/07/2022,0,0,2,2,1,2,2,5,0,1,1,2,16,0,10,26,9,2,0,11
163089,2022,Türkiye,Thailand,0,0,0,0,14/07/2022,0,0,0,0,0,0,0,0,0,0,0,0,0,0,0,0,0,0,0,0
163089,2022,Türkiye,Belgium,1,1,10,12,5/6/2022,1,0,1,2,11,2,12,25,1,2,3,6,9,0,22,31,11,0,3,14
163089,2022,Bulgaria,Türkiye,0,0,0,0,4/6/2022,0,0,0,0,0,0,0,0,0,0,0,0,0,0,0,0,0,0,0,0
163089,2022,Türkiye,China,0,0,2,2,3/6/2022,0,0,2,2,1,3,1,5,1,0,0,1,4,0,4,8,0,1,1,2
163089,2022,Türkiye,Italy,0,0,0,0,31/05/2022,0,0,0,0,0,0,0,0,0,0,0,0,0,0,0,0,0,0,0,0
163091,2022,,,-,-,-,-,-,-,-,-,-,-,-,-,-,-,-,-,-,-,-,-,-,-,-,-,-
173334,2022,,,-,-,-,-,-,-,-,-,-,-,-,-,-,-,-,-,-,-,-,-,-,-,-,-,-
163093,2022,,,-,-,-,-,-,-,-,-,-,-,-,-,-,-,-,-,-,-,-,-,-,-,-,-,-
152254,2022,,,-,-,-,-,-,-,-,-,-,-,-,-,-,-,-,-,-,-,-,-,-,-,-,-,-
163982,2022,Türkiye,Serbia,0,0,10,10,17/07/2022,0,1,4,5,14,5,14,33,0,3,1,4,0,0,1,1,6,1,0,7
163982,2022,Türkiye,Italy,2,1,8,11,16/07/2022,0,0,1,1,12,5,12,29,0,2,5,7,0,0,0,0,2,4,0,6
163982,2022,Türkiye,Thailand,0,0,10,10,14/07/2022,0,0,1,1,15,4,15,34,2,2,4,8,0,0,0,0,7,3,1,11
163982,2022,Türkiye,USA,0,3,16,19,2/7/2022,0,0,2,2,24,7,17,48,3,3,4,10,0,0,0,0,11,3,0,14
163982,2022,Türkiye,Japan,0,1,1,2,1/7/2022,0,0,0,0,6,0,2,8,0,0,1,1,0,0,0,0,0,0,0,0
163982,2022,Türkiye,Netherlands,0,0,0,0,30/06/2022,0,0,0,0,0,0,0,0,0,0,0,0,0,0,0,0,0,0,0,0
163982,2022,Canada,Türkiye,2,4,13,19,29/06/2022,0,0,0,0,20,8,11,39,1,4,2,7,0,0,0,0,8,0,0,8
163982,2022,Türkiye,Korea,0,3,9,12,19/06/2022,0,0,2,2,14,3,8,25,3,4,2,9,0,0,0,0,4,0,0,4
163982,2022,Germany,Türkiye,0,1,6,7,18/06/2022,0,0,0,0,9,4,6,19,0,0,1,1,0,0,0,0,7,0,0,7
163982,2022,Serbia,Türkiye,0,3,7,10,17/06/2022,0,0,0,0,14,6,15,35,1,3,5,9,0,0,0,0,2,0,0,2
163982,2022,Brazil,Türkiye,1,1,12,14,16/06/2022,0,0,2,2,19,8,24,51,1,6,1,8,0,0,0,0,3,1,4,8
163982,2022,Türkiye,Belgium,0,3,10,13,5/6/2022,0,0,0,0,20,10,18,48,0,6,2,8,0,0,0,0,9,1,2,12
163982,2022,Bulgaria,Türkiye,0,2,14,16,4/6/2022,1,0,1,2,15,2,8,25,5,4,5,14,0,0,0,0,5,1,4,10
163982,2022,Türkiye,China,1,0,12,13,3/6/2022,0,0,1,1,21,8,17,46,0,1,1,2,0,0,0,0,9,1,1,11
163982,2022,Türkiye,Italy,0,2,8,10,31/05/2022,0,0,0,0,13,2,12,27,1,2,3,6,0,0,0,0,5,1,1,7
132835,2022,USA,Germany,1,3,12,16,3/7/2022,4,0,99,103,1,1,1,3,0,5,2,7,0,0,1,1,8,0,0,8
132835,2022,Türkiye,USA,0,0,0,0,2/7/2022,0,0,0,0,0,0,0,0,0,0,0,0,0,0,0,0,0,0,0,0
132835,2022,USA,Serbia,0,0,0,0,1/7/2022,0,0,0,0,0,0,0,0,0,0,0,0,0,0,0,0,0,0,0,0
132835,2022,Belgium,USA,0,0,0,0,30/06/2022,0,0,0,0,0,0,0,0,0,0,0,0,0,0,0,0,0,0,0,0
132835,2022,Thailand,USA,0,0,2,2,19/06/2022,6,0,20,26,0,1,1,2,0,0,2,2,0,0,0,0,2,0,0,2
132835,2022,USA,China,3,6,3,12,18/06/2022,17,0,68,85,2,0,0,2,0,2,3,5,0,0,0,0,2,1,2,5
132835,2022,Poland,USA,0,0,0,0,17/06/2022,0,0,0,0,0,0,0,0,0,0,0,0,0,0,0,0,0,0,0,0
132835,2022,Bulgaria,USA,1,1,11,13,15/06/2022,12,0,61,73,1,0,0,1,1,3,5,9,0,0,1,1,6,1,1,8
143517,2022,USA,Serbia,2,1,19,22,13/07/2022,18,0,82,100,1,0,0,1,2,3,0,5,0,0,0,0,8,4,0,12
143517,2022,USA,Germany,0,0,0,0,3/7/2022,0,0,0,0,0,0,0,0,0,0,0,0,0,0,0,0,0,0,0,0
143517,2022,Türkiye,USA,1,1,14,16,2/7/2022,8,0,136,144,0,0,1,1,0,3,0,3,0,0,0,0,3,2,0,5
143517,2022,USA,Serbia,0,0,8,8,1/7/2022,14,0,66,80,0,0,0,0,2,4,1,7,0,0,0,0,6,3,1,10
143517,2022,Belgium,USA,0,0,7,7,30/06/2022,11,0,77,88,0,0,1,1,3,0,3,6,0,0,0,0,3,2,0,5
146722,2022,USA,Serbia,0,2,4,6,13/07/2022,0,0,0,0,5,4,4,13,1,3,1,5,11,2,21,34,6,2,1,9
146722,2022,USA,Germany,1,2,8,11,3/7/2022,0,0,2,2,7,2,6,15,2,1,2,5,8,2,20,30,7,3,0,10
146722,2022,Türkiye,USA,0,0,0,0,2/7/2022,0,0,0,0,0,0,0,0,0,0,0,0,0,0,0,0,0,0,0,0
146722,2022,USA,Serbia,0,2,8,10,1/7/2022,0,0,4,4,16,1,13,30,2,0,0,2,13,2,11,26,4,0,0,4
146722,2022,Belgium,USA,0,0,0,0,30/06/2022,0,0,0,0,0,0,0,0,0,0,0,0,0,0,0,0,0,0,0,0
146722,2022,Thailand,USA,0,0,0,0,19/06/2022,0,0,0,0,0,0,0,0,0,0,0,0,0,0,0,0,0,0,0,0
146722,2022,USA,China,2,0,10,12,18/06/2022,1,0,3,4,18,5,6,29,0,2,1,3,5,0,24,29,6,1,0,7
146722,2022,Poland,USA,0,0,0,0,17/06/2022,0,0,0,0,0,0,0,0,0,0,0,0,0,0,0,0,0,0,0,0
146722,2022,Bulgaria,USA,0,1,8,9,15/06/2022,0,0,1,1,7,4,9,20,1,3,2,6,7,4,15,26,9,3,0,12
135564,2022,USA,Serbia,0,0,0,0,13/07/2022,0,1,6,7,0,0,0,0,0,0,0,0,6,1,5,12,10,1,0,11
135564,2022,USA,Germany,0,0,0,0,3/7/2022,0,0,0,0,0,0,0,0,0,0,0,0,0,0,0,0,0,0,0,0
135564,2022,Türkiye,USA,0,0,0,0,2/7/2022,0,0,9,9,0,0,0,0,0,0,0,0,15,0,6,21,17,2,0,19
135564,2022,USA,Serbia,0,0,0,0,1/7/2022,0,1,3,4,0,0,0,0,0,0,0,0,4,2,1,7,7,2,1,10
135564,2022,Belgium,USA,0,0,0,0,30/06/2022,0,0,2,2,0,0,0,0,0,0,0,0,3,1,4,8,5,3,0,8
135564,2022,Thailand,USA,0,0,0,0,19/06/2022,0,0,17,17,0,0,0,0,0,0,0,0,2,1,16,19,16,3,2,21
135564,2022,USA,China,0,0,0,0,18/06/2022,0,0,3,3,0,0,0,0,0,0,0,0,4,2,12,18,11,0,0,11
135564,2022,Poland,USA,0,0,0,0,17/06/2022,0,0,0,0,0,0,0,0,0,0,0,0,0,0,0,0,0,0,0,0
135564,2022,Bulgaria,USA,0,0,0,0,15/06/2022,0,0,5,5,0,0,0,0,0,0,0,0,3,1,8,12,8,1,0,9
152187,2022,USA,Serbia,0,0,0,0,13/07/2022,0,0,0,0,0,0,0,0,0,0,0,0,0,0,0,0,0,0,0,0
152187,2022,USA,Germany,0,0,0,0,3/7/2022,0,0,9,9,0,0,0,0,0,0,0,0,4,0,11,15,15,3,2,20
152187,2022,Türkiye,USA,0,0,0,0,2/7/2022,0,0,0,0,0,0,0,0,0,0,0,0,0,0,0,0,0,0,0,0
152187,2022,USA,Serbia,0,0,0,0,1/7/2022,0,0,0,0,0,0,0,0,0,0,0,0,0,0,0,0,0,0,0,0
152187,2022,Belgium,USA,0,0,0,0,30/06/2022,0,0,0,0,0,0,0,0,0,0,0,0,0,0,0,0,0,0,0,0
152187,2022,Thailand,USA,0,0,0,0,19/06/2022,0,0,0,0,0,0,0,0,0,0,0,0,0,0,0,0,0,0,0,0
152187,2022,USA,China,0,0,0,0,18/06/2022,0,0,0,0,0,0,0,0,0,0,0,0,0,0,0,0,0,0,0,0
152187,2022,Poland,USA,0,0,0,0,17/06/2022,0,0,5,5,0,0,0,0,0,0,0,0,3,0,1,4,12,4,0,16
152187,2022,Bulgaria,USA,0,0,0,0,15/06/2022,0,0,0,0,0,0,0,0,0,0,0,0,0,0,0,0,0,0,0,0
152187,2022,Japan,USA,0,0,0,0,5/6/2022,0,1,15,16,0,0,0,0,0,0,0,0,4,2,3,9,15,5,2,22
152187,2022,USA,Brazil,0,0,0,0,5/6/2022,0,0,13,13,0,0,0,0,0,0,0,0,8,0,2,10,17,3,0,20
152187,2022,USA,Canada,0,0,0,0,4/6/2022,0,0,0,0,0,0,0,0,0,0,0,0,0,0,0,0,0,0,0,0
152187,2022,USA,Dominican Republic,0,0,0,0,1/6/2022,0,0,13,13,0,0,0,0,0,0,0,0,10,0,3,13,15,0,1,16
145702,2022,USA,Germany,1,1,13,15,3/7/2022,0,0,1,1,2,0,5,7,2,4,5,11,0,0,0,0,3,1,0,4
145702,2022,Türkiye,USA,0,0,0,0,2/7/2022,0,0,0,0,0,0,0,0,0,0,0,0,0,0,0,0,0,0,0,0
145702,2022,USA,Serbia,0,0,0,0,1/7/2022,0,0,0,0,0,0,0,0,0,0,0,0,0,0,0,0,0,0,0,0
145702,2022,Belgium,USA,0,0,16,16,30/06/2022,0,0,3,3,4,1,2,7,1,2,0,3,0,0,0,0,5,0,0,5
145702,2022,Japan,USA,0,0,7,7,5/6/2022,0,0,0,0,2,1,3,6,0,3,1,4,2,0,0,2,1,1,0,2
145702,2022,USA,Brazil,0,0,0,0,5/6/2022,0,0,0,0,0,0,0,0,0,0,0,0,0,0,0,0,0,0,0,0
145702,2022,USA,Canada,0,0,12,12,4/6/2022,0,0,1,1,3,0,4,7,0,2,5,7,0,0,0,0,1,0,0,1
145702,2022,USA,Dominican Republic,1,0,10,11,1/6/2022,0,0,2,2,5,1,5,11,0,4,6,10,0,0,1,1,0,0,0,0
132500,2022,USA,Serbia,0,0,1,1,13/07/2022,2,0,0,2,0,0,0,0,0,0,0,0,0,0,0,0,0,0,0,0
132500,2022,Thailand,USA,1,1,12,14,19/06/2022,26,1,56,83,1,0,0,1,1,1,4,6,0,0,0,0,8,1,0,9
132500,2022,USA,China,0,0,0,0,18/06/2022,0,0,0,0,0,0,0,0,0,0,0,0,0,0,0,0,0,0,0,0
132500,2022,Poland,USA,1,0,10,11,17/06/2022,14,0,60,74,2,0,1,3,1,1,4,6,0,0,0,0,8,1,0,9
132500,2022,Bulgaria,USA,0,0,0,0,15/06/2022,0,0,0,0,0,0,0,0,0,0,0,0,0,0,0,0,0,0,0,0
132500,2022,Japan,USA,0,0,14,14,5/6/2022,24,1,70,95,1,0,4,5,0,3,2,5,0,0,1,1,16,0,0,16
132500,2022,USA,Brazil,2,2,12,16,5/6/2022,13,0,60,73,1,0,0,1,0,4,5,9,0,0,0,0,12,2,1,15
132500,2022,USA,Canada,1,2,7,10,4/6/2022,9,0,55,64,2,0,1,3,0,3,1,4,0,0,0,0,14,3,1,18
132500,2022,USA,Dominican Republic,0,1,13,14,1/6/2022,23,0,46,69,3,1,3,7,0,2,0,2,0,0,1,1,12,2,0,14
160909,2022,USA,Serbia,0,0,0,0,13/07/2022,0,0,0,0,0,0,0,0,0,0,0,0,0,0,0,0,0,0,0,0
160909,2022,USA,Germany,0,0,0,0,3/7/2022,0,0,0,0,0,0,0,0,0,0,0,0,0,0,0,0,0,0,0,0
160909,2022,Türkiye,USA,0,3,14,17,2/7/2022,0,0,1,1,2,3,2,7,4,9,3,16,0,1,0,1,5,1,0,6
160909,2022,USA,Serbia,1,0,23,24,1/7/2022,0,0,1,1,4,1,0,5,2,3,0,5,0,0,0,0,2,1,0,3
160909,2022,Belgium,USA,0,0,0,0,30/06/2022,0,0,0,0,0,0,0,0,0,0,0,0,0,0,0,0,0,0,0,0
160909,2022,Thailand,USA,0,0,0,0,19/06/2022,0,0,0,0,0,0,0,0,0,0,0,0,0,0,0,0,0,0,0,0
160909,2022,USA,China,0,1,7,8,18/06/2022,0,0,0,0,4,3,1,8,2,2,4,8,1,0,0,1,3,0,0,3
160909,2022,Poland,USA,0,0,0,0,17/06/2022,0,0,0,0,0,0,0,0,0,0,0,0,0,0,0,0,0,0,0,0
160909,2022,Bulgaria,USA,1,2,7,10,15/06/2022,0,0,2,2,9,1,0,10,1,4,5,10,1,0,0,1,2,1,0,3
135983,2022,Thailand,USA,1,1,3,5,19/06/2022,0,0,0,0,3,1,6,10,1,0,0,1,2,1,11,14,3,0,0,3
135983,2022,USA,China,0,0,0,0,18/06/2022,0,0,0,0,0,0,0,0,0,0,0,0,0,0,0,0,0,0,0,0
135983,2022,Poland,USA,0,1,10,11,17/06/2022,0,0,2,2,11,3,11,25,1,0,2,3,3,1,17,21,5,1,0,6
135983,2022,Bulgaria,USA,0,0,0,0,15/06/2022,0,0,0,0,0,0,0,0,0,0,0,0,0,0,0,0,0,0,0,0
135983,2022,Japan,USA,0,0,7,7,5/6/2022,0,0,2,2,7,2,14,23,0,2,1,3,6,0,7,13,7,2,0,9
135983,2022,USA,Brazil,0,0,0,0,5/6/2022,0,0,0,0,0,0,0,0,0,0,0,0,0,0,0,0,0,0,0,0
135983,2022,USA,Canada,0,1,9,10,4/6/2022,0,0,2,2,11,2,11,24,1,0,1,2,4,0,5,9,8,3,0,11
135983,2022,USA,Dominican Republic,0,0,0,0,1/6/2022,0,0,0,0,0,0,0,0,0,0,0,0,0,0,0,0,0,0,0,0
152194,2022,Japan,USA,0,0,0,0,5/6/2022,0,0,0,0,0,0,0,0,0,0,0,0,0,0,0,0,0,0,0,0
152194,2022,USA,Brazil,0,0,0,0,5/6/2022,0,0,0,0,0,0,0,0,0,0,0,0,0,0,0,0,0,0,0,0
152194,2022,USA,Canada,0,1,11,12,4/6/2022,0,0,0,0,6,0,2,8,3,3,2,8,0,0,0,0,2,0,0,2
152194,2022,USA,Dominican Republic,0,0,0,0,1/6/2022,0,0,0,0,0,0,0,0,0,0,0,0,0,0,0,0,0,0,0,0
155307,2022,USA,Serbia,0,1,7,8,13/07/2022,0,0,0,0,10,4,5,19,1,6,1,8,0,0,0,0,8,1,1,10
155307,2022,USA,Germany,0,0,0,0,3/7/2022,0,0,0,0,0,0,0,0,0,0,0,0,0,0,0,0,0,0,0,0
155307,2022,Türkiye,USA,3,3,12,18,2/7/2022,0,0,0,0,20,5,20,45,1,0,3,4,0,0,0,0,7,2,0,9
155307,2022,USA,Serbia,0,0,0,0,1/7/2022,0,0,0,0,0,0,0,0,0,0,0,0,0,0,0,0,0,0,0,0
155307,2022,Belgium,USA,1,4,8,13,30/06/2022,0,0,0,0,12,4,11,27,2,3,0,5,0,0,0,0,5,3,0,8
155307,2022,Japan,USA,0,2,5,7,5/6/2022,0,0,0,0,11,4,18,33,0,4,1,5,0,0,0,0,11,3,1,15
155307,2022,USA,Brazil,0,0,0,0,5/6/2022,0,0,0,0,0,0,0,0,0,0,0,0,0,0,0,0,0,0,0,0
155307,2022,USA,Canada,0,3,9,12,4/6/2022,0,0,1,1,13,4,10,27,2,2,1,5,0,0,0,0,5,0,1,6
155307,2022,USA,Dominican Republic,0,0,0,0,1/6/2022,0,0,0,0,0,0,0,0,0,0,0,0,0,0,0,0,0,0,0,0
172978,2022,USA,Serbia,0,1,6,7,13/07/2022,0,0,0,0,9,3,5,17,2,2,1,5,0,0,0,0,1,1,0,2
172978,2022,USA,Germany,1,1,11,13,3/7/2022,0,0,4,4,12,6,13,31,1,3,1,5,0,0,0,0,8,1,0,9
172978,2022,Türkiye,USA,0,0,0,0,2/7/2022,0,0,0,0,0,0,0,0,0,0,0,0,0,0,0,0,0,0,0,0
172978,2022,USA,Serbia,1,1,9,11,1/7/2022,0,0,1,1,14,3,13,30,0,1,1,2,0,0,0,0,10,3,0,13
172978,2022,Belgium,USA,0,0,0,0,30/06/2022,0,0,0,0,0,0,0,0,0,0,0,0,0,0,0,0,0,0,0,0
172978,2022,Japan,USA,0,0,0,0,5/6/2022,0,0,0,0,0,0,0,0,0,0,0,0,0,0,0,0,0,0,0,0
172978,2022,USA,Brazil,3,1,10,14,5/6/2022,0,0,3,3,15,9,10,34,1,1,0,2,0,0,0,0,4,1,0,5
172978,2022,USA,Canada,0,0,0,0,4/6/2022,0,0,0,0,0,0,0,0,0,0,0,0,0,0,0,0,0,0,0,0
172978,2022,USA,Dominican Republic,1,2,10,13,1/6/2022,0,0,2,2,13,1,14,28,1,3,4,8,0,0,0,0,6,6,0,12
162942,2022,USA,Serbia,0,0,7,7,13/07/2022,0,0,0,0,1,0,0,1,0,0,0,0,0,0,0,0,0,0,0,0
162942,2022,USA,Germany,2,0,14,16,3/7/2022,0,0,6,6,18,5,20,43,4,3,2,9,7,1,11,19,10,2,0,12
162942,2022,Türkiye,USA,0,0,1,1,2/7/2022,0,0,0,0,0,0,0,0,0,0,0,0,0,0,0,0,0,0,0,0
162942,2022,USA,Serbia,2,0,11,13,1/7/2022,0,0,3,3,10,1,6,17,0,2,1,3,11,0,13,24,11,2,0,13
162942,2022,Belgium,USA,0,0,0,0,30/06/2022,0,0,0,0,0,0,0,0,0,0,0,0,0,0,0,0,0,0,0,0
162942,2022,Japan,USA,0,2,3,5,5/6/2022,0,0,1,1,6,1,5,12,0,1,0,1,2,0,2,4,4,1,0,5
162942,2022,USA,Brazil,0,1,11,12,5/6/2022,0,0,4,4,9,3,14,26,3,1,0,4,11,1,8,20,5,1,0,6
162942,2022,USA,Canada,0,0,0,0,4/6/2022,0,0,0,0,0,0,0,0,0,0,0,0,0,0,0,0,0,0,0,0
162942,2022,USA,Dominican Republic,2,1,16,19,1/6/2022,0,0,2,2,10,5,11,26,3,1,1,5,8,0,6,14,10,3,0,13
140052,2022,USA,Serbia,1,2,27,30,13/07/2022,0,0,2,2,3,1,6,10,3,6,6,15,0,0,2,2,1,2,0,3
140052,2022,USA,Germany,0,0,0,0,3/7/2022,0,0,0,0,0,0,0,0,0,0,0,0,0,0,0,0,0,0,0,0
140052,2022,Türkiye,USA,1,0,14,15,2/7/2022,0,0,0,0,10,5,5,20,0,7,0,7,0,0,1,1,0,1,0,1
140052,2022,USA,Serbia,1,1,13,15,1/7/2022,0,0,1,1,4,4,4,12,3,5,4,12,0,0,1,1,3,0,0,3
140052,2022,Belgium,USA,0,0,0,0,30/06/2022,0,0,0,0,0,0,0,0,0,0,0,0,0,0,0,0,0,0,0,0
140052,2022,Thailand,USA,0,0,0,0,19/06/2022,0,0,0,0,0,0,0,0,0,0,0,0,0,0,0,0,0,0,0,0
140052,2022,USA,China,2,1,14,17,18/06/2022,0,0,1,1,6,1,5,12,3,3,2,8,0,0,0,0,4,1,1,6
140052,2022,Poland,USA,0,0,0,0,17/06/2022,0,0,0,0,0,0,0,0,0,0,0,0,0,0,0,0,0,0,0,0
140052,2022,Bulgaria,USA,4,0,15,19,15/06/2022,0,0,0,0,4,1,2,7,2,2,2,6,0,0,0,0,1,1,1,3
172977,2022,USA,Serbia,0,0,0,0,13/07/2022,0,0,0,0,0,0,0,0,0,0,0,0,0,0,0,0,0,0,0,0
172977,2022,USA,Germany,0,1,9,10,3/7/2022,0,0,1,1,7,2,3,12,2,5,5,12,0,0,0,0,4,2,0,6
172977,2022,Türkiye,USA,0,0,0,0,2/7/2022,0,0,0,0,0,0,0,0,0,0,0,0,0,0,0,0,0,0,0,0
172977,2022,USA,Serbia,0,0,0,0,1/7/2022,0,0,0,0,0,0,0,0,0,0,0,0,0,0,0,0,0,0,0,0
172977,2022,Belgium,USA,1,0,8,9,30/06/2022,0,0,0,0,4,1,7,12,1,1,2,4,0,0,0,0,2,1,0,3
172977,2022,Japan,USA,0,0,3,3,5/6/2022,0,0,0,0,1,1,2,4,1,0,5,6,1,0,1,2,0,0,0,0
172977,2022,USA,Brazil,1,0,13,14,5/6/2022,0,0,2,2,5,3,0,8,3,3,5,11,0,0,0,0,1,0,0,1
172977,2022,USA,Canada,0,0,0,0,4/6/2022,0,0,0,0,0,0,0,0,0,0,0,0,0,0,0,0,0,0,0,0
172977,2022,USA,Dominican Republic,0,2,5,7,1/6/2022,0,0,0,0,3,2,3,8,3,4,3,10,1,0,1,2,1,0,0,1
186425,2022,,,-,-,-,-,-,-,-,-,-,-,-,-,-,-,-,-,-,-,-,-,-,-,-,-,-
179566,2022,USA,Germany,0,0,0,0,3/7/2022,0,0,0,0,0,0,0,0,0,0,0,0,0,0,0,0,0,0,0,0
179566,2022,Türkiye,USA,2,3,15,20,2/7/2022,0,0,2,2,24,7,16,47,0,3,1,4,20,1,30,51,10,0,0,10
179566,2022,USA,Serbia,0,0,0,0,1/7/2022,0,0,0,0,0,0,0,0,0,0,0,0,0,0,0,0,0,0,0,0
179566,2022,Belgium,USA,1,0,12,13,30/06/2022,0,0,1,1,18,3,7,28,1,1,2,4,11,3,11,25,5,0,0,5
179566,2022,Japan,USA,0,1,7,8,5/6/2022,0,0,2,2,10,2,18,30,0,0,1,1,9,1,14,24,5,1,0,6
179566,2022,USA,Brazil,0,0,0,0,5/6/2022,0,0,0,0,0,0,0,0,0,0,0,0,0,0,0,0,0,0,0,0
179566,2022,USA,Canada,1,1,15,17,4/6/2022,0,1,5,6,9,3,11,23,2,1,1,4,18,0,12,30,5,2,0,7
179566,2022,USA,Dominican Republic,0,0,0,0,1/6/2022,0,0,0,0,0,0,0,0,0,0,0,0,0,0,0,0,0,0,0,0
178951,2022,Japan,USA,0,0,0,0,5/6/2022,0,0,0,0,0,0,0,0,0,0,0,0,0,0,0,0,0,0,0,0
178951,2022,USA,Brazil,0,0,0,0,5/6/2022,0,0,0,0,0,0,0,0,0,0,0,0,0,0,0,0,0,0,0,0
178951,2022,USA,Canada,0,0,0,0,4/6/2022,0,0,0,0,0,0,0,0,0,0,0,0,0,0,0,0,0,0,0,0
178951,2022,USA,Dominican Republic,0,0,0,0,1/6/2022,0,0,0,0,0,0,0,0,0,0,0,0,0,0,0,0,0,0,0,0
143524,2022,Thailand,USA,0,0,1,1,19/06/2022,0,0,0,0,0,2,4,6,0,0,1,1,0,0,0,0,1,0,1,2
143524,2022,USA,China,0,2,11,13,18/06/2022,0,0,0,0,7,3,11,21,1,4,1,6,0,0,0,0,6,7,0,13
143524,2022,Poland,USA,0,0,0,0,17/06/2022,0,0,0,0,0,0,0,0,0,0,0,0,0,0,0,0,0,0,0,0
143524,2022,Bulgaria,USA,0,2,9,11,15/06/2022,0,0,2,2,10,1,10,21,2,4,5,11,0,0,0,0,7,3,1,11
174134,2022,Japan,USA,0,0,0,0,5/6/2022,0,0,0,0,0,0,0,0,0,0,0,0,0,0,0,0,0,0,0,0
174134,2022,USA,Brazil,0,0,0,0,5/6/2022,0,0,0,0,0,0,0,0,0,0,0,0,0,0,0,0,0,0,0,0
174134,2022,USA,Canada,0,0,0,0,4/6/2022,0,0,14,14,0,0,0,0,0,0,0,0,6,1,1,8,17,3,1,21
174134,2022,USA,Dominican Republic,0,0,0,0,1/6/2022,0,0,0,0,0,0,0,0,0,0,0,0,0,0,0,0,0,0,0,0
141933,2022,USA,Serbia,0,0,13,13,13/07/2022,0,0,9,9,17,8,14,39,4,4,4,12,6,1,13,20,14,6,1,21
141933,2022,USA,Germany,0,0,5,5,3/7/2022,0,0,2,2,4,0,7,11,0,0,2,2,3,0,2,5,3,0,0,3
141933,2022,Türkiye,USA,2,2,18,22,2/7/2022,0,0,4,4,19,4,17,40,0,3,1,4,16,0,10,26,10,2,0,12
141933,2022,USA,Serbia,0,0,0,0,1/7/2022,0,0,0,0,0,0,0,0,0,0,0,0,0,0,0,0,0,0,0,0
141933,2022,Belgium,USA,0,0,15,15,30/06/2022,0,0,1,1,11,2,9,22,1,1,1,3,6,0,12,18,12,2,0,14
141933,2022,Thailand,USA,1,3,9,13,19/06/2022,1,0,4,5,10,2,16,28,0,3,3,6,7,1,11,19,16,2,1,19
141933,2022,USA,China,1,1,9,11,18/06/2022,0,0,6,6,13,3,12,28,1,2,1,4,5,1,8,14,6,1,0,7
141933,2022,Poland,USA,0,0,0,0,17/06/2022,0,0,0,0,0,0,0,0,0,0,0,0,0,0,0,0,0,0,0,0
141933,2022,Bulgaria,USA,1,1,9,11,15/06/2022,0,0,2,2,13,5,11,29,0,2,2,4,3,1,12,16,4,1,0,5
166638,2022,USA,Serbia,0,1,12,13,13/07/2022,0,0,3,3,6,3,2,11,6,9,13,28,0,1,0,1,1,1,0,2
166638,2022,Thailand,USA,1,1,13,15,19/06/2022,0,0,1,1,8,0,5,13,1,6,8,15,0,0,0,0,2,0,1,3
166638,2022,USA,China,0,0,0,0,18/06/2022,0,0,0,0,0,0,0,0,0,0,0,0,0,0,0,0,0,0,0,0
166638,2022,Poland,USA,0,1,14,15,17/06/2022,0,0,0,0,7,0,4,11,2,6,5,13,0,0,0,0,1,2,1,4
166638,2022,Bulgaria,USA,0,0,0,0,15/06/2022,0,0,0,0,0,0,0,0,0,0,0,0,0,0,0,0,0,0,0,0
139848,2022,USA,Serbia,0,0,6,6,13/07/2022,0,0,3,3,14,3,5,22,2,0,1,3,11,1,19,31,8,3,0,11
139848,2022,Thailand,USA,1,1,15,17,19/06/2022,0,0,3,3,24,2,19,45,2,1,2,5,4,0,20,24,10,1,0,11
139848,2022,USA,China,0,0,0,0,18/06/2022,0,0,0,0,0,0,0,0,0,0,0,0,0,0,0,0,0,0,0,0
139848,2022,Poland,USA,0,0,11,11,17/06/2022,0,0,3,3,15,2,2,19,3,1,2,6,7,0,12,19,6,1,1,8
139848,2022,Bulgaria,USA,0,0,0,0,15/06/2022,0,0,0,0,0,0,0,0,0,0,0,0,0,0,0,0,0,0,0,0
139848,2022,Japan,USA,0,0,1,1,5/6/2022,0,0,0,0,1,1,0,2,1,1,0,2,3,1,3,7,2,0,0,2
139848,2022,USA,Brazil,0,0,7,7,5/6/2022,0,0,2,2,11,4,10,25,2,0,1,3,11,1,14,26,11,3,0,14
139848,2022,USA,Canada,0,0,0,0,4/6/2022,0,0,0,0,0,0,0,0,0,0,0,0,0,0,0,0,0,0,0,0
139848,2022,USA,Dominican Republic,0,1,8,9,1/6/2022,0,0,2,2,13,6,8,27,2,0,2,4,15,0,8,23,6,0,0,6
186519,2022,Thailand,USA,0,5,10,15,19/06/2022,0,0,2,2,7,3,7,17,3,4,8,15,0,0,0,0,1,0,0,1
186519,2022,USA,China,0,0,0,0,18/06/2022,0,0,0,0,0,0,0,0,0,0,0,0,0,0,0,0,0,0,0,0
186519,2022,Poland,USA,0,1,12,13,17/06/2022,0,0,1,1,5,2,3,10,1,2,4,7,0,0,0,0,1,0,0,1
186519,2022,Bulgaria,USA,0,0,0,0,15/06/2022,0,0,0,0,0,0,0,0,0,0,0,0,0,0,0,0,0,0,0,0
186519,2022,Japan,USA,0,2,9,11,5/6/2022,0,0,1,1,7,2,4,13,3,0,2,5,3,0,3,6,6,0,0,6
186519,2022,USA,Brazil,0,0,10,10,5/6/2022,0,0,1,1,4,0,4,8,2,2,4,8,0,0,0,0,1,0,0,1
186519,2022,USA,Canada,0,0,0,0,4/6/2022,0,0,0,0,0,0,0,0,0,0,0,0,0,0,0,0,0,0,0,0
186519,2022,USA,Dominican Republic,0,0,0,0,1/6/2022,0,0,0,0,0,0,0,0,0,0,0,0,0,0,0,0,0,0,0,0
143525,2022,Thailand,USA,0,0,9,9,19/06/2022,0,0,0,0,8,5,12,25,0,6,6,12,0,0,0,0,9,1,2,12
143525,2022,USA,China,0,0,0,0,18/06/2022,0,0,0,0,0,0,0,0,0,0,0,0,0,0,0,0,0,0,0,0
143525,2022,Poland,USA,0,0,12,12,17/06/2022,1,0,0,1,11,2,9,22,1,1,5,7,0,0,0,0,13,1,1,15
143525,2022,Bulgaria,USA,0,0,0,0,15/06/2022,0,0,0,0,0,0,0,0,0,0,0,0,0,0,0,0,0,0,0,0
152119,2023,Brazil,China,1,1,8,10,13/07/2023,0,0,0,0,1,1,2,4,2,0,2,4,0,0,0,0,3,0,1,4
152119,2023,Thailand,Brazil,0,0,0,0,2/7/2023,0,0,0,0,0,0,0,0,0,0,0,0,0,0,0,0,0,0,0,0
152119,2023,Brazil,Türkiye,0,0,4,4,30/06/2023,0,0,0,0,0,2,0,2,1,0,2,3,0,0,0,0,0,1,1,2
152119,2023,Brazil,Canada,0,0,0,0,29/06/2023,0,0,0,0,0,0,0,0,0,0,0,0,0,0,0,0,0,0,0,0
152119,2023,Brazil,Italy,0,0,2,2,28/06/2023,0,0,0,0,0,0,1,1,0,0,0,0,0,0,0,0,1,0,0,1
152119,2023,Brazil,USA,0,0,4,4,18/06/2023,0,0,0,0,3,0,0,3,3,1,0,4,0,0,0,0,1,0,0,1
152119,2023,Brazil,Germany,2,0,4,6,17/06/2023,0,0,1,1,2,1,1,4,2,10,1,13,0,0,0,0,2,0,1,3
152119,2023,Brazil,Serbia,0,0,0,0,16/06/2023,0,0,0,0,0,0,0,0,0,0,0,0,0,0,0,0,0,0,0,0
152119,2023,Brazil,Korea,2,0,10,12,15/06/2023,0,0,1,1,6,2,2,10,3,5,9,17,0,0,0,0,2,0,3,5
152119,2023,Croatia,Brazil,1,2,5,8,4/6/2023,0,0,1,1,6,0,2,8,2,0,3,5,0,1,1,2,1,0,1,2
152119,2023,Brazil,Dominican Republic,1,0,7,8,3/6/2023,0,0,1,1,9,4,2,15,2,9,6,17,1,0,0,1,3,0,1,4
152119,2023,Brazil,Netherlands,0,1,9,10,1/6/2023,0,0,0,0,2,2,1,5,1,1,6,8,0,0,0,0,1,1,0,2
152119,2023,China,Brazil,1,2,9,12,31/05/2023,0,0,0,0,14,0,5,19,1,2,4,7,0,0,0,0,2,0,1,3
152135,2023,Brazil,China,0,0,0,0,13/07/2023,0,0,0,0,0,0,0,0,0,0,0,0,0,0,0,0,0,0,0,0
152135,2023,Thailand,Brazil,0,0,0,0,2/7/2023,0,0,3,3,0,0,0,0,0,0,0,0,2,2,6,10,12,4,0,16
152135,2023,Brazil,Türkiye,0,0,0,0,30/06/2023,0,0,10,10,0,0,0,0,0,0,0,0,8,0,20,28,8,8,1,17
152135,2023,Brazil,Canada,0,0,0,0,29/06/2023,0,0,7,7,0,0,0,0,0,0,0,0,6,0,19,25,12,1,5,18
152135,2023,Brazil,Italy,0,0,0,0,28/06/2023,0,0,0,0,0,0,0,0,0,0,0,0,0,0,0,0,0,0,0,0
152135,2023,Brazil,USA,0,0,0,0,18/06/2023,0,0,5,5,0,0,0,0,0,0,0,0,2,2,8,12,6,5,0,11
152135,2023,Brazil,Germany,0,0,0,0,17/06/2023,0,0,4,4,0,0,0,0,0,0,0,0,6,0,2,8,11,2,2,15
152135,2023,Brazil,Serbia,0,0,0,0,16/06/2023,0,0,9,9,0,0,0,0,0,0,0,0,3,1,7,11,16,6,2,24
152135,2023,Brazil,Korea,0,0,0,0,15/06/2023,0,0,1,1,0,0,0,0,0,0,0,0,1,0,6,7,9,2,0,11
115970,2023,Brazil,China,0,0,0,0,13/07/2023,0,0,0,0,0,0,0,0,0,0,0,0,0,0,0,0,0,0,0,0
115970,2023,Thailand,Brazil,0,0,0,0,2/7/2023,0,0,0,0,0,0,0,0,0,0,0,0,0,0,0,0,0,0,0,0
115970,2023,Brazil,Türkiye,0,0,3,3,30/06/2023,0,0,1,1,1,3,4,8,1,3,2,6,2,1,11,14,8,0,2,10
115970,2023,Brazil,Canada,0,1,3,4,29/06/2023,0,0,1,1,3,2,7,12,1,1,0,2,2,0,5,7,2,1,0,3
115970,2023,Brazil,Italy,1,0,10,11,28/06/2023,0,0,1,1,3,2,13,18,1,1,4,6,6,1,9,16,8,1,2,11
115970,2023,Brazil,USA,0,0,0,0,18/06/2023,0,0,0,0,0,0,0,0,0,0,0,0,0,0,0,0,0,0,0,0
115970,2023,Brazil,Germany,0,0,4,4,17/06/2023,0,0,1,1,2,1,2,5,0,1,2,3,1,0,6,7,0,0,1,1
115970,2023,Brazil,Serbia,0,1,16,17,16/06/2023,0,0,4,4,12,1,15,28,0,3,2,5,9,3,19,31,11,7,1,19
115970,2023,Brazil,Korea,0,1,10,11,15/06/2023,0,0,0,0,6,5,5,16,1,0,2,3,6,0,14,20,14,3,2,19
113963,2023,Brazil,China,1,2,9,12,13/07/2023,0,0,4,4,17,3,5,25,0,3,3,6,0,1,2,3,1,2,0,3
113963,2023,Thailand,Brazil,1,3,13,17,2/7/2023,0,0,3,3,10,1,4,15,0,2,2,4,0,0,1,1,2,1,1,4
113963,2023,Brazil,Türkiye,0,2,6,8,30/06/2023,0,0,2,2,8,0,6,14,0,2,5,7,0,0,1,1,0,1,1,2
113963,2023,Brazil,Canada,1,4,14,19,29/06/2023,0,0,2,2,14,1,7,22,2,6,4,12,0,0,0,0,2,0,0,2
113963,2023,Brazil,Italy,1,2,14,17,28/06/2023,0,0,0,0,8,0,3,11,3,8,5,16,0,0,0,0,3,2,0,5
113963,2023,Brazil,USA,1,2,4,7,18/06/2023,0,0,0,0,10,2,3,15,1,4,3,8,0,0,0,0,2,0,2,4
113963,2023,Brazil,Germany,0,1,5,6,17/06/2023,0,0,2,2,3,0,6,9,4,3,3,10,0,0,0,0,3,0,0,3
113963,2023,Brazil,Serbia,1,0,16,17,16/06/2023,0,1,4,5,8,0,6,14,9,4,3,16,0,0,1,1,2,1,0,3
113963,2023,Brazil,Korea,1,1,11,13,15/06/2023,0,0,5,5,9,4,5,18,1,7,4,12,0,0,2,2,1,1,0,2
136897,2023,Brazil,China,0,0,0,0,13/07/2023,0,0,0,0,0,0,0,0,0,0,0,0,0,0,0,0,0,0,0,0
136897,2023,Thailand,Brazil,0,2,9,11,2/7/2023,0,0,1,1,6,2,10,18,2,0,2,4,0,0,0,0,9,1,0,10
136897,2023,Brazil,Türkiye,0,1,2,3,30/06/2023,0,0,2,2,3,3,3,9,0,2,1,3,0,0,0,0,2,0,0,2
136897,2023,Brazil,Canada,2,2,9,13,29/06/2023,0,0,2,2,13,10,8,31,0,1,2,3,0,0,0,0,2,2,0,4
136897,2023,Brazil,Italy,1,2,18,21,28/06/2023,0,0,2,2,18,7,17,42,2,6,2,10,0,0,0,0,4,3,1,8
136897,2023,Brazil,USA,0,1,1,2,18/06/2023,0,0,0,0,2,1,2,5,0,0,1,1,0,0,0,0,1,1,0,2
136897,2023,Brazil,Germany,1,0,9,10,17/06/2023,0,0,2,2,18,5,12,35,0,3,2,5,0,0,0,0,11,0,0,11
136897,2023,Brazil,Serbia,0,0,0,0,16/06/2023,0,0,0,0,1,2,2,5,0,0,1,1,0,0,0,0,0,0,0,0
136897,2023,Brazil,Korea,0,0,0,0,15/06/2023,0,0,0,0,1,1,1,3,0,0,1,1,0,0,0,0,0,0,0,0
151187,2023,Brazil,China,2,1,9,12,13/07/2023,36,0,72,108,2,0,1,3,0,1,1,2,0,0,0,0,4,2,2,8
151187,2023,Thailand,Brazil,0,0,9,9,2/7/2023,24,0,60,84,1,0,1,2,0,1,3,4,0,0,0,0,2,3,1,6
151187,2023,Brazil,Türkiye,0,2,2,4,30/06/2023,8,0,49,57,0,0,2,2,0,1,2,3,0,0,1,1,4,4,1,9
151187,2023,Brazil,Canada,0,1,3,4,29/06/2023,12,0,56,68,0,0,0,0,2,2,0,4,0,0,0,0,8,1,2,11
151187,2023,Brazil,Italy,0,0,3,3,28/06/2023,5,0,27,32,0,0,0,0,0,0,1,1,0,0,0,0,1,0,0,1
151187,2023,Brazil,USA,0,0,9,9,18/06/2023,5,0,51,56,0,0,2,2,0,2,2,4,0,0,0,0,1,4,1,6
151187,2023,Brazil,Germany,0,0,4,4,17/06/2023,8,0,18,26,0,0,1,1,0,2,1,3,0,0,0,0,0,0,0,0
151187,2023,Brazil,Serbia,0,0,14,14,16/06/2023,14,3,87,104,1,1,0,2,3,4,3,10,0,0,0,0,9,6,2,17
151187,2023,Brazil,Korea,0,0,12,12,15/06/2023,22,0,57,79,0,0,0,0,1,1,5,7,0,0,0,0,4,3,0,7
151187,2023,Croatia,Brazil,1,0,5,6,4/6/2023,2,0,56,58,1,0,0,1,1,0,1,2,0,0,0,0,2,0,0,2
151187,2023,Brazil,Dominican Republic,1,0,18,19,3/6/2023,8,1,113,122,1,1,2,4,0,1,2,3,0,0,0,0,6,1,2,9
151187,2023,Brazil,Netherlands,0,0,10,10,1/6/2023,5,3,73,81,1,0,2,3,0,1,1,2,0,0,0,0,4,0,0,4
151187,2023,China,Brazil,0,1,16,17,31/05/2023,11,1,110,122,0,0,1,1,0,0,1,1,0,0,0,0,4,0,2,6
119575,2023,Brazil,China,0,0,4,4,13/07/2023,8,0,7,15,0,0,0,0,0,0,0,0,0,0,0,0,0,0,0,0
119575,2023,Thailand,Brazil,0,0,0,0,2/7/2023,1,0,0,1,0,0,0,0,0,0,0,0,0,0,0,0,0,0,0,0
119575,2023,Brazil,Türkiye,0,1,6,7,30/06/2023,2,0,30,32,0,0,0,0,0,1,0,1,0,0,0,0,1,1,0,2
119575,2023,Brazil,Canada,0,0,11,11,29/06/2023,23,0,68,91,1,0,0,1,0,0,3,3,0,0,0,0,5,1,1,7
119575,2023,Brazil,Italy,0,2,11,13,28/06/2023,13,1,96,110,0,0,0,0,1,2,6,9,0,0,1,1,2,2,0,4
119575,2023,Brazil,USA,0,0,9,9,18/06/2023,8,0,20,28,0,0,0,0,0,1,0,1,0,0,0,0,3,3,0,6
119575,2023,Brazil,Germany,0,0,11,11,17/06/2023,12,0,69,81,1,0,3,4,0,5,3,8,0,0,0,0,9,2,1,12
119575,2023,Brazil,Serbia,0,0,3,3,16/06/2023,2,0,7,9,0,0,0,0,0,0,0,0,0,0,0,0,0,1,0,1
119575,2023,Brazil,Korea,0,0,5,5,15/06/2023,4,0,4,8,0,0,0,0,0,0,0,0,0,0,0,0,0,0,0,0
136896,2023,Brazil,China,1,2,12,15,13/07/2023,0,0,2,2,14,10,9,33,1,3,1,5,14,0,29,43,12,2,2,16
136896,2023,Thailand,Brazil,0,0,13,13,2/7/2023,0,0,2,2,17,6,7,30,1,0,3,4,9,0,11,20,5,1,3,9
136896,2023,Brazil,Türkiye,0,0,14,14,30/06/2023,0,0,2,2,7,4,16,27,0,1,1,2,7,0,6,13,6,4,1,11
136896,2023,Brazil,Canada,0,0,25,25,29/06/2023,0,0,2,2,19,14,30,63,1,2,2,5,14,1,10,25,14,3,0,17
136896,2023,Brazil,Italy,0,1,20,21,28/06/2023,0,1,1,2,24,9,17,50,1,5,4,10,10,0,11,21,13,6,1,20
141651,2023,Brazil,China,0,0,4,4,13/07/2023,0,1,3,4,2,2,5,9,0,0,0,0,2,0,12,14,2,2,0,4
141651,2023,Thailand,Brazil,0,0,14,14,2/7/2023,0,0,1,1,8,4,8,20,2,2,3,7,9,1,13,23,8,2,2,12
141651,2023,Brazil,Türkiye,1,1,6,8,30/06/2023,0,0,1,1,10,5,16,31,1,3,2,6,2,0,11,13,5,1,0,6
141651,2023,Brazil,Canada,0,1,9,10,29/06/2023,0,0,0,0,10,3,7,20,1,2,1,4,4,0,10,14,6,1,0,7
141651,2023,Brazil,Italy,1,0,3,4,28/06/2023,0,0,1,1,3,2,6,11,0,0,0,0,2,0,6,8,1,0,0,1
141651,2023,Brazil,USA,0,2,11,13,18/06/2023,0,0,2,2,10,2,10,22,1,2,2,5,3,0,6,9,7,4,0,11
141651,2023,Brazil,Germany,1,3,14,18,17/06/2023,0,0,6,6,17,3,20,40,0,2,9,11,6,2,8,16,6,1,0,7
141651,2023,Brazil,Serbia,1,0,13,14,16/06/2023,0,0,2,2,10,3,9,22,0,0,3,3,6,0,11,17,5,4,1,10
141651,2023,Brazil,Korea,0,1,1,2,15/06/2023,0,0,0,0,0,0,0,0,0,0,0,0,0,0,0,0,0,0,0,0
141651,2023,Croatia,Brazil,0,0,4,4,4/6/2023,0,0,0,0,0,0,0,0,0,0,0,0,0,0,1,1,1,0,0,1
141651,2023,Brazil,Dominican Republic,0,1,3,4,3/6/2023,0,0,0,0,0,0,0,0,0,0,0,0,0,0,0,0,0,0,0,0
141651,2023,Brazil,Netherlands,1,0,3,4,1/6/2023,0,0,0,0,0,0,0,0,0,0,0,0,0,0,0,0,1,0,0,1
141651,2023,China,Brazil,0,0,1,1,31/05/2023,0,0,0,0,0,0,0,0,0,0,0,0,0,0,0,0,0,0,0,0
164674,2023,Brazil,China,0,0,0,0,13/07/2023,0,0,12,12,0,0,0,0,0,0,0,0,7,0,3,10,8,5,1,14
164674,2023,Thailand,Brazil,0,0,0,0,2/7/2023,0,0,0,0,0,0,0,0,0,0,0,0,0,0,0,0,0,0,0,0
164674,2023,Brazil,Türkiye,0,0,0,0,30/06/2023,0,0,0,0,0,0,0,0,0,0,0,0,0,0,0,0,0,0,0,0
164674,2023,Brazil,Canada,0,0,0,0,29/06/2023,0,0,5,5,0,0,0,0,0,0,0,0,6,0,18,24,6,1,1,8
164674,2023,Brazil,Italy,0,0,0,0,28/06/2023,0,0,8,8,0,0,0,0,0,0,0,0,12,0,34,46,22,4,0,26
164674,2023,Brazil,USA,0,0,0,0,18/06/2023,0,0,0,0,0,0,0,0,0,0,0,0,0,0,0,0,0,0,0,0
164674,2023,Brazil,Germany,0,0,0,0,17/06/2023,0,0,6,6,0,0,0,0,0,0,0,0,0,0,4,4,9,2,1,12
164674,2023,Brazil,Serbia,0,0,0,0,16/06/2023,0,0,0,0,0,0,0,0,0,0,0,0,0,0,0,0,0,0,0,0
164674,2023,Brazil,Korea,0,0,0,0,15/06/2023,0,0,0,0,0,0,0,0,0,0,0,0,0,0,0,0,0,0,0,0
164674,2023,Croatia,Brazil,0,0,0,0,4/6/2023,0,0,0,0,0,0,0,0,0,0,0,0,0,0,0,0,0,0,0,0
164674,2023,Brazil,Dominican Republic,0,0,0,0,3/6/2023,0,0,5,5,0,0,0,0,0,0,0,0,14,0,15,29,16,2,4,22
164674,2023,Brazil,Netherlands,0,0,0,0,1/6/2023,0,0,8,8,0,0,0,0,0,0,0,0,5,1,10,16,12,0,0,12
164674,2023,China,Brazil,0,0,0,0,31/05/2023,0,0,6,6,0,0,0,0,0,0,0,0,8,1,11,20,14,0,1,15
144866,2023,Brazil,China,0,1,6,7,13/07/2023,0,0,2,2,5,1,1,7,2,4,3,9,0,0,0,0,0,1,1,2
144866,2023,Thailand,Brazil,1,3,6,10,2/7/2023,0,0,0,0,8,1,1,10,5,5,7,17,0,0,0,0,0,0,0,0
144866,2023,Brazil,Türkiye,0,1,6,7,30/06/2023,0,0,1,1,4,1,2,7,2,3,0,5,0,0,0,0,1,0,0,1
144866,2023,Brazil,Canada,0,1,19,20,29/06/2023,0,0,2,2,5,3,4,12,6,4,9,19,0,0,0,0,3,1,1,5
144866,2023,Brazil,Italy,1,1,16,18,28/06/2023,0,0,1,1,11,3,6,20,2,6,5,13,0,0,0,0,3,1,0,4
144866,2023,Brazil,USA,0,1,5,6,18/06/2023,0,0,1,1,2,1,3,6,3,3,2,8,0,0,0,0,3,1,0,4
144866,2023,Brazil,Germany,0,1,13,14,17/06/2023,0,0,0,0,7,1,3,11,3,4,0,7,0,0,0,0,1,1,0,2
144866,2023,Brazil,Serbia,0,1,19,20,16/06/2023,0,0,3,3,9,2,8,19,3,9,8,20,0,0,0,0,3,3,0,6
144866,2023,Brazil,Korea,0,0,0,0,15/06/2023,0,0,0,0,0,0,0,0,0,0,0,0,0,0,0,0,0,0,0,0
144866,2023,Croatia,Brazil,1,1,11,13,4/6/2023,0,0,0,0,6,2,3,11,2,1,2,5,2,0,2,4,2,0,0,2
144866,2023,Brazil,Dominican Republic,1,2,15,18,3/6/2023,0,0,2,2,1,1,4,6,4,3,3,10,0,0,0,0,1,0,2,3
144866,2023,Brazil,Netherlands,3,0,12,15,1/6/2023,0,0,0,0,0,2,3,5,0,2,2,4,0,0,0,0,1,0,0,1
144866,2023,China,Brazil,0,1,16,17,31/05/2023,0,0,1,1,7,0,7,14,2,2,4,8,0,0,0,0,1,0,2,3
171260,2023,Brazil,China,1,1,5,7,13/07/2023,0,0,0,0,5,4,9,18,0,1,1,2,0,0,0,0,3,3,0,6
171260,2023,Brazil,USA,0,1,4,5,18/06/2023,0,0,1,1,10,3,13,26,1,3,0,4,0,0,0,0,5,1,1,7
171260,2023,Brazil,Germany,0,1,1,2,17/06/2023,0,0,0,0,1,1,4,6,0,1,0,1,0,0,0,0,1,1,0,2
171260,2023,Brazil,Serbia,0,4,14,18,16/06/2023,0,0,1,1,13,7,12,32,3,3,5,11,0,0,0,0,11,3,2,16
171260,2023,Brazil,Korea,0,1,6,7,15/06/2023,0,0,1,1,13,1,7,21,2,2,3,7,0,0,0,0,6,0,1,7
171260,2023,Croatia,Brazil,0,0,0,0,4/6/2023,0,0,0,0,0,0,0,0,0,0,0,0,0,0,0,0,0,0,0,0
171260,2023,Brazil,Dominican Republic,1,0,9,10,3/6/2023,0,0,2,2,10,4,17,31,1,3,0,4,0,0,0,0,8,0,0,8
171260,2023,Brazil,Netherlands,1,2,11,14,1/6/2023,0,0,0,0,10,4,5,19,0,1,3,4,0,0,0,0,5,0,1,6
171260,2023,China,Brazil,1,2,13,16,31/05/2023,0,0,1,1,16,3,14,33,4,0,0,4,0,0,0,0,9,0,3,12
162999,2023,Brazil,China,0,2,8,10,13/07/2023,0,0,0,0,4,3,11,18,0,3,0,3,3,0,14,17,9,2,1,12
162999,2023,Thailand,Brazil,0,0,0,0,2/7/2023,0,0,0,0,0,0,0,0,0,0,0,0,0,0,0,0,0,0,0,0
162999,2023,Brazil,Türkiye,0,0,0,0,30/06/2023,0,0,0,0,0,0,0,0,0,0,0,0,0,0,0,0,0,0,0,0
162999,2023,Brazil,Canada,0,1,2,3,29/06/2023,0,0,0,0,1,1,2,4,0,1,0,1,1,2,9,12,1,0,0,1
162999,2023,Brazil,Italy,0,0,0,0,28/06/2023,0,0,0,0,0,0,1,1,0,0,0,0,0,0,0,0,0,0,0,0
162999,2023,Brazil,USA,1,0,9,10,18/06/2023,0,0,1,1,6,6,6,18,0,1,0,1,11,5,32,48,2,2,0,4
162999,2023,Brazil,Germany,2,2,13,17,17/06/2023,0,0,0,0,9,1,11,21,0,1,2,3,10,1,28,39,4,2,0,6
162999,2023,Brazil,Serbia,0,1,4,5,16/06/2023,0,0,0,0,0,6,8,14,0,1,0,1,2,0,17,19,5,1,1,7
162999,2023,Brazil,Korea,1,2,12,15,15/06/2023,0,0,1,1,14,5,6,25,0,2,1,3,6,3,19,28,8,2,0,10
162999,2023,Croatia,Brazil,1,1,13,15,4/6/2023,0,0,1,1,3,5,9,17,1,0,0,1,3,1,11,15,10,0,0,10
162999,2023,Brazil,Dominican Republic,0,3,14,17,3/6/2023,0,0,2,2,11,10,11,32,2,4,3,9,9,2,21,32,7,1,2,10
162999,2023,Brazil,Netherlands,1,1,8,10,1/6/2023,0,0,0,0,10,4,9,23,2,0,1,3,9,2,22,33,4,0,1,5
162999,2023,China,Brazil,0,4,16,20,31/05/2023,0,0,1,1,15,8,8,31,1,0,0,1,12,1,26,39,9,1,2,12
163000,2023,Brazil,China,2,3,4,9,13/07/2023,0,0,1,1,10,6,9,25,1,2,2,5,0,0,0,0,8,2,1,11
163000,2023,Croatia,Brazil,0,0,0,0,4/6/2023,0,0,0,0,2,0,0,2,2,0,0,2,0,0,0,0,1,0,0,1
163000,2023,Brazil,Dominican Republic,0,0,0,0,3/6/2023,0,0,0,0,0,0,0,0,0,0,0,0,0,0,0,0,0,0,0,0
163000,2023,Brazil,Netherlands,0,0,0,0,1/6/2023,0,0,0,0,0,0,0,0,0,0,0,0,0,0,0,0,0,0,0,0
163000,2023,China,Brazil,0,0,0,0,31/05/2023,0,0,0,0,1,0,1,2,0,0,0,0,0,0,0,0,0,0,1,1
151859,2023,Serbia,Bulgaria,1,1,1,3,2/7/2023,0,1,1,2,0,0,1,1,2,0,0,2,0,0,6,6,0,0,0,0
151859,2023,Bulgaria,Poland,0,0,2,2,30/06/2023,0,0,1,1,4,1,1,6,0,2,0,2,0,1,6,7,2,1,0,3
151859,2023,USA,Bulgaria,0,0,0,0,29/06/2023,0,0,0,0,0,0,0,0,0,0,0,0,0,0,0,0,0,0,0,0
151859,2023,Bulgaria,Korea,0,0,0,0,27/06/2023,0,0,0,0,0,0,0,0,0,0,0,0,0,0,0,0,0,0,0,0
151859,2023,Bulgaria,Netherlands,0,0,0,0,18/06/2023,0,0,0,0,0,0,0,0,0,0,0,0,0,0,0,0,0,0,0,0
151859,2023,Bulgaria,China,0,0,1,1,16/06/2023,0,0,1,1,0,4,5,9,0,0,0,0,0,1,6,7,0,2,0,2
151859,2023,Bulgaria,Canada,0,2,5,7,15/06/2023,0,0,1,1,7,6,14,27,0,1,1,2,3,0,11,14,2,1,0,3
151859,2023,Italy,Bulgaria,0,0,0,0,14/06/2023,0,0,1,1,0,0,0,0,0,0,0,0,1,1,0,2,1,0,0,1
153422,2023,Serbia,Bulgaria,0,0,0,0,2/7/2023,0,0,4,4,0,0,0,0,0,0,0,0,0,0,0,0,0,0,0,0
153422,2023,Bulgaria,Poland,0,0,0,0,30/06/2023,0,0,6,6,0,0,0,0,0,0,0,0,0,0,0,0,0,0,0,0
153422,2023,USA,Bulgaria,0,0,1,1,29/06/2023,4,1,30,35,0,0,1,1,1,0,0,1,0,0,0,0,0,1,0,1
153422,2023,Bulgaria,Korea,0,0,0,0,27/06/2023,0,0,0,0,0,0,0,0,0,0,0,0,0,0,0,0,0,0,0,0
153422,2023,Bulgaria,Netherlands,0,0,0,0,18/06/2023,0,0,0,0,0,0,0,0,0,0,0,0,0,0,0,0,0,0,0,0
153422,2023,Bulgaria,China,0,0,0,0,16/06/2023,1,0,7,8,0,0,0,0,0,1,0,1,0,0,0,0,1,0,0,1
153422,2023,Bulgaria,Canada,0,1,0,1,15/06/2023,2,0,25,27,0,1,0,1,1,0,1,2,0,0,0,0,2,1,2,5
153422,2023,Italy,Bulgaria,0,1,2,3,14/06/2023,2,0,23,25,1,0,1,2,0,0,2,2,0,0,0,0,1,0,1,2
153422,2023,Germany,Bulgaria,0,0,1,1,4/6/2023,1,0,19,20,0,0,0,0,0,0,0,0,0,0,0,0,1,0,0,1
153422,2023,Bulgaria,Japan,0,0,1,1,3/6/2023,0,0,16,16,0,0,0,0,1,0,0,1,0,0,0,0,1,0,0,1
153422,2023,Bulgaria,Dominican Republic,0,0,0,0,1/6/2023,3,1,16,20,0,0,0,0,0,0,1,1,0,0,0,0,0,0,0,0
153422,2023,Croatia,Bulgaria,0,0,0,0,31/05/2023,0,0,0,0,0,0,0,0,0,0,0,0,0,0,0,0,0,0,0,0
174474,2023,Serbia,Bulgaria,1,2,12,15,2/7/2023,0,0,4,4,9,7,18,34,1,2,5,8,1,1,5,7,6,7,0,13
174474,2023,Bulgaria,Poland,2,2,11,15,30/06/2023,0,0,4,4,10,5,13,28,0,3,1,4,4,0,24,28,9,1,1,11
174474,2023,USA,Bulgaria,2,1,8,11,29/06/2023,0,0,1,1,8,10,11,29,0,2,3,5,1,0,7,8,6,0,0,6
174474,2023,Bulgaria,Korea,3,4,15,22,27/06/2023,0,0,2,2,15,8,11,34,0,3,2,5,9,0,11,20,12,4,0,16
174474,2023,Bulgaria,Netherlands,1,2,7,10,18/06/2023,0,0,2,2,9,6,12,27,0,2,0,2,4,2,29,35,6,0,0,6
174474,2023,Bulgaria,China,0,1,7,8,16/06/2023,0,1,2,3,5,8,11,24,0,0,0,0,3,2,33,38,4,5,3,12
174474,2023,Bulgaria,Canada,0,1,6,7,15/06/2023,0,0,4,4,9,3,12,24,0,1,0,1,3,1,13,17,6,1,2,9
174474,2023,Italy,Bulgaria,1,4,5,10,14/06/2023,0,0,0,0,11,6,21,38,0,4,4,8,8,0,24,32,6,6,0,12
174474,2023,Germany,Bulgaria,3,2,15,20,4/6/2023,0,0,0,0,25,9,25,59,0,0,2,2,5,2,13,20,13,0,3,16
174474,2023,Bulgaria,Japan,1,1,9,11,3/6/2023,0,0,4,4,7,3,10,20,0,1,0,1,4,2,19,25,3,0,1,4
174474,2023,Bulgaria,Dominican Republic,2,0,12,14,1/6/2023,0,0,2,2,12,3,27,42,0,2,3,5,14,2,26,42,17,1,1,19
174474,2023,Croatia,Bulgaria,3,1,8,12,31/05/2023,0,0,1,1,10,6,5,21,0,0,4,4,4,0,14,18,8,0,1,9
153421,2023,Serbia,Bulgaria,0,0,1,1,2/7/2023,0,0,0,0,0,1,0,1,0,1,1,2,0,0,0,0,0,0,0,0
153421,2023,Bulgaria,Poland,0,0,0,0,30/06/2023,0,0,0,0,0,1,0,1,0,0,0,0,0,0,0,0,0,0,0,0
153421,2023,USA,Bulgaria,0,1,5,6,29/06/2023,0,0,0,0,4,3,9,16,1,2,1,4,0,0,0,0,0,0,0,0
153421,2023,Bulgaria,Korea,0,0,0,0,27/06/2023,0,0,0,0,0,0,0,0,0,0,0,0,0,0,0,0,0,0,0,0
153421,2023,Bulgaria,Netherlands,0,0,0,0,18/06/2023,0,0,0,0,0,0,0,0,0,0,0,0,0,0,0,0,0,0,0,0
153421,2023,Bulgaria,China,0,0,1,1,16/06/2023,0,0,1,1,2,3,1,6,0,0,0,0,0,0,0,0,1,2,0,3
153421,2023,Bulgaria,Canada,0,0,1,1,15/06/2023,0,0,0,0,1,0,3,4,0,0,0,0,0,0,0,0,0,0,0,0
153421,2023,Italy,Bulgaria,0,0,2,2,14/06/2023,0,0,0,0,0,1,0,1,0,0,0,0,0,0,0,0,0,1,1,2
153421,2023,Germany,Bulgaria,0,2,0,2,4/6/2023,0,0,0,0,2,2,3,7,0,0,0,0,0,0,0,0,0,0,0,0
153421,2023,Bulgaria,Japan,0,1,1,2,3/6/2023,0,0,0,0,4,1,2,7,0,0,0,0,0,0,0,0,0,0,0,0
153421,2023,Bulgaria,Dominican Republic,0,0,3,3,1/6/2023,0,0,0,0,0,0,3,3,0,0,0,0,0,0,1,1,1,0,0,1
153421,2023,Croatia,Bulgaria,0,0,0,0,31/05/2023,0,0,0,0,0,0,0,0,0,0,0,0,0,0,0,0,0,0,0,0
142348,2023,Serbia,Bulgaria,1,1,12,14,2/7/2023,9,2,92,103,0,0,4,4,1,5,6,12,0,0,1,1,8,3,2,13
142348,2023,Bulgaria,Poland,0,0,16,16,30/06/2023,6,1,102,109,1,0,1,2,1,3,7,11,0,0,0,0,5,0,1,6
142348,2023,USA,Bulgaria,0,1,0,1,29/06/2023,5,0,44,49,0,1,0,1,1,3,0,4,0,0,0,0,2,3,0,5
142348,2023,Bulgaria,Korea,0,1,12,13,27/06/2023,23,0,94,117,0,0,3,3,2,3,3,8,0,0,0,0,3,0,1,4
142348,2023,Bulgaria,Netherlands,1,0,8,9,18/06/2023,9,0,76,85,0,1,1,2,0,3,4,7,0,0,0,0,4,2,0,6
142348,2023,Bulgaria,China,0,0,9,9,16/06/2023,21,0,60,81,1,0,1,2,0,1,2,3,0,1,0,1,3,1,1,5
142348,2023,Bulgaria,Canada,0,0,4,4,15/06/2023,5,0,51,56,0,0,3,3,0,2,1,3,0,0,0,0,1,1,0,2
142348,2023,Italy,Bulgaria,0,0,4,4,14/06/2023,6,0,60,66,1,1,1,3,0,1,1,2,0,2,0,2,2,2,0,4
142348,2023,Germany,Bulgaria,0,1,11,12,4/6/2023,5,0,116,121,2,0,1,3,0,0,2,2,0,0,0,0,11,0,3,14
142348,2023,Bulgaria,Japan,0,0,5,5,3/6/2023,5,1,55,61,0,0,0,0,1,2,2,5,0,0,0,0,1,0,0,1
142348,2023,Bulgaria,Dominican Republic,0,0,10,10,1/6/2023,3,0,102,105,4,0,4,8,0,4,2,6,0,0,1,1,9,1,4,14
142348,2023,Croatia,Bulgaria,2,0,12,14,31/05/2023,2,0,74,76,1,0,0,1,0,0,1,1,0,0,0,0,9,0,0,9
163256,2023,Serbia,Bulgaria,1,0,8,9,2/7/2023,0,1,1,2,6,4,14,24,0,1,1,2,4,2,28,34,10,3,1,14
163256,2023,Bulgaria,Poland,2,0,8,10,30/06/2023,0,0,1,1,7,11,15,33,1,3,0,4,2,2,27,31,6,0,0,6
163256,2023,USA,Bulgaria,1,1,5,7,29/06/2023,0,0,4,4,5,7,9,21,0,0,0,0,3,3,19,25,11,2,0,13
163256,2023,Bulgaria,Korea,0,2,13,15,27/06/2023,0,0,2,2,7,2,17,26,1,3,4,8,4,2,24,30,13,2,0,15
163256,2023,Bulgaria,Netherlands,0,1,6,7,18/06/2023,0,0,4,4,6,9,11,26,0,2,0,2,3,1,16,20,2,1,0,3
163256,2023,Bulgaria,China,0,2,8,10,16/06/2023,0,0,2,2,4,6,10,20,0,1,1,2,5,2,20,27,6,1,4,11
163256,2023,Bulgaria,Canada,0,0,3,3,15/06/2023,0,0,0,0,5,6,5,16,0,3,0,3,1,2,11,14,2,1,0,3
163256,2023,Italy,Bulgaria,2,1,11,14,14/06/2023,0,0,4,4,6,4,12,22,1,1,0,2,1,0,27,28,5,4,1,10
163256,2023,Germany,Bulgaria,0,1,15,16,4/6/2023,0,0,2,2,16,4,12,32,0,1,2,3,2,3,33,38,9,0,1,10
163256,2023,Bulgaria,Japan,1,1,7,9,3/6/2023,0,0,2,2,3,2,12,17,2,3,1,6,7,2,10,19,2,0,3,5
163256,2023,Bulgaria,Dominican Republic,0,0,10,10,1/6/2023,0,0,0,0,16,4,17,37,1,1,1,3,5,1,25,31,6,0,0,6
163256,2023,Croatia,Bulgaria,0,0,3,3,31/05/2023,0,0,0,0,1,2,2,5,1,0,0,1,1,0,1,2,0,0,0,0
142337,2023,Serbia,Bulgaria,3,1,12,16,2/7/2023,0,0,0,0,3,3,7,13,5,3,5,13,0,0,1,1,4,2,0,6
142337,2023,Bulgaria,Poland,0,1,11,12,30/06/2023,0,0,0,0,7,1,5,13,1,6,3,10,0,0,2,2,3,2,0,5
142337,2023,USA,Bulgaria,0,1,5,6,29/06/2023,0,0,1,1,3,4,3,10,3,2,1,6,0,0,0,0,3,0,0,3
142337,2023,Bulgaria,Korea,1,0,11,12,27/06/2023,0,0,2,2,8,1,8,17,7,4,15,26,2,0,1,3,3,0,0,3
142337,2023,Bulgaria,Netherlands,0,3,5,8,18/06/2023,0,0,1,1,7,3,5,15,5,2,5,12,0,0,0,0,3,2,1,6
142337,2023,Bulgaria,China,0,0,7,7,16/06/2023,0,0,0,0,7,2,4,13,2,3,4,9,0,0,0,0,2,2,0,4
142337,2023,Bulgaria,Canada,0,0,3,3,15/06/2023,0,0,0,0,2,1,3,6,2,1,3,6,1,0,0,1,0,0,0,0
142337,2023,Italy,Bulgaria,0,1,6,7,14/06/2023,0,0,1,1,6,1,3,10,1,5,1,7,0,0,0,0,0,0,0,0
142337,2023,Germany,Bulgaria,0,2,11,13,4/6/2023,0,0,2,2,6,4,6,16,4,2,5,11,0,0,1,1,5,0,0,5
142337,2023,Bulgaria,Japan,0,1,6,7,3/6/2023,0,0,0,0,5,4,2,11,2,2,1,5,1,0,1,2,3,0,1,4
142337,2023,Bulgaria,Dominican Republic,3,1,14,18,1/6/2023,0,0,2,2,3,1,7,11,1,2,0,3,0,0,0,0,4,0,0,4
142337,2023,Croatia,Bulgaria,1,0,8,9,31/05/2023,0,0,1,1,2,0,6,8,6,3,2,11,0,0,0,0,4,0,0,4
164660,2023,Serbia,Bulgaria,1,0,9,10,2/7/2023,1,0,1,2,3,0,3,6,1,1,3,5,1,0,1,2,2,0,0,2
164660,2023,Bulgaria,Poland,0,1,4,5,30/06/2023,0,0,1,1,0,0,4,4,1,4,2,7,0,0,0,0,0,2,0,2
164660,2023,USA,Bulgaria,0,0,8,8,29/06/2023,0,0,1,1,0,0,0,0,0,1,1,2,0,0,0,0,1,0,0,1
164660,2023,Bulgaria,Korea,0,0,9,9,27/06/2023,0,0,0,0,0,0,0,0,0,0,0,0,0,0,0,0,1,0,0,1
164660,2023,Bulgaria,Netherlands,0,0,0,0,18/06/2023,0,0,1,1,0,0,0,0,0,0,0,0,0,0,1,1,0,0,0,0
164660,2023,Bulgaria,China,0,0,0,0,16/06/2023,0,0,0,0,0,0,0,0,0,0,0,0,0,0,0,0,0,0,0,0
164660,2023,Bulgaria,Canada,0,0,2,2,15/06/2023,0,1,3,4,0,1,3,4,0,1,3,4,0,0,0,0,1,2,1,4
164660,2023,Italy,Bulgaria,0,0,0,0,14/06/2023,0,0,0,0,0,0,0,0,0,0,0,0,0,0,0,0,0,0,0,0
164660,2023,Germany,Bulgaria,0,0,0,0,4/6/2023,0,0,0,0,0,0,0,0,0,0,0,0,0,0,0,0,0,0,0,0
164660,2023,Bulgaria,Japan,0,0,4,4,3/6/2023,0,0,4,4,2,0,3,5,0,0,3,3,0,0,0,0,1,0,0,1
164660,2023,Bulgaria,Dominican Republic,0,1,5,6,1/6/2023,0,0,2,2,1,0,2,3,1,4,4,9,0,0,0,0,0,0,1,1
164660,2023,Croatia,Bulgaria,2,2,13,17,31/05/2023,0,0,0,0,0,0,1,1,1,2,2,5,0,0,0,0,2,0,1,3
174478,2023,Serbia,Bulgaria,0,0,0,0,2/7/2023,0,0,10,10,0,0,0,0,0,0,0,0,7,5,27,39,14,7,0,21
174478,2023,Bulgaria,Poland,0,0,0,0,30/06/2023,0,1,10,11,0,0,0,0,0,0,0,0,0,1,12,13,14,9,0,23
174478,2023,USA,Bulgaria,0,0,0,0,29/06/2023,0,0,7,7,0,0,0,0,0,0,0,0,6,4,20,30,12,4,0,16
174478,2023,Bulgaria,Korea,0,0,0,0,27/06/2023,0,0,11,11,0,0,0,0,0,0,0,0,2,4,9,15,23,5,3,31
174478,2023,Bulgaria,Netherlands,0,0,0,0,18/06/2023,0,0,6,6,0,0,0,0,0,0,0,0,1,0,12,13,15,4,2,21
174478,2023,Bulgaria,China,0,0,0,0,16/06/2023,0,0,8,8,0,0,0,0,0,0,0,0,2,2,8,12,7,4,1,12
174478,2023,Bulgaria,Canada,0,0,0,0,15/06/2023,0,0,5,5,0,0,0,0,0,0,0,0,1,1,14,16,9,2,0,11
174478,2023,Italy,Bulgaria,0,0,0,0,14/06/2023,0,0,5,5,0,0,0,0,0,0,0,0,0,0,5,5,14,3,1,18
174478,2023,Germany,Bulgaria,0,0,0,0,4/6/2023,0,0,15,15,0,0,0,0,0,0,0,0,7,1,23,31,25,1,5,31
174478,2023,Bulgaria,Japan,0,0,0,0,3/6/2023,0,0,2,2,0,0,0,0,0,0,0,0,3,0,8,11,9,0,0,9
174478,2023,Bulgaria,Dominican Republic,0,0,0,0,1/6/2023,0,0,9,9,0,0,0,0,0,0,0,0,5,1,9,15,20,2,3,25
174478,2023,Croatia,Bulgaria,0,0,0,0,31/05/2023,0,0,10,10,0,0,0,0,0,0,0,0,3,1,9,13,14,0,4,18
163261,2023,Serbia,Bulgaria,0,0,2,2,2/7/2023,0,0,1,1,1,0,1,2,2,3,2,7,0,0,0,0,1,0,0,1
163261,2023,Bulgaria,Poland,0,2,5,7,30/06/2023,0,0,1,1,0,0,2,2,3,4,4,11,0,0,0,0,0,0,0,0
163261,2023,USA,Bulgaria,0,1,2,3,29/06/2023,0,0,0,0,2,1,1,4,0,0,0,0,0,0,0,0,1,0,0,1
163261,2023,Bulgaria,Korea,2,4,8,14,27/06/2023,0,1,0,1,2,1,3,6,2,8,7,17,0,0,0,0,0,1,1,2
163261,2023,Bulgaria,Netherlands,0,4,7,11,18/06/2023,0,0,1,1,1,0,5,6,0,2,6,8,0,0,0,0,0,0,0,0
163261,2023,Bulgaria,China,0,3,9,12,16/06/2023,0,0,0,0,4,0,0,4,2,3,4,9,0,0,0,0,1,1,2,4
163261,2023,Bulgaria,Canada,2,1,7,10,15/06/2023,0,0,2,2,0,0,2,2,0,2,8,10,0,0,2,2,4,0,1,5
163261,2023,Italy,Bulgaria,1,1,6,8,14/06/2023,0,0,0,0,2,2,1,5,0,2,5,7,0,0,0,0,2,0,0,2
163261,2023,Germany,Bulgaria,1,5,15,21,4/6/2023,0,0,2,2,1,0,3,4,1,1,3,5,0,0,0,0,3,1,0,4
163261,2023,Bulgaria,Japan,2,1,5,8,3/6/2023,0,0,0,0,1,0,5,6,0,2,2,4,0,0,0,0,0,0,0,0
163261,2023,Bulgaria,Dominican Republic,1,0,12,13,1/6/2023,0,0,1,1,2,0,1,3,1,1,0,2,0,0,1,1,2,0,0,2
163261,2023,Croatia,Bulgaria,0,0,0,0,31/05/2023,0,0,0,0,0,0,0,0,0,0,0,0,0,0,0,0,0,0,0,0
163141,2023,Serbia,Bulgaria,0,0,15,15,2/7/2023,0,0,3,3,18,6,24,48,0,3,4,7,0,0,0,0,8,1,1,10
163141,2023,Bulgaria,Poland,1,1,8,10,30/06/2023,0,1,3,4,17,4,27,48,1,2,2,5,0,0,1,1,8,2,0,10
163141,2023,USA,Bulgaria,0,1,6,7,29/06/2023,0,0,1,1,3,2,13,18,0,0,1,1,0,0,0,0,3,1,0,4
163141,2023,Bulgaria,Korea,0,2,12,14,27/06/2023,0,0,1,1,18,7,26,51,1,2,4,7,0,0,0,0,6,3,0,9
163141,2023,Bulgaria,Netherlands,0,0,0,0,18/06/2023,0,0,0,0,0,0,0,0,0,0,0,0,0,0,0,0,0,0,0,0
163141,2023,Bulgaria,China,0,0,4,4,16/06/2023,0,0,0,0,9,1,7,17,1,4,1,6,0,0,0,0,2,1,0,3
163141,2023,Bulgaria,Canada,0,0,2,2,15/06/2023,0,0,2,2,2,3,3,8,0,0,0,0,0,0,0,0,2,1,0,3
163141,2023,Italy,Bulgaria,1,2,7,10,14/06/2023,0,0,0,0,10,2,8,20,0,0,1,1,0,0,0,0,5,2,0,7
163141,2023,Germany,Bulgaria,1,0,18,19,4/6/2023,0,0,0,0,13,7,22,42,1,1,2,4,0,0,0,0,9,0,1,10
163141,2023,Bulgaria,Japan,0,0,2,2,3/6/2023,0,1,0,1,3,1,1,5,0,0,1,1,0,0,0,0,3,0,0,3
163141,2023,Bulgaria,Dominican Republic,1,0,13,14,1/6/2023,0,0,2,2,11,7,25,43,1,2,3,6,0,0,0,0,5,1,2,8
163141,2023,Croatia,Bulgaria,1,2,7,10,31/05/2023,0,0,3,3,11,4,19,34,0,1,0,1,0,0,0,0,6,0,0,6
163144,2023,Serbia,Bulgaria,0,0,0,0,2/7/2023,0,0,1,1,0,1,1,2,0,0,0,0,0,0,0,0,0,0,0,0
163144,2023,Bulgaria,Poland,0,0,0,0,30/06/2023,0,0,0,0,0,0,0,0,0,0,0,0,0,0,0,0,0,0,0,0
163144,2023,USA,Bulgaria,0,0,0,0,29/06/2023,0,0,1,1,0,0,0,0,0,0,0,0,0,0,0,0,0,1,0,1
163144,2023,Bulgaria,Korea,0,0,0,0,27/06/2023,0,0,0,0,0,0,0,0,0,0,0,0,0,0,0,0,0,0,0,0
163144,2023,Bulgaria,Netherlands,0,0,0,0,18/06/2023,0,0,0,0,0,0,0,0,0,0,0,0,0,0,0,0,0,0,0,0
163144,2023,Bulgaria,China,0,0,1,1,16/06/2023,0,0,0,0,2,0,0,2,0,0,0,0,0,1,2,3,0,0,1,1
163144,2023,Bulgaria,Canada,0,0,0,0,15/06/2023,0,0,0,0,0,0,0,0,0,0,0,0,0,0,0,0,0,0,0,0
163144,2023,Italy,Bulgaria,0,0,0,0,14/06/2023,0,0,0,0,0,0,0,0,0,0,0,0,0,0,0,0,0,0,0,0
163144,2023,Germany,Bulgaria,0,0,0,0,4/6/2023,0,0,0,0,0,0,1,1,0,0,0,0,0,0,2,2,2,0,0,2
163144,2023,Bulgaria,Japan,0,0,0,0,3/6/2023,0,0,0,0,0,0,0,0,0,0,0,0,0,0,0,0,0,0,0,0
163144,2023,Bulgaria,Dominican Republic,0,0,0,0,1/6/2023,0,0,0,0,0,0,1,1,0,0,1,1,0,0,3,3,2,0,0,2
163144,2023,Croatia,Bulgaria,0,0,0,0,31/05/2023,0,0,0,0,0,0,0,0,0,0,0,0,0,0,0,0,0,0,0,0
174467,2023,Serbia,Bulgaria,0,0,0,0,2/7/2023,0,0,1,1,0,0,0,0,0,0,0,0,0,1,2,3,1,0,1,2
174467,2023,Bulgaria,Poland,0,0,0,0,30/06/2023,0,0,1,1,0,0,0,0,0,0,0,0,0,2,3,5,2,0,1,3
174467,2023,USA,Bulgaria,0,0,0,0,29/06/2023,0,0,0,0,0,0,0,0,0,0,0,0,0,0,0,0,0,0,0,0
174467,2023,Bulgaria,Korea,0,0,0,0,27/06/2023,0,0,0,0,0,0,0,0,0,0,0,0,0,0,1,1,1,0,0,1
174467,2023,Bulgaria,Netherlands,0,0,0,0,18/06/2023,0,0,0,0,0,0,0,0,0,0,0,0,0,0,2,2,0,0,0,0
174467,2023,Bulgaria,China,0,0,0,0,16/06/2023,0,0,0,0,0,0,0,0,0,0,0,0,0,0,0,0,0,0,0,0
174467,2023,Bulgaria,Canada,0,0,0,0,15/06/2023,0,0,0,0,0,0,0,0,0,0,0,0,1,0,1,2,2,0,0,2
174467,2023,Italy,Bulgaria,0,0,0,0,14/06/2023,0,0,0,0,0,0,0,0,0,0,0,0,0,0,0,0,0,0,0,0
174467,2023,Germany,Bulgaria,0,0,0,0,4/6/2023,0,0,0,0,0,0,0,0,0,0,0,0,0,0,0,0,0,0,0,0
174467,2023,Bulgaria,Japan,0,0,0,0,3/6/2023,0,0,0,0,0,0,0,0,0,0,0,0,2,0,6,8,4,0,1,5
174467,2023,Bulgaria,Dominican Republic,0,0,0,0,1/6/2023,0,0,1,1,0,0,0,0,0,0,0,0,0,0,0,0,0,0,0,0
174467,2023,Croatia,Bulgaria,0,0,0,0,31/05/2023,0,0,0,0,0,0,0,0,0,0,0,0,0,0,0,0,0,0,0,0
174472,2023,Serbia,Bulgaria,0,0,0,0,2/7/2023,0,0,0,0,0,1,0,1,0,0,0,0,0,0,0,0,0,0,0,0
174472,2023,Bulgaria,Poland,0,0,2,2,30/06/2023,0,0,0,0,0,2,0,2,0,0,0,0,0,0,0,0,0,1,0,1
174472,2023,USA,Bulgaria,0,0,1,1,29/06/2023,0,0,0,0,0,1,0,1,0,0,0,0,0,0,0,0,0,0,0,0
174472,2023,Bulgaria,Korea,0,0,0,0,27/06/2023,0,0,0,0,0,0,0,0,0,0,0,0,0,0,0,0,0,0,0,0
174472,2023,Bulgaria,Netherlands,3,4,7,14,18/06/2023,0,0,2,2,14,8,10,32,0,2,0,2,0,0,0,0,5,0,1,6
174472,2023,Bulgaria,China,0,0,5,5,16/06/2023,0,0,0,0,2,1,6,9,0,1,0,1,0,1,0,1,3,0,0,3
174472,2023,Bulgaria,Canada,1,2,2,5,15/06/2023,0,0,3,3,1,4,5,10,0,1,0,1,0,0,0,0,2,0,0,2
174472,2023,Italy,Bulgaria,0,0,3,3,14/06/2023,0,0,0,0,1,2,4,7,1,0,0,1,0,0,0,0,2,0,0,2
174472,2023,Germany,Bulgaria,0,0,1,1,4/6/2023,0,0,0,0,3,0,0,3,0,0,0,0,0,0,0,0,0,0,0,0
174472,2023,Bulgaria,Japan,0,1,7,8,3/6/2023,0,0,1,1,7,7,9,23,0,3,2,5,0,0,1,1,5,1,0,6
174472,2023,Bulgaria,Dominican Republic,1,0,2,3,1/6/2023,0,0,0,0,3,1,1,5,0,0,0,0,0,0,0,0,1,0,0,1
174472,2023,Croatia,Bulgaria,0,0,0,0,31/05/2023,0,0,0,0,0,0,0,0,0,0,0,0,0,0,0,0,0,0,0,0
168355,2023,Netherlands,Canada,2,3,12,17,1/7/2023,0,0,4,4,8,7,8,23,3,4,4,11,0,0,0,0,10,4,2,16
168355,2023,Canada,Italy,2,5,5,12,30/06/2023,0,0,4,4,12,7,13,32,1,3,2,6,0,0,0,0,5,4,3,12
168355,2023,Brazil,Canada,1,2,16,19,29/06/2023,0,0,1,1,15,7,11,33,3,1,7,11,0,0,0,0,15,1,3,19
168355,2023,Croatia,Canada,1,1,8,10,27/06/2023,0,0,3,3,9,5,14,28,1,6,0,7,0,0,0,0,8,5,0,13
168355,2023,Dominican Republic,Canada,0,3,7,10,17/06/2023,0,0,4,4,9,8,12,29,1,2,5,8,0,0,0,0,5,0,0,5
168355,2023,Türkiye,Canada,0,4,3,7,16/06/2023,0,0,1,1,9,6,12,27,1,3,2,6,0,0,0,0,7,3,1,11
168355,2023,Bulgaria,Canada,1,2,5,8,15/06/2023,0,0,1,1,12,1,6,19,2,3,9,14,0,0,0,0,5,2,2,9
168355,2023,China,Canada,0,7,4,11,13/06/2023,0,1,2,3,10,10,10,30,0,2,2,4,0,0,0,0,6,6,1,13
175158,2023,Netherlands,Canada,0,0,0,0,1/7/2023,0,0,0,0,0,0,0,0,0,0,0,0,0,0,0,0,0,0,0,0
175158,2023,Canada,Italy,0,0,0,0,30/06/2023,0,0,0,0,0,0,0,0,0,0,0,0,0,0,0,0,0,0,0,0
175158,2023,Brazil,Canada,0,0,0,0,29/06/2023,0,0,0,0,0,0,0,0,0,0,0,0,0,0,0,0,0,0,0,0
175158,2023,Croatia,Canada,0,0,0,0,27/06/2023,0,0,12,12,0,0,0,0,0,0,0,0,1,0,15,16,7,2,2,11
175158,2023,Dominican Republic,Canada,0,0,0,0,17/06/2023,0,0,15,15,0,0,0,0,0,0,0,0,4,1,26,31,12,2,0,14
175158,2023,Türkiye,Canada,0,0,0,0,16/06/2023,0,0,7,7,0,0,0,0,0,0,0,0,0,0,5,5,3,1,2,6
175158,2023,Bulgaria,Canada,0,0,0,0,15/06/2023,0,0,6,6,0,0,0,0,0,0,0,0,1,1,6,8,6,2,0,8
175158,2023,China,Canada,0,0,0,0,13/06/2023,0,0,10,10,0,0,0,0,0,0,0,0,0,0,8,8,8,3,1,12
175158,2023,Canada,Serbia,0,0,0,0,4/6/2023,0,0,0,0,0,0,0,0,0,0,0,0,0,0,0,0,0,0,0,0
175158,2023,Canada,Korea,0,0,0,0,2/6/2023,0,0,4,4,0,0,0,0,0,0,0,0,0,0,9,9,9,4,0,13
175158,2023,Canada,Thailand,0,0,0,0,1/6/2023,1,0,9,10,0,0,0,0,0,0,0,0,2,1,7,10,9,7,2,18
175158,2023,Poland,Canada,0,0,0,0,30/05/2023,0,0,20,20,0,0,0,0,0,0,0,0,0,1,16,17,23,4,2,29
153629,2023,Netherlands,Canada,0,2,13,15,1/7/2023,0,0,4,4,5,2,7,14,6,2,4,12,0,0,1,1,2,2,0,4
153629,2023,Canada,Italy,0,0,10,10,30/06/2023,0,0,2,2,3,0,8,11,1,4,5,10,0,0,0,0,1,3,1,5
153629,2023,Brazil,Canada,1,2,19,22,29/06/2023,0,0,2,2,7,3,3,13,4,6,3,13,0,0,1,1,1,0,0,1
153629,2023,Croatia,Canada,1,1,12,14,27/06/2023,0,1,3,4,5,2,5,12,4,5,6,15,0,0,0,0,7,1,0,8
153629,2023,Dominican Republic,Canada,1,1,1,3,17/06/2023,0,0,2,2,1,1,4,6,1,1,2,4,0,0,0,0,2,0,0,2
153629,2023,Türkiye,Canada,0,0,6,6,16/06/2023,0,0,0,0,1,0,3,4,0,2,1,3,0,0,0,0,2,0,0,2
153629,2023,Bulgaria,Canada,0,2,6,8,15/06/2023,0,0,1,1,3,1,2,6,3,3,5,11,0,0,0,0,0,0,0,0
153629,2023,China,Canada,0,0,0,0,13/06/2023,0,0,0,0,0,0,0,0,0,0,0,0,0,0,0,0,0,0,0,0
153629,2023,Canada,Serbia,0,1,13,14,4/6/2023,0,0,3,3,8,0,6,14,1,5,4,10,0,0,2,2,2,1,0,3
153629,2023,Canada,Korea,0,0,0,0,2/6/2023,0,0,0,0,0,0,0,0,0,0,0,0,0,0,0,0,0,0,0,0
153629,2023,Canada,Thailand,0,0,0,0,1/6/2023,0,0,0,0,0,0,0,0,0,0,0,0,0,0,0,0,0,0,0,0
153629,2023,Poland,Canada,0,0,10,10,30/05/2023,0,0,2,2,0,3,4,7,1,1,5,7,0,0,0,0,1,0,0,1
163360,2023,Netherlands,Canada,0,0,0,0,1/7/2023,0,0,0,0,0,0,0,0,0,0,0,0,0,0,0,0,0,0,0,0
163360,2023,Canada,Italy,0,1,5,6,30/06/2023,0,0,0,0,2,0,1,3,1,1,1,3,0,0,1,1,2,0,0,2
163360,2023,Brazil,Canada,0,0,0,0,29/06/2023,0,0,0,0,0,0,0,0,0,0,0,0,0,0,0,0,0,0,0,0
163360,2023,Croatia,Canada,0,0,0,0,27/06/2023,0,0,0,0,0,0,0,0,0,0,0,0,0,0,0,0,0,0,0,0
163360,2023,Dominican Republic,Canada,0,1,1,2,17/06/2023,0,0,0,0,1,3,1,5,0,2,3,5,0,0,0,0,0,0,0,0
163360,2023,Türkiye,Canada,0,0,0,0,16/06/2023,0,0,0,0,0,0,0,0,0,0,0,0,0,0,0,0,0,0,0,0
163360,2023,Bulgaria,Canada,0,1,1,2,15/06/2023,0,0,0,0,0,0,0,0,0,0,1,1,0,0,0,0,0,0,0,0
163360,2023,China,Canada,0,1,3,4,13/06/2023,0,0,0,0,3,0,2,5,0,1,1,2,0,0,0,0,0,0,0,0
163360,2023,Canada,Serbia,0,1,0,1,4/6/2023,0,0,0,0,0,2,1,3,1,1,2,4,0,0,0,0,0,0,0,0
163360,2023,Canada,Korea,0,1,3,4,2/6/2023,0,0,1,1,13,2,3,18,5,4,6,15,0,0,0,0,4,1,1,6
163360,2023,Canada,Thailand,0,1,7,8,1/6/2023,1,0,1,2,6,4,5,15,4,4,3,11,0,0,0,0,1,1,0,2
163360,2023,Poland,Canada,0,1,3,4,30/05/2023,0,0,1,1,2,0,1,3,1,4,3,8,0,0,0,0,0,0,0,0
142777,2023,Netherlands,Canada,0,0,0,0,1/7/2023,0,0,0,0,0,0,0,0,0,0,0,0,0,0,0,0,0,0,0,0
142777,2023,Canada,Italy,0,0,1,1,30/06/2023,0,0,0,0,0,0,0,0,0,0,0,0,0,0,0,0,0,0,0,0
142777,2023,Brazil,Canada,0,0,0,0,29/06/2023,0,0,0,0,0,0,0,0,0,0,0,0,0,0,0,0,0,0,0,0
142777,2023,Croatia,Canada,0,0,1,1,27/06/2023,0,0,1,1,0,0,1,1,1,3,0,4,0,0,0,0,0,0,0,0
142777,2023,Dominican Republic,Canada,0,1,11,12,17/06/2023,0,0,2,2,0,1,0,1,1,2,3,6,0,0,0,0,3,2,0,5
142777,2023,Türkiye,Canada,0,1,3,4,16/06/2023,0,0,3,3,1,0,3,4,1,1,2,4,0,0,0,0,3,0,0,3
142777,2023,Bulgaria,Canada,0,0,0,0,15/06/2023,0,0,0,0,0,0,0,0,0,0,0,0,0,0,0,0,0,0,0,0
142777,2023,China,Canada,0,0,5,5,13/06/2023,0,1,3,4,0,0,0,0,0,0,1,1,1,0,0,1,2,0,0,2
132236,2023,Netherlands,Canada,1,1,15,17,1/7/2023,0,0,6,6,23,11,17,51,1,2,2,5,6,0,18,24,10,3,1,14
132236,2023,Canada,Italy,1,3,9,13,30/06/2023,0,0,4,4,16,8,19,43,1,1,5,7,9,2,37,48,10,2,0,12
132236,2023,Brazil,Canada,1,2,15,18,29/06/2023,0,0,6,6,22,8,27,57,2,0,1,3,16,1,54,71,6,2,1,9
132236,2023,Croatia,Canada,0,0,10,10,27/06/2023,0,0,2,2,17,2,26,45,3,2,3,8,3,0,16,19,10,0,2,12
132236,2023,Dominican Republic,Canada,1,3,14,18,17/06/2023,0,1,2,3,19,7,25,51,1,4,5,10,7,0,48,55,14,2,0,16
132236,2023,Türkiye,Canada,0,1,6,7,16/06/2023,0,0,1,1,17,7,13,37,0,4,1,5,7,1,31,39,1,1,0,2
132236,2023,Bulgaria,Canada,2,0,20,22,15/06/2023,0,0,2,2,9,2,8,19,0,2,1,3,0,0,25,25,6,1,3,10
132236,2023,China,Canada,0,0,8,8,13/06/2023,0,0,3,3,12,6,9,27,1,1,0,2,0,3,26,29,6,5,4,15
132236,2023,Canada,Serbia,2,2,13,17,4/6/2023,0,0,4,4,20,6,39,65,1,3,1,5,9,2,47,58,11,4,0,15
132236,2023,Canada,Korea,1,0,11,12,2/6/2023,0,0,1,1,9,2,4,15,1,0,4,5,2,1,20,23,9,4,1,14
132236,2023,Canada,Thailand,1,1,12,14,1/6/2023,0,0,0,0,8,2,25,35,1,1,7,9,5,4,37,46,8,6,0,14
132236,2023,Poland,Canada,0,3,24,27,30/05/2023,0,0,2,2,36,6,29,71,1,4,6,11,8,2,34,44,12,3,3,18
173581,2023,Netherlands,Canada,1,0,4,5,1/7/2023,0,0,0,0,1,2,7,10,1,0,0,1,1,0,9,10,2,1,0,3
173581,2023,Canada,Italy,0,0,13,13,30/06/2023,0,0,0,0,8,4,9,21,0,0,2,2,2,0,8,10,7,3,1,11
173581,2023,Brazil,Canada,0,0,12,12,29/06/2023,0,1,1,2,8,1,15,24,0,1,2,3,3,0,6,9,11,0,1,12
173581,2023,Croatia,Canada,2,0,12,14,27/06/2023,0,0,1,1,2,4,8,14,0,0,1,1,1,0,14,15,6,1,1,8
173581,2023,Dominican Republic,Canada,0,1,0,1,17/06/2023,0,0,0,0,2,2,2,6,0,1,2,3,0,0,1,1,1,0,0,1
173581,2023,Türkiye,Canada,0,0,1,1,16/06/2023,0,0,0,0,0,0,0,0,0,0,0,0,0,1,2,3,0,0,0,0
173581,2023,Bulgaria,Canada,0,0,1,1,15/06/2023,0,0,0,0,0,0,1,1,0,0,0,0,0,0,0,0,1,0,1,2
173581,2023,China,Canada,0,1,0,1,13/06/2023,0,0,0,0,0,0,0,0,0,1,0,1,0,0,0,0,1,0,0,1
173581,2023,Canada,Serbia,0,0,2,2,4/6/2023,0,0,0,0,2,0,5,7,0,1,1,2,1,0,0,1,2,2,0,4
173581,2023,Canada,Korea,1,0,9,10,2/6/2023,0,0,1,1,5,2,5,12,1,0,3,4,2,0,9,11,3,3,2,8
173581,2023,Canada,Thailand,0,2,4,6,1/6/2023,1,0,5,6,8,2,9,19,0,2,1,3,2,1,6,9,11,2,1,14
173581,2023,Poland,Canada,0,0,7,7,30/05/2023,0,0,1,1,5,4,5,14,0,2,2,4,2,0,10,12,9,0,2,11
173585,2023,Netherlands,Canada,0,0,17,17,1/7/2023,20,1,95,116,1,1,0,2,0,3,4,7,0,1,0,1,10,1,1,12
173585,2023,Canada,Italy,0,0,17,17,30/06/2023,23,2,96,121,1,1,0,2,1,2,2,5,0,0,0,0,7,3,1,11
173585,2023,Brazil,Canada,0,1,20,21,29/06/2023,29,1,115,145,2,0,1,3,1,2,7,10,0,0,1,1,9,5,3,17
173585,2023,Croatia,Canada,0,1,11,12,27/06/2023,22,1,74,97,3,0,3,6,0,2,4,6,0,0,0,0,10,1,2,13
173585,2023,Dominican Republic,Canada,1,0,12,13,17/06/2023,43,0,87,130,2,1,3,6,0,4,2,6,0,0,0,0,15,7,2,24
173585,2023,Türkiye,Canada,1,1,12,14,16/06/2023,8,2,61,71,0,1,2,3,1,2,1,4,0,0,0,0,9,2,1,12
173585,2023,Bulgaria,Canada,0,0,13,13,15/06/2023,14,0,33,47,0,0,1,1,3,1,1,5,0,1,0,1,11,2,2,15
173585,2023,China,Canada,2,0,7,9,13/06/2023,23,1,55,79,0,0,3,3,1,0,2,3,0,1,0,1,10,5,0,15
173585,2023,Canada,Serbia,1,1,22,24,4/6/2023,14,3,126,143,4,1,2,7,1,6,3,10,0,0,0,0,11,2,0,13
173585,2023,Canada,Korea,0,1,11,12,2/6/2023,19,1,48,68,2,1,1,4,0,1,3,4,0,0,0,0,4,2,1,7
173585,2023,Canada,Thailand,0,0,12,12,1/6/2023,29,3,60,92,0,0,0,0,1,1,4,6,0,0,0,0,10,6,2,18
173585,2023,Poland,Canada,2,1,18,21,30/05/2023,22,1,94,117,3,0,3,6,2,7,3,12,0,0,0,0,10,5,1,16
174676,2023,Netherlands,Canada,0,3,14,17,1/7/2023,0,0,3,3,10,7,10,27,1,1,1,3,5,1,15,21,12,1,1,14
174676,2023,Canada,Italy,2,0,9,11,30/06/2023,0,0,1,1,4,5,4,13,1,1,0,2,1,1,5,7,4,2,1,7
174676,2023,Brazil,Canada,0,0,6,6,29/06/2023,0,0,1,1,5,3,6,14,3,1,0,4,0,1,5,6,6,1,0,7
174676,2023,Croatia,Canada,0,0,1,1,27/06/2023,0,0,0,0,1,2,6,9,1,0,1,2,1,2,9,12,2,0,0,2
174676,2023,Dominican Republic,Canada,0,1,13,14,17/06/2023,0,0,3,3,12,11,15,38,3,4,3,10,0,0,9,9,3,2,1,6
174676,2023,Türkiye,Canada,1,2,6,9,16/06/2023,0,0,1,1,5,2,7,14,0,3,1,4,1,1,14,16,2,1,0,3
174676,2023,Bulgaria,Canada,1,1,6,8,15/06/2023,0,0,0,0,9,0,9,18,3,0,3,6,0,0,1,1,3,1,0,4
174676,2023,China,Canada,0,1,11,12,13/06/2023,0,0,2,2,11,2,11,24,1,2,1,4,2,1,27,30,4,3,4,11
174676,2023,Canada,Serbia,0,2,11,13,4/6/2023,0,0,2,2,18,6,26,50,6,5,0,11,2,2,21,25,12,5,2,19
174676,2023,Canada,Korea,1,0,8,9,2/6/2023,0,0,0,0,6,2,9,17,2,3,6,11,0,0,0,0,5,2,1,8
174676,2023,Canada,Thailand,0,0,3,3,1/6/2023,0,0,1,1,7,2,9,18,1,2,2,5,0,0,1,1,7,4,1,12
174676,2023,Poland,Canada,0,2,13,15,30/05/2023,0,0,4,4,13,9,21,43,2,2,6,10,1,0,11,12,5,3,2,10
166581,2023,Netherlands,Canada,0,0,2,2,1/7/2023,0,0,2,2,0,0,1,1,0,1,0,1,0,0,1,1,1,0,0,1
166581,2023,Canada,Italy,0,0,1,1,30/06/2023,0,0,0,0,0,0,1,1,0,0,0,0,0,0,0,0,0,0,0,0
166581,2023,Brazil,Canada,0,0,0,0,29/06/2023,0,0,0,0,0,0,0,0,0,0,0,0,0,0,0,0,0,0,0,0
166581,2023,Croatia,Canada,0,0,0,0,27/06/2023,0,0,0,0,0,0,0,0,0,0,0,0,0,0,0,0,0,0,0,0
166581,2023,Dominican Republic,Canada,0,0,3,3,17/06/2023,0,0,1,1,2,3,4,9,0,0,0,0,0,0,0,0,3,1,0,4
166581,2023,Türkiye,Canada,0,0,0,0,16/06/2023,0,0,0,0,0,0,0,0,0,0,0,0,0,0,0,0,0,0,0,0
166581,2023,Bulgaria,Canada,0,0,0,0,15/06/2023,0,0,0,0,1,0,1,2,0,1,1,2,0,0,0,0,0,1,0,1
166581,2023,China,Canada,0,0,0,0,13/06/2023,0,0,0,0,0,0,0,0,0,0,0,0,0,0,0,0,0,0,0,0
166581,2023,Canada,Serbia,0,1,12,13,4/6/2023,0,0,2,2,7,1,9,17,0,3,4,7,0,0,0,0,6,8,0,14
166581,2023,Canada,Korea,0,0,1,1,2/6/2023,0,0,0,0,3,0,1,4,0,2,1,3,0,0,0,0,0,0,1,1
166581,2023,Canada,Thailand,0,0,0,0,1/6/2023,0,0,0,0,0,1,2,3,0,1,1,2,0,0,0,0,0,1,0,1
166581,2023,Poland,Canada,0,0,0,0,30/05/2023,0,0,0,0,0,0,0,0,0,0,0,0,0,0,0,0,0,0,0,0
174680,2023,Netherlands,Canada,0,0,0,0,1/7/2023,0,0,0,0,0,0,0,0,0,0,0,0,0,0,0,0,0,0,0,0
174680,2023,Canada,Italy,0,0,1,1,30/06/2023,0,0,0,0,0,0,0,0,0,0,0,0,0,0,0,0,1,0,0,1
174680,2023,Brazil,Canada,0,0,1,1,29/06/2023,0,0,0,0,0,0,0,0,0,0,0,0,0,0,0,0,0,0,0,0
174680,2023,Croatia,Canada,0,0,0,0,27/06/2023,0,0,0,0,0,0,0,0,0,0,0,0,2,0,2,4,0,0,0,0
174680,2023,Dominican Republic,Canada,0,0,3,3,17/06/2023,0,0,0,0,0,0,0,0,0,0,0,0,0,0,0,0,1,0,0,1
174680,2023,Türkiye,Canada,0,0,1,1,16/06/2023,0,0,0,0,0,0,0,0,0,0,0,0,0,0,0,0,0,1,0,1
174680,2023,Bulgaria,Canada,0,0,2,2,15/06/2023,0,0,0,0,0,0,0,0,0,0,0,0,0,0,0,0,0,0,0,0
174680,2023,China,Canada,0,0,3,3,13/06/2023,0,0,1,1,0,0,0,0,0,0,0,0,0,0,0,0,0,1,0,1
174680,2023,Canada,Serbia,0,1,0,1,4/6/2023,0,0,0,0,0,0,0,0,0,0,0,0,0,0,0,0,0,0,0,0
174680,2023,Canada,Korea,0,1,1,2,2/6/2023,0,0,0,0,0,0,0,0,0,0,0,0,0,0,0,0,0,0,0,0
174680,2023,Canada,Thailand,0,0,6,6,1/6/2023,0,0,0,0,0,0,0,0,0,0,0,0,0,0,1,1,0,1,0,1
174680,2023,Poland,Canada,0,1,3,4,30/05/2023,0,0,1,1,0,0,0,0,0,0,0,0,0,0,0,0,0,0,0,0
192389,2023,Netherlands,Canada,0,0,0,0,1/7/2023,0,0,12,12,0,0,0,0,0,0,0,0,7,1,16,24,10,4,1,15
192389,2023,Canada,Italy,0,0,0,0,30/06/2023,0,0,9,9,0,0,0,0,0,0,0,0,8,3,16,27,13,6,3,22
192389,2023,Brazil,Canada,0,0,0,0,29/06/2023,0,0,8,8,0,0,0,0,0,0,0,0,4,2,9,15,9,7,1,17
192389,2023,Croatia,Canada,0,0,0,0,27/06/2023,0,0,0,0,0,0,0,0,0,0,0,0,0,0,0,0,0,0,0,0
192389,2023,Canada,Serbia,0,0,0,0,4/6/2023,0,0,19,19,0,0,0,0,0,0,0,0,4,1,15,20,12,5,1,18
192389,2023,Canada,Korea,0,0,0,0,2/6/2023,0,0,0,0,0,0,0,0,0,0,0,0,0,0,0,0,0,0,0,0
192389,2023,Canada,Thailand,0,0,0,0,1/6/2023,0,0,0,0,0,0,0,0,0,0,0,0,0,0,0,0,0,0,0,0
192389,2023,Poland,Canada,0,0,0,0,30/05/2023,0,0,0,0,0,0,0,0,0,0,0,0,0,0,0,0,0,0,0,0
168354,2023,Netherlands,Canada,1,0,16,17,1/7/2023,0,0,1,1,9,1,6,16,4,1,4,9,0,0,4,4,2,0,0,2
168354,2023,Canada,Italy,2,1,10,13,30/06/2023,0,0,0,0,7,2,2,11,4,5,3,12,2,0,1,3,0,0,0,0
168354,2023,Brazil,Canada,0,3,15,18,29/06/2023,0,0,3,3,5,1,14,20,8,5,11,24,0,0,0,0,3,1,2,6
168354,2023,Croatia,Canada,0,1,13,14,27/06/2023,0,0,3,3,5,1,2,8,3,3,4,10,0,0,0,0,3,0,2,5
168354,2023,Dominican Republic,Canada,0,1,10,11,17/06/2023,0,0,0,0,9,2,5,16,2,8,7,17,0,0,1,1,5,0,0,5
168354,2023,Türkiye,Canada,0,2,7,9,16/06/2023,0,0,1,1,2,1,3,6,2,1,6,9,0,0,0,0,0,0,0,0
168354,2023,Bulgaria,Canada,0,1,8,9,15/06/2023,0,0,3,3,4,1,3,8,2,2,7,11,0,0,0,0,4,0,0,4
168354,2023,China,Canada,0,3,6,9,13/06/2023,0,0,2,2,5,1,5,11,0,2,1,3,0,0,0,0,3,1,0,4
168354,2023,Canada,Serbia,1,4,13,18,4/6/2023,0,0,4,4,6,4,8,18,3,8,11,22,0,0,0,0,4,1,1,6
168354,2023,Canada,Korea,0,1,20,21,2/6/2023,0,0,1,1,4,0,5,9,2,3,3,8,0,0,1,1,1,4,5,10
168354,2023,Canada,Thailand,0,0,10,10,1/6/2023,1,0,1,2,5,2,7,14,4,3,3,10,0,0,0,0,3,0,0,3
168354,2023,Poland,Canada,0,3,8,11,30/05/2023,0,0,1,1,5,2,3,10,1,8,15,24,1,0,3,4,6,0,1,7
183258,2023,Netherlands,Canada,0,0,0,0,1/7/2023,0,0,0,0,0,0,0,0,0,0,0,0,0,0,0,0,0,0,0,0
183258,2023,Canada,Italy,0,0,0,0,30/06/2023,0,0,0,0,0,0,0,0,0,0,0,0,0,0,0,0,0,0,0,0
183258,2023,Brazil,Canada,0,0,0,0,29/06/2023,0,0,0,0,0,0,0,0,0,0,0,0,0,0,0,0,0,0,0,0
183258,2023,Croatia,Canada,0,0,0,0,27/06/2023,0,0,0,0,0,0,0,0,0,0,0,0,0,0,0,0,0,0,0,0
183258,2023,Dominican Republic,Canada,0,0,0,0,17/06/2023,0,0,0,0,0,0,0,0,0,0,0,0,0,0,0,0,0,0,0,0
183258,2023,Türkiye,Canada,0,0,0,0,16/06/2023,0,0,0,0,0,0,0,0,0,0,0,0,0,0,0,0,0,0,0,0
183258,2023,Bulgaria,Canada,0,0,0,0,15/06/2023,1,0,4,5,0,0,0,0,0,0,0,0,0,0,0,0,0,0,1,1
183258,2023,China,Canada,0,0,0,0,13/06/2023,0,0,0,0,0,0,0,0,0,0,0,0,0,0,0,0,0,0,0,0
135746,2023,China,Türkiye,1,2,9,12,16/07/2023,0,0,1,1,9,3,9,21,1,2,3,6,0,0,0,0,3,0,1,4
135746,2023,Poland,China,1,0,7,8,15/07/2023,0,0,1,1,10,0,2,12,2,6,6,14,0,0,0,0,0,1,0,1
135746,2023,Brazil,China,0,2,10,12,13/07/2023,0,0,2,2,6,1,12,19,7,6,6,19,0,0,0,0,2,0,0,2
135746,2023,China,USA,1,0,10,11,2/7/2023,0,0,1,1,9,0,6,15,3,6,4,13,0,0,2,2,0,3,2,5
135746,2023,Korea,China,1,1,12,14,1/7/2023,0,0,3,3,13,1,9,23,4,6,8,18,1,0,0,1,2,0,1,3
135746,2023,China,Dominican Republic,1,0,11,12,30/06/2023,0,0,3,3,13,3,7,23,2,5,6,13,0,0,0,0,3,4,0,7
135746,2023,China,Serbia,1,1,10,12,28/06/2023,0,0,4,4,9,2,6,17,3,8,2,13,0,0,1,1,2,1,0,3
135746,2023,Italy,China,1,1,14,16,18/06/2023,0,0,2,2,13,0,9,22,1,5,4,10,0,0,0,0,3,2,1,6
135746,2023,Poland,China,0,1,10,11,17/06/2023,0,1,2,3,7,1,2,10,0,5,3,8,0,0,1,1,0,1,0,1
135746,2023,Bulgaria,China,0,0,9,9,16/06/2023,0,0,2,2,10,1,6,17,3,3,3,9,1,0,0,1,1,0,0,1
135746,2023,China,Canada,0,1,6,7,13/06/2023,0,0,0,0,6,0,2,8,3,4,3,10,0,0,1,1,1,0,0,1
135746,2023,Japan,China,2,0,8,10,4/6/2023,0,0,3,3,7,2,7,16,1,4,5,10,0,0,2,2,2,0,0,2
135746,2023,China,Netherlands,0,2,9,11,3/6/2023,0,0,2,2,8,0,7,15,3,1,2,6,0,0,1,1,2,0,0,2
135746,2023,China,Germany,0,2,7,9,2/6/2023,0,0,0,0,7,0,6,13,4,2,4,10,0,0,0,0,6,0,1,7
135746,2023,China,Brazil,0,1,14,15,31/05/2023,0,0,1,1,9,2,10,21,3,3,2,8,0,0,0,0,3,0,1,4
162354,2023,China,Türkiye,0,1,6,7,16/07/2023,21,0,64,85,1,1,1,3,0,0,5,5,0,0,0,0,4,1,0,5
162354,2023,Poland,China,0,1,10,11,15/07/2023,26,1,32,59,0,0,2,2,0,4,3,7,0,0,0,0,5,1,0,6
162354,2023,Brazil,China,0,1,11,12,13/07/2023,24,0,65,89,0,1,1,2,3,4,5,12,0,0,0,0,12,8,1,21
162354,2023,China,USA,0,0,12,12,2/7/2023,15,1,81,97,1,0,0,1,2,4,2,8,0,0,2,2,5,6,4,15
162354,2023,Korea,China,2,0,21,23,1/7/2023,28,2,50,80,1,0,2,3,0,4,4,8,0,0,0,0,3,0,1,4
162354,2023,China,Dominican Republic,0,0,10,10,30/06/2023,33,0,58,91,0,0,0,0,0,4,2,6,0,0,1,1,7,3,0,10
162354,2023,China,Serbia,2,0,10,12,28/06/2023,29,2,57,88,1,0,1,2,0,3,4,7,0,0,0,0,3,5,1,9
162354,2023,Italy,China,0,0,22,22,18/06/2023,36,2,78,116,2,0,3,5,1,3,1,5,0,0,0,0,8,3,2,13
162354,2023,Poland,China,0,0,8,8,17/06/2023,24,0,44,68,0,0,0,0,0,4,2,6,0,0,0,0,7,2,0,9
162354,2023,Bulgaria,China,3,0,18,21,16/06/2023,34,0,46,80,1,0,0,1,0,3,3,6,0,0,0,0,4,2,1,7
162354,2023,China,Canada,2,1,17,20,13/06/2023,20,1,40,61,1,0,2,3,0,4,3,7,0,0,0,0,4,5,2,11
162354,2023,Japan,China,0,0,7,7,4/6/2023,2,0,79,81,0,1,0,1,4,3,0,7,0,0,1,1,6,0,1,7
162354,2023,China,Netherlands,0,1,14,15,3/6/2023,8,1,92,101,0,0,1,1,1,0,3,4,0,0,2,2,13,0,3,16
162354,2023,China,Germany,0,0,13,13,2/6/2023,10,0,64,74,0,0,0,0,0,0,0,0,0,0,0,0,9,1,1,11
162354,2023,China,Brazil,1,2,15,18,31/05/2023,12,2,108,122,0,0,1,1,1,1,2,4,0,0,0,0,4,0,3,7
152337,2023,China,Türkiye,0,1,0,1,16/07/2023,0,0,0,0,0,1,0,1,0,1,0,1,0,0,0,0,0,0,0,0
152337,2023,Poland,China,0,0,0,0,15/07/2023,0,0,0,0,0,0,0,0,0,0,0,0,0,0,0,0,0,0,0,0
152337,2023,Brazil,China,0,0,0,0,13/07/2023,0,0,0,0,0,0,0,0,0,0,0,0,0,0,0,0,0,0,0,0
152337,2023,China,USA,0,0,0,0,2/7/2023,0,0,0,0,0,0,0,0,0,0,0,0,0,0,0,0,0,0,0,0
152337,2023,Korea,China,0,0,1,1,1/7/2023,0,0,0,0,0,0,2,2,0,1,0,1,0,0,0,0,0,1,0,1
152337,2023,China,Dominican Republic,0,1,7,8,30/06/2023,0,0,1,1,1,1,5,7,0,2,0,2,0,1,0,1,0,2,0,2
152337,2023,China,Serbia,0,0,11,11,28/06/2023,0,0,2,2,8,1,2,11,3,5,5,13,3,0,1,4,0,0,2,2
152337,2023,Italy,China,0,0,0,0,18/06/2023,0,0,0,0,0,0,0,0,0,0,0,0,0,0,0,0,0,0,0,0
152337,2023,Poland,China,0,0,6,6,17/06/2023,0,0,1,1,1,0,5,6,1,5,3,9,0,0,1,1,1,1,0,2
152337,2023,Bulgaria,China,0,0,0,0,16/06/2023,0,0,0,0,1,0,0,1,0,0,0,0,0,0,0,0,0,0,0,0
152337,2023,China,Canada,0,0,0,0,13/06/2023,0,0,0,0,0,0,0,0,0,0,0,0,0,0,0,0,0,0,0,0
152337,2023,Japan,China,0,0,0,0,4/6/2023,0,0,0,0,0,0,0,0,0,0,0,0,0,0,0,0,0,0,0,0
152337,2023,China,Netherlands,0,0,0,0,3/6/2023,0,0,0,0,0,0,0,0,0,0,0,0,0,0,0,0,0,0,0,0
152337,2023,China,Germany,0,0,0,0,2/6/2023,0,0,0,0,0,0,0,0,0,0,0,0,0,0,0,0,0,0,0,0
152337,2023,China,Brazil,0,0,0,0,31/05/2023,0,0,0,0,0,0,0,0,0,0,0,0,0,0,0,0,0,0,0,0
152332,2023,China,Türkiye,0,1,0,1,16/07/2023,0,0,1,1,0,0,1,1,0,0,0,0,0,0,0,0,0,0,0,0
152332,2023,Poland,China,0,0,0,0,15/07/2023,0,0,0,0,0,0,0,0,0,0,0,0,0,0,0,0,0,0,0,0
152332,2023,Brazil,China,0,0,0,0,13/07/2023,0,0,0,0,0,0,0,0,0,0,0,0,0,0,0,0,0,0,0,0
152332,2023,China,USA,0,2,6,8,2/7/2023,0,0,1,1,4,1,7,12,3,1,5,9,1,0,0,1,3,1,0,4
152332,2023,Korea,China,0,0,0,0,1/7/2023,0,0,0,0,0,0,0,0,0,0,0,0,0,0,0,0,0,0,0,0
152332,2023,China,Dominican Republic,0,0,0,0,30/06/2023,0,0,0,0,0,0,0,0,0,0,0,0,0,0,0,0,0,0,0,0
152332,2023,China,Serbia,0,0,0,0,28/06/2023,0,0,0,0,0,0,0,0,0,0,0,0,0,0,0,0,0,0,0,0
152332,2023,Italy,China,0,0,0,0,18/06/2023,0,0,0,0,0,0,0,0,0,0,0,0,0,0,0,0,0,0,0,0
152332,2023,Poland,China,0,0,1,1,17/06/2023,0,0,0,0,0,0,0,0,0,0,0,0,0,0,0,0,0,0,0,0
152332,2023,Bulgaria,China,0,0,2,2,16/06/2023,0,0,0,0,1,0,0,1,0,0,0,0,0,0,0,0,0,0,0,0
152332,2023,China,Canada,0,0,0,0,13/06/2023,0,0,0,0,0,0,0,0,0,0,0,0,0,0,0,0,0,0,0,0
152332,2023,Japan,China,0,0,0,0,4/6/2023,0,0,0,0,0,0,0,0,0,0,0,0,0,0,0,0,0,0,0,0
152332,2023,China,Netherlands,0,0,0,0,3/6/2023,0,0,0,0,0,0,0,0,0,0,0,0,0,0,0,0,0,0,0,0
152332,2023,China,Germany,0,0,0,0,2/6/2023,0,0,0,0,0,0,0,0,0,0,0,0,0,0,0,0,0,0,0,0
152332,2023,China,Brazil,0,0,0,0,31/05/2023,0,0,0,0,0,0,0,0,0,0,0,0,0,0,0,0,0,0,0,0
143206,2023,China,Türkiye,0,2,10,12,16/07/2023,0,0,8,8,6,4,15,25,2,1,0,3,5,2,13,20,10,3,3,16
143206,2023,Poland,China,0,1,12,13,15/07/2023,0,0,4,4,9,4,7,20,0,2,1,3,2,1,5,8,7,1,2,10
143206,2023,Brazil,China,0,1,12,13,13/07/2023,0,1,1,2,14,3,4,21,0,3,5,8,3,2,16,21,10,2,1,13
143206,2023,China,USA,0,1,19,20,2/7/2023,0,0,7,7,12,2,8,22,1,3,5,9,4,0,17,21,8,4,3,15
143206,2023,Korea,China,0,0,16,16,1/7/2023,0,0,3,3,10,1,3,14,2,6,8,16,3,2,11,16,15,4,1,20
143206,2023,China,Dominican Republic,0,0,11,11,30/06/2023,0,0,3,3,8,2,18,28,1,1,0,2,3,1,4,8,16,3,2,21
143206,2023,China,Serbia,0,0,15,15,28/06/2023,0,0,3,3,10,4,14,28,0,2,2,4,6,1,14,21,9,2,3,14
143206,2023,Italy,China,1,0,15,16,18/06/2023,0,0,5,5,12,7,17,36,3,2,0,5,7,1,11,19,10,1,1,12
143206,2023,Poland,China,1,1,9,11,17/06/2023,0,1,3,4,12,4,8,24,0,3,1,4,2,0,7,9,9,1,1,11
143206,2023,Bulgaria,China,2,0,3,5,16/06/2023,0,1,1,2,3,0,3,6,0,0,3,3,0,0,1,1,4,1,0,5
143206,2023,China,Canada,1,0,10,11,13/06/2023,0,0,0,0,5,2,7,14,1,1,2,4,1,1,5,7,7,2,3,12
143206,2023,Japan,China,1,1,14,16,4/6/2023,0,0,1,1,8,2,12,22,0,0,0,0,2,0,3,5,10,0,1,11
143206,2023,China,Netherlands,0,1,8,9,3/6/2023,0,0,2,2,8,7,6,21,1,1,1,3,1,1,9,11,14,0,0,14
143206,2023,China,Germany,0,0,18,18,2/6/2023,0,0,1,1,9,4,8,21,0,1,3,4,6,1,6,13,5,0,0,5
143206,2023,China,Brazil,1,1,17,19,31/05/2023,0,0,0,0,15,8,12,35,2,0,0,2,6,1,8,15,11,1,0,12
143201,2023,China,Türkiye,1,1,14,16,16/07/2023,0,0,0,0,7,1,4,12,1,3,2,6,0,0,0,0,3,3,0,6
143201,2023,Poland,China,0,0,8,8,15/07/2023,0,0,3,3,5,1,3,9,1,3,5,9,0,0,0,0,1,0,0,1
143201,2023,Brazil,China,1,0,17,18,13/07/2023,0,0,3,3,6,0,3,9,2,1,1,4,0,0,2,2,1,3,1,5
143201,2023,China,USA,0,0,3,3,2/7/2023,0,0,1,1,2,0,2,4,0,2,0,2,0,0,2,2,0,0,0,0
143201,2023,Korea,China,0,1,15,16,1/7/2023,0,0,3,3,7,1,10,18,2,4,4,10,0,0,0,0,0,0,0,0
143201,2023,China,Dominican Republic,0,1,6,7,30/06/2023,0,0,0,0,7,0,5,12,2,0,4,6,0,1,0,1,1,1,0,2
143201,2023,China,Serbia,0,0,0,0,28/06/2023,0,0,0,0,0,0,0,0,0,0,0,0,0,0,0,0,0,0,0,0
143201,2023,Italy,China,0,2,14,16,18/06/2023,0,0,2,2,11,2,5,18,2,3,7,12,0,0,2,2,6,0,1,7
143201,2023,Poland,China,1,0,2,3,17/06/2023,0,0,1,1,3,0,0,3,1,2,0,3,0,0,0,0,2,1,0,3
143201,2023,Bulgaria,China,0,2,11,13,16/06/2023,0,1,1,2,6,1,8,15,3,3,0,6,0,0,0,0,3,0,0,3
143201,2023,China,Canada,0,0,11,11,13/06/2023,0,0,0,0,8,0,4,12,1,2,4,7,0,0,0,0,1,2,2,5
143201,2023,Japan,China,0,0,11,11,4/6/2023,0,0,1,1,10,0,3,13,1,1,3,5,1,0,3,4,2,0,1,3
143201,2023,China,Netherlands,1,0,21,22,3/6/2023,0,1,4,5,11,0,4,15,4,5,0,9,0,0,0,0,3,0,0,3
143201,2023,China,Germany,0,0,11,11,2/6/2023,0,0,4,4,11,0,4,15,0,2,2,4,0,0,0,0,1,0,1,2
143201,2023,China,Brazil,0,2,11,13,31/05/2023,0,0,0,0,8,0,7,15,1,3,5,9,0,0,0,0,0,0,1,1
162979,2023,China,Türkiye,0,0,2,2,16/07/2023,5,2,15,22,0,0,0,0,0,0,0,0,0,0,0,0,0,0,0,0
162979,2023,Poland,China,0,0,0,0,15/07/2023,0,0,0,0,0,0,0,0,0,0,0,0,0,0,0,0,0,0,0,0
162979,2023,Brazil,China,0,0,0,0,13/07/2023,1,0,2,3,0,0,0,0,0,0,0,0,0,0,0,0,1,1,0,2
162979,2023,China,USA,0,0,0,0,2/7/2023,1,2,7,10,0,0,1,1,0,1,1,2,0,0,0,0,1,0,0,1
162979,2023,Korea,China,0,0,1,1,1/7/2023,1,0,4,5,0,0,1,1,0,0,0,0,0,0,0,0,0,1,1,2
162979,2023,China,Dominican Republic,1,0,4,5,30/06/2023,11,0,22,33,0,1,0,1,0,0,0,0,0,0,0,0,0,1,0,1
162979,2023,China,Serbia,0,0,1,1,28/06/2023,5,0,5,10,0,0,1,1,0,0,0,0,0,0,0,0,0,1,0,1
162979,2023,Italy,China,0,0,0,0,18/06/2023,2,0,1,3,0,0,0,0,0,0,0,0,0,0,0,0,0,0,0,0
162979,2023,Poland,China,0,0,0,0,17/06/2023,4,0,4,8,0,0,0,0,0,0,0,0,0,0,0,0,0,0,0,0
162979,2023,Bulgaria,China,1,0,3,4,16/06/2023,1,0,3,4,0,0,0,0,0,0,0,0,0,0,0,0,0,0,0,0
162979,2023,China,Canada,1,0,0,1,13/06/2023,3,0,6,9,0,0,0,0,0,0,0,0,0,0,0,0,0,0,0,0
162979,2023,Japan,China,0,0,0,0,4/6/2023,0,0,5,5,0,0,0,0,0,0,0,0,0,0,0,0,0,0,0,0
162979,2023,China,Netherlands,0,0,0,0,3/6/2023,0,0,0,0,0,0,0,0,0,0,0,0,0,0,0,0,0,0,0,0
162979,2023,China,Germany,0,0,0,0,2/6/2023,0,0,0,0,0,0,0,0,0,0,0,0,0,0,0,0,0,0,0,0
162979,2023,China,Brazil,0,0,0,0,31/05/2023,0,1,9,10,0,0,0,0,0,0,0,0,0,0,0,0,1,0,0,1
135740,2023,China,Türkiye,1,2,13,16,16/07/2023,0,0,2,2,8,7,4,19,0,4,1,5,4,4,15,23,8,5,2,15
135740,2023,Poland,China,0,0,15,15,15/07/2023,0,0,3,3,11,1,4,16,2,3,3,8,8,2,11,21,5,2,2,9
135740,2023,Brazil,China,0,0,16,16,13/07/2023,0,0,2,2,5,3,12,20,2,3,3,8,4,2,13,19,3,1,0,4
135740,2023,China,USA,0,2,19,21,2/7/2023,0,0,0,0,12,2,14,28,0,4,6,10,5,1,10,16,7,3,1,11
135740,2023,Korea,China,1,2,8,11,1/7/2023,0,0,1,1,14,1,11,26,0,7,1,8,4,1,13,18,10,2,1,13
135740,2023,China,Dominican Republic,3,1,16,20,30/06/2023,0,0,2,2,6,4,9,19,0,1,2,3,9,3,14,26,4,5,1,10
135740,2023,China,Serbia,0,2,10,12,28/06/2023,0,0,1,1,7,4,9,20,0,1,4,5,12,4,13,29,6,5,0,11
135740,2023,Italy,China,0,2,13,15,18/06/2023,0,0,3,3,5,7,5,17,1,2,1,4,10,0,26,36,5,4,2,11
135740,2023,Poland,China,1,1,8,10,17/06/2023,0,0,3,3,6,4,7,17,2,3,1,6,4,0,17,21,4,3,1,8
135740,2023,Bulgaria,China,1,1,11,13,16/06/2023,0,0,2,2,8,6,8,22,1,5,0,6,10,0,15,25,6,4,0,10
135740,2023,China,Canada,1,5,7,13,13/06/2023,0,0,1,1,5,2,9,16,1,2,2,5,0,1,13,14,6,1,0,7
135740,2023,Japan,China,0,0,14,14,4/6/2023,0,0,0,0,4,3,7,14,1,0,2,3,3,3,13,19,6,0,0,6
135740,2023,China,Netherlands,0,2,9,11,3/6/2023,0,0,0,0,13,4,7,24,1,0,3,4,5,0,16,21,4,0,2,6
135740,2023,China,Germany,0,1,8,9,2/6/2023,0,0,2,2,8,2,7,17,1,1,1,3,4,1,4,9,8,1,3,12
135740,2023,China,Brazil,1,1,19,21,31/05/2023,0,0,0,0,9,7,12,28,0,1,0,1,7,1,18,26,13,0,1,14
152920,2023,China,Türkiye,0,1,0,1,16/07/2023,0,0,0,0,0,0,0,0,0,0,0,0,0,0,1,1,1,0,0,1
152920,2023,Poland,China,0,0,0,0,15/07/2023,0,0,0,0,0,0,0,0,0,0,0,0,0,0,0,0,0,0,0,0
152920,2023,Brazil,China,0,0,0,0,13/07/2023,0,0,0,0,0,0,0,0,0,0,0,0,0,0,0,0,0,0,0,0
152920,2023,China,USA,0,0,0,0,2/7/2023,0,0,0,0,0,0,0,0,0,0,0,0,0,0,0,0,0,0,0,0
152920,2023,Korea,China,0,0,0,0,1/7/2023,0,0,0,0,0,0,0,0,0,0,0,0,0,0,0,0,0,0,0,0
152920,2023,China,Dominican Republic,0,0,6,6,30/06/2023,0,0,0,0,1,0,2,3,0,0,0,0,0,1,3,4,4,0,0,4
152920,2023,China,Serbia,0,1,3,4,28/06/2023,0,0,0,0,2,0,3,5,0,2,0,2,3,1,1,5,0,0,0,0
152920,2023,Italy,China,0,0,2,2,18/06/2023,0,0,0,0,0,1,0,1,0,0,0,0,1,0,4,5,1,1,0,2
152920,2023,Poland,China,0,0,0,0,17/06/2023,0,0,0,0,0,0,0,0,0,0,0,0,0,0,0,0,0,0,0,0
152920,2023,Bulgaria,China,0,0,0,0,16/06/2023,0,0,0,0,0,1,1,2,0,0,0,0,0,0,0,0,0,0,0,0
152920,2023,China,Canada,0,0,0,0,13/06/2023,0,0,0,0,0,0,0,0,0,0,0,0,0,0,0,0,0,0,0,0
152920,2023,Japan,China,0,1,4,5,4/6/2023,0,0,0,0,1,2,2,5,1,0,0,1,0,0,3,3,3,0,0,3
152920,2023,China,Netherlands,0,1,1,2,3/6/2023,0,0,0,0,0,0,4,4,0,0,1,1,0,0,2,2,1,0,0,1
152920,2023,China,Germany,0,0,0,0,2/6/2023,0,0,0,0,0,0,0,0,0,0,0,0,0,0,0,0,0,0,0,0
152920,2023,China,Brazil,0,0,0,0,31/05/2023,0,0,0,0,0,0,0,0,0,0,0,0,0,0,0,0,0,0,0,0
152318,2023,China,Türkiye,1,3,9,13,16/07/2023,0,0,2,2,19,4,18,41,1,3,1,5,4,1,7,12,10,6,0,16
152318,2023,Poland,China,0,1,15,16,15/07/2023,0,0,4,4,13,3,8,24,1,1,4,6,2,0,10,12,4,0,1,5
152318,2023,Brazil,China,0,2,17,19,13/07/2023,0,0,2,2,16,5,19,40,0,1,0,1,7,3,13,23,6,4,2,12
152318,2023,China,USA,2,2,19,23,2/7/2023,0,0,1,1,26,7,13,46,0,1,4,5,6,1,12,19,7,3,3,13
152318,2023,Korea,China,2,1,9,12,1/7/2023,0,0,6,6,10,5,10,25,2,2,5,9,5,1,12,18,7,1,0,8
152318,2023,China,Dominican Republic,0,2,16,18,30/06/2023,0,0,3,3,22,9,15,46,2,4,1,7,17,0,10,27,5,8,0,13
152318,2023,China,Serbia,0,2,13,15,28/06/2023,0,0,3,3,18,3,13,34,0,5,2,7,3,3,10,16,3,2,0,5
152318,2023,Italy,China,1,1,17,19,18/06/2023,0,0,1,1,20,8,18,46,3,3,0,6,2,1,6,9,12,4,1,17
152318,2023,Poland,China,0,2,9,11,17/06/2023,0,0,3,3,12,5,15,32,1,9,2,12,5,1,10,16,4,0,0,4
152318,2023,Bulgaria,China,3,2,15,20,16/06/2023,0,0,3,3,15,1,10,26,0,4,4,8,2,0,15,17,11,1,1,13
152318,2023,China,Canada,0,2,10,12,13/06/2023,0,0,3,3,13,2,13,28,1,2,3,6,3,0,5,8,1,2,1,4
152318,2023,Japan,China,0,1,11,12,4/6/2023,0,0,0,0,19,3,11,33,1,2,1,4,2,1,6,9,9,0,1,10
152318,2023,China,Netherlands,4,3,14,21,3/6/2023,0,0,0,0,20,5,13,38,3,0,0,3,13,4,10,27,5,0,6,11
152318,2023,China,Germany,0,1,13,14,2/6/2023,0,0,1,1,14,2,10,26,0,0,0,0,7,1,12,20,6,0,1,7
152318,2023,China,Brazil,1,2,16,19,31/05/2023,0,0,1,1,25,4,12,41,0,2,0,2,11,0,23,34,11,2,2,15
135742,2023,China,Türkiye,0,0,1,1,16/07/2023,0,0,0,0,3,0,0,3,0,0,0,0,0,0,1,1,2,0,0,2
135742,2023,Poland,China,0,0,0,0,15/07/2023,0,0,0,0,0,0,0,0,0,0,0,0,0,0,0,0,0,0,0,0
135742,2023,Brazil,China,0,1,0,1,13/07/2023,0,0,0,0,2,0,0,2,1,0,1,2,0,0,0,0,0,0,0,0
135742,2023,China,USA,0,0,2,2,2/7/2023,0,0,0,0,0,0,4,4,0,0,1,1,0,0,2,2,0,0,0,0
135742,2023,Korea,China,0,0,0,0,1/7/2023,0,0,0,0,0,0,0,0,0,0,0,0,0,0,0,0,0,0,0,0
135742,2023,China,Dominican Republic,0,0,6,6,30/06/2023,0,0,0,0,1,0,5,6,0,0,2,2,1,0,1,2,2,5,0,7
135742,2023,China,Serbia,0,0,0,0,28/06/2023,0,0,0,0,0,0,0,0,0,0,1,1,0,0,0,0,0,0,0,0
135742,2023,Italy,China,0,0,0,0,18/06/2023,0,0,0,0,1,0,0,1,0,0,0,0,0,0,0,0,0,0,0,0
135742,2023,Poland,China,0,1,2,3,17/06/2023,0,0,0,0,3,0,0,3,1,0,1,2,0,0,0,0,3,0,0,3
135742,2023,Bulgaria,China,0,0,7,7,16/06/2023,0,0,0,0,6,3,3,12,2,0,6,8,0,0,0,0,2,1,1,4
135742,2023,China,Canada,0,0,2,2,13/06/2023,0,0,0,0,1,0,0,1,0,0,0,0,0,0,0,0,1,1,0,2
135742,2023,Japan,China,0,0,0,0,4/6/2023,0,0,0,0,0,0,0,0,0,0,0,0,0,0,0,0,0,0,0,0
135742,2023,China,Netherlands,1,1,3,5,3/6/2023,0,0,0,0,1,1,3,5,1,0,0,1,0,0,1,1,0,0,0,0
135742,2023,China,Germany,0,0,0,0,2/6/2023,0,0,0,0,0,0,0,0,0,0,0,0,0,0,0,0,0,0,0,0
135742,2023,China,Brazil,0,0,0,0,31/05/2023,0,0,0,0,2,0,2,4,0,0,1,1,0,0,0,0,1,0,0,1
163909,2023,China,Türkiye,0,0,0,0,16/07/2023,0,0,2,2,0,0,0,0,0,0,0,0,0,0,0,0,1,1,1,3
163909,2023,Poland,China,0,0,0,0,15/07/2023,0,0,0,0,0,0,0,0,0,0,0,0,0,0,0,0,0,0,0,0
163909,2023,Brazil,China,0,0,1,1,13/07/2023,0,0,0,0,0,0,0,0,0,0,0,0,0,0,0,0,0,1,0,1
163909,2023,China,USA,0,0,0,0,2/7/2023,0,0,2,2,0,0,0,0,0,0,0,0,0,0,0,0,1,1,1,3
163909,2023,Korea,China,0,0,0,0,1/7/2023,0,0,1,1,0,0,0,0,0,0,0,0,0,0,0,0,2,0,1,3
163909,2023,China,Dominican Republic,0,0,0,0,30/06/2023,0,0,3,3,0,0,0,0,0,0,0,0,0,0,0,0,7,5,0,12
163909,2023,China,Serbia,0,0,0,0,28/06/2023,0,0,1,1,0,0,0,0,0,0,0,0,0,0,0,0,11,0,1,12
163909,2023,Italy,China,0,0,0,0,18/06/2023,0,0,0,0,0,0,0,0,0,0,0,0,0,0,0,0,5,1,0,6
163909,2023,Poland,China,0,0,0,0,17/06/2023,0,0,0,0,0,0,0,0,0,0,0,0,0,0,0,0,0,0,0,0
163909,2023,Bulgaria,China,0,0,0,0,16/06/2023,0,0,0,0,0,0,0,0,0,0,0,0,0,0,0,0,0,0,0,0
163909,2023,China,Canada,0,0,0,0,13/06/2023,0,0,0,0,0,0,0,0,0,0,0,0,0,0,0,0,0,0,0,0
163909,2023,Japan,China,0,0,0,0,4/6/2023,0,0,0,0,0,0,0,0,0,0,0,0,0,0,0,0,0,0,0,0
163909,2023,China,Netherlands,0,0,0,0,3/6/2023,0,0,0,0,0,0,0,0,0,0,0,0,0,0,0,0,0,0,0,0
163909,2023,China,Germany,0,0,0,0,2/6/2023,0,0,0,0,0,0,0,0,0,0,0,0,0,0,0,0,0,0,0,0
163909,2023,China,Brazil,0,0,0,0,31/05/2023,0,0,0,0,0,0,0,0,0,0,0,0,0,0,0,0,0,0,0,0
135745,2023,China,Türkiye,0,0,0,0,16/07/2023,0,0,4,4,0,0,0,0,0,0,0,0,5,1,24,30,10,1,1,12
135745,2023,Poland,China,0,0,0,0,15/07/2023,0,0,4,4,0,0,0,0,0,0,0,0,3,1,7,11,10,5,2,17
135745,2023,Brazil,China,0,0,0,0,13/07/2023,0,0,9,9,0,0,0,0,0,0,0,0,2,1,9,12,10,2,2,14
135745,2023,China,USA,0,0,0,0,2/7/2023,0,0,8,8,0,0,0,0,0,0,0,0,4,0,13,17,13,1,1,15
135745,2023,Korea,China,0,0,0,0,1/7/2023,0,0,2,2,0,0,0,0,0,0,0,0,2,1,10,13,8,1,1,10
135745,2023,China,Dominican Republic,0,0,0,0,30/06/2023,0,0,8,8,0,0,0,0,0,0,0,0,13,1,10,24,10,4,0,14
135745,2023,China,Serbia,0,0,0,0,28/06/2023,0,0,7,7,0,0,0,0,0,0,0,0,1,0,7,8,7,2,0,9
135745,2023,Italy,China,0,0,0,0,18/06/2023,0,0,7,7,0,0,0,0,0,0,0,0,6,1,13,20,10,1,1,12
135745,2023,Poland,China,0,0,0,0,17/06/2023,0,0,8,8,0,0,0,0,0,0,0,0,5,1,13,19,7,3,0,10
135745,2023,Bulgaria,China,0,0,0,0,16/06/2023,0,0,7,7,0,0,0,0,0,0,0,0,1,0,7,8,16,5,1,22
135745,2023,China,Canada,0,0,0,0,13/06/2023,0,0,4,4,0,0,0,0,0,0,0,0,3,0,14,17,9,5,2,16
135745,2023,Japan,China,0,0,0,0,4/6/2023,0,0,7,7,0,0,0,0,0,0,0,0,5,1,11,17,7,0,1,8
135745,2023,China,Netherlands,0,0,0,0,3/6/2023,0,0,9,9,0,0,0,0,0,0,0,0,3,0,15,18,6,1,2,9
135745,2023,China,Germany,0,0,0,0,2/6/2023,0,0,11,11,0,0,0,0,0,0,0,0,2,2,7,11,13,1,2,16
135745,2023,China,Brazil,0,0,0,0,31/05/2023,0,0,6,6,0,0,0,0,0,0,0,0,9,0,8,17,15,0,3,18
143198,2023,China,Türkiye,0,0,1,1,16/07/2023,0,0,0,0,0,0,0,0,0,0,0,0,0,0,0,0,0,0,0,0
143198,2023,Poland,China,0,0,3,3,15/07/2023,0,0,0,0,0,0,0,0,0,0,0,0,0,0,0,0,0,0,0,0
143198,2023,Brazil,China,0,0,2,2,13/07/2023,0,0,0,0,0,0,0,0,0,0,0,0,0,0,0,0,0,0,0,0
143198,2023,China,USA,0,0,2,2,2/7/2023,0,0,0,0,0,0,0,0,0,0,0,0,0,0,0,0,0,0,0,0
143198,2023,Korea,China,0,0,1,1,1/7/2023,0,0,0,0,0,0,0,0,0,0,0,0,0,0,0,0,0,0,0,0
143198,2023,China,Dominican Republic,0,1,0,1,30/06/2023,0,0,0,0,0,0,0,0,0,0,0,0,0,0,0,0,0,0,0,0
143198,2023,China,Serbia,0,0,0,0,28/06/2023,0,0,0,0,0,0,0,0,0,0,0,0,0,0,0,0,0,0,0,0
143198,2023,Italy,China,0,1,1,2,18/06/2023,0,0,0,0,0,0,0,0,0,0,0,0,0,0,0,0,1,0,0,1
143198,2023,Poland,China,0,0,2,2,17/06/2023,0,0,0,0,0,0,0,0,0,0,0,0,0,0,0,0,0,0,0,0
143198,2023,Bulgaria,China,0,0,0,0,16/06/2023,0,0,0,0,0,0,0,0,0,0,0,0,0,0,0,0,0,0,0,0
143198,2023,China,Canada,0,0,1,1,13/06/2023,0,0,0,0,0,0,0,0,0,0,0,0,0,0,0,0,0,0,0,0
143198,2023,Japan,China,0,0,2,2,4/6/2023,0,0,0,0,0,0,0,0,0,0,0,0,0,0,0,0,0,0,0,0
143198,2023,China,Netherlands,0,0,3,3,3/6/2023,0,0,0,0,0,0,0,0,0,0,0,0,0,0,0,0,0,0,0,0
143198,2023,China,Germany,0,0,0,0,2/6/2023,0,0,0,0,0,0,0,0,0,0,0,0,0,0,0,0,0,0,0,0
143198,2023,China,Brazil,0,1,1,2,31/05/2023,0,0,0,0,0,0,0,0,0,0,0,0,0,0,0,0,0,0,0,0
194499,2023,Croatia,Türkiye,0,1,7,8,2/7/2023,6,0,46,52,0,0,3,3,0,2,0,2,0,0,1,1,5,1,0,6
194499,2023,Italy,Croatia,0,1,0,1,1/7/2023,6,0,32,38,0,0,3,3,0,3,3,6,0,0,0,0,2,0,0,2
194499,2023,Croatia,Netherlands,0,0,6,6,29/06/2023,9,4,59,72,0,1,0,1,0,1,0,1,0,0,1,1,7,3,1,11
194499,2023,Croatia,Canada,0,1,9,10,27/06/2023,18,1,82,101,1,0,2,3,1,4,3,8,0,0,0,0,6,2,1,9
194499,2023,Thailand,Croatia,1,0,9,10,18/06/2023,17,0,75,92,0,0,2,2,0,4,4,8,0,0,0,0,5,3,1,9
194499,2023,Serbia,Croatia,1,1,6,8,18/06/2023,18,3,68,89,0,0,1,1,0,3,2,5,0,0,0,0,8,5,1,14
194499,2023,Korea,Croatia,0,0,5,5,16/06/2023,34,0,56,90,2,0,3,5,2,3,3,8,0,0,0,0,8,3,1,12
194499,2023,Croatia,USA,2,2,9,13,13/06/2023,13,0,100,113,3,0,4,7,0,0,9,9,0,0,0,0,7,5,2,14
194499,2023,Croatia,Brazil,0,0,8,8,4/6/2023,9,1,70,80,0,0,0,0,0,1,4,5,0,0,0,0,3,0,1,4
194499,2023,Croatia,Japan,2,1,6,9,2/6/2023,3,0,103,106,0,0,0,0,2,0,3,5,0,0,0,0,3,0,1,4
194499,2023,Croatia,Germany,0,0,10,10,1/6/2023,8,0,66,74,0,1,0,1,0,1,0,1,0,0,0,0,8,3,0,11
194499,2023,Croatia,Bulgaria,0,1,2,3,31/05/2023,7,1,36,44,0,0,0,0,1,0,1,2,0,0,0,0,4,0,0,4
194498,2023,Croatia,Türkiye,0,1,6,7,2/7/2023,0,0,1,1,6,3,16,25,0,2,3,5,3,1,18,22,4,0,1,5
194498,2023,Italy,Croatia,0,0,5,5,1/7/2023,0,0,2,2,5,4,16,25,2,2,1,5,1,1,14,16,5,4,0,9
194498,2023,Croatia,Netherlands,0,2,5,7,29/06/2023,0,0,1,1,9,8,12,29,1,2,1,4,0,0,0,0,2,6,2,10
194498,2023,Croatia,Canada,1,0,3,4,27/06/2023,0,0,2,2,4,2,7,13,0,0,2,2,0,0,0,0,1,2,0,3
194498,2023,Thailand,Croatia,0,2,4,6,18/06/2023,0,0,1,1,17,1,16,34,2,1,5,8,0,0,0,0,8,4,2,14
194498,2023,Serbia,Croatia,0,0,5,5,18/06/2023,0,0,1,1,6,5,8,19,0,3,1,4,0,0,0,0,2,4,1,7
194498,2023,Korea,Croatia,1,0,16,17,16/06/2023,0,0,2,2,8,3,16,27,0,3,5,8,0,0,0,0,7,1,1,9
194498,2023,Croatia,USA,0,4,3,7,13/06/2023,0,0,1,1,13,5,20,38,1,0,7,8,0,0,0,0,8,2,1,11
194498,2023,Croatia,Brazil,2,1,6,9,4/6/2023,0,0,1,1,10,6,15,31,2,2,2,6,0,0,1,1,4,0,1,5
194498,2023,Croatia,Japan,0,2,6,8,2/6/2023,0,1,0,1,8,10,27,45,0,0,3,3,0,0,1,1,6,0,3,9
194498,2023,Croatia,Germany,1,2,6,9,1/6/2023,0,0,1,1,16,1,13,30,1,0,3,4,0,0,0,0,7,1,1,9
194498,2023,Croatia,Bulgaria,0,2,5,7,31/05/2023,0,0,1,1,7,8,13,28,1,1,1,3,0,0,0,0,5,1,1,7
156438,2023,Croatia,Türkiye,1,1,12,14,2/7/2023,0,0,1,1,4,0,4,8,2,4,1,7,0,0,0,0,0,2,1,3
156438,2023,Italy,Croatia,0,1,7,8,1/7/2023,0,0,1,1,2,0,3,5,0,6,5,11,0,0,0,0,0,1,0,1
156438,2023,Croatia,Netherlands,0,0,6,6,29/06/2023,0,0,0,0,3,1,3,7,1,2,3,6,0,0,0,0,1,1,0,2
156438,2023,Croatia,Canada,1,0,13,14,27/06/2023,0,0,1,1,6,0,5,11,3,6,3,12,0,0,0,0,4,1,1,6
156438,2023,Thailand,Croatia,2,1,13,16,18/06/2023,0,0,3,3,3,2,3,8,1,1,6,8,0,0,0,0,4,0,1,5
156438,2023,Serbia,Croatia,0,1,10,11,18/06/2023,0,0,3,3,5,1,4,10,3,3,6,12,0,0,0,0,5,3,1,9
156438,2023,Korea,Croatia,1,0,10,11,16/06/2023,0,0,3,3,3,1,6,10,4,2,9,15,0,0,0,0,4,3,2,9
156438,2023,Croatia,USA,0,1,11,12,13/06/2023,0,0,2,2,3,1,8,12,3,5,3,11,0,0,0,0,2,1,0,3
156438,2023,Croatia,Brazil,0,0,8,8,4/6/2023,0,0,0,0,4,2,2,8,4,1,3,8,0,0,0,0,4,0,0,4
156438,2023,Croatia,Japan,0,2,7,9,2/6/2023,0,0,0,0,3,1,6,10,3,0,1,4,1,0,0,1,3,0,0,3
156438,2023,Croatia,Germany,0,0,5,5,1/6/2023,0,0,2,2,2,0,5,7,4,4,2,10,0,0,1,1,2,0,0,2
156438,2023,Croatia,Bulgaria,1,0,7,8,31/05/2023,0,0,0,0,3,3,5,11,1,4,5,10,0,0,0,0,0,0,0,0
162957,2023,Croatia,Türkiye,0,0,0,0,2/7/2023,0,0,0,0,0,0,0,0,0,0,0,0,0,0,0,0,0,0,0,0
162957,2023,Italy,Croatia,0,0,0,0,1/7/2023,0,0,0,0,0,0,0,0,0,0,0,0,0,0,0,0,0,0,0,0
162957,2023,Croatia,Netherlands,0,0,0,0,29/06/2023,0,0,0,0,0,0,0,0,0,0,0,0,0,0,0,0,0,0,0,0
162957,2023,Croatia,Canada,0,0,0,0,27/06/2023,0,0,0,0,0,0,0,0,0,0,0,0,0,0,0,0,0,0,0,0
173970,2023,Croatia,Türkiye,0,0,0,0,2/7/2023,0,0,14,14,0,0,0,0,0,0,0,0,0,0,0,0,0,1,0,1
173970,2023,Italy,Croatia,1,0,6,7,1/7/2023,9,0,37,46,1,0,1,2,0,0,0,0,0,1,0,1,1,1,1,3
173970,2023,Croatia,Netherlands,0,0,2,2,29/06/2023,1,0,6,7,0,0,1,1,0,1,1,2,0,0,0,0,0,0,0,0
173970,2023,Croatia,Canada,0,0,0,0,27/06/2023,0,0,6,6,0,0,0,0,0,0,0,0,0,0,0,0,0,0,0,0
173970,2023,Thailand,Croatia,0,0,0,0,18/06/2023,0,0,0,0,0,0,0,0,0,0,0,0,0,0,0,0,0,0,0,0
173970,2023,Serbia,Croatia,0,0,2,2,18/06/2023,3,0,16,19,0,0,1,1,0,3,2,5,0,0,0,0,3,1,0,4
173970,2023,Korea,Croatia,0,0,0,0,16/06/2023,0,0,0,0,0,0,0,0,0,0,0,0,0,0,0,0,0,0,0,0
173970,2023,Croatia,USA,0,0,1,1,13/06/2023,0,0,5,5,0,0,0,0,0,0,0,0,0,0,0,0,0,0,0,0
173970,2023,Croatia,Brazil,0,1,0,1,4/6/2023,0,0,0,0,0,0,0,0,0,0,0,0,0,0,0,0,0,0,0,0
173970,2023,Croatia,Japan,1,0,5,6,2/6/2023,0,0,2,2,0,0,0,0,0,0,0,0,0,0,0,0,0,0,0,0
173970,2023,Croatia,Germany,0,0,1,1,1/6/2023,1,0,4,5,0,0,0,0,0,0,0,0,0,0,0,0,0,0,0,0
173970,2023,Croatia,Bulgaria,0,0,6,6,31/05/2023,8,1,36,45,0,0,1,1,1,0,0,1,0,0,0,0,1,0,0,1
170571,2023,Croatia,Türkiye,0,0,0,0,2/7/2023,0,0,0,0,0,1,0,1,0,0,0,0,0,0,1,1,0,0,0,0
170571,2023,Italy,Croatia,1,0,2,3,1/7/2023,0,0,0,0,0,1,2,3,0,0,0,0,1,2,4,7,0,0,0,0
170571,2023,Croatia,Netherlands,0,0,6,6,29/06/2023,0,0,0,0,3,1,3,7,0,2,0,2,2,2,2,6,0,2,1,3
170571,2023,Croatia,Canada,0,0,9,9,27/06/2023,0,0,1,1,9,3,11,23,0,1,3,4,5,2,18,25,8,1,0,9
170571,2023,Thailand,Croatia,1,0,12,13,18/06/2023,0,0,1,1,9,3,12,24,0,1,3,4,5,1,8,14,7,2,0,9
170571,2023,Serbia,Croatia,0,0,0,0,18/06/2023,0,0,0,0,0,1,6,7,0,0,0,0,0,1,2,3,0,1,0,1
170571,2023,Korea,Croatia,0,1,13,14,16/06/2023,0,0,1,1,4,5,15,24,3,1,3,7,4,1,10,15,7,0,0,7
170571,2023,Croatia,USA,0,1,13,14,13/06/2023,0,0,1,1,15,6,14,35,0,1,4,5,5,1,24,30,10,3,0,13
170571,2023,Croatia,Brazil,0,2,6,8,4/6/2023,0,0,1,1,1,5,10,16,1,0,3,4,6,3,9,18,5,0,1,6
170571,2023,Croatia,Japan,0,1,7,8,2/6/2023,0,0,0,0,7,3,7,17,0,2,1,3,2,2,10,14,7,0,2,9
170571,2023,Croatia,Germany,0,0,2,2,1/6/2023,0,0,0,0,1,3,7,11,0,0,0,0,2,0,2,4,1,0,0,1
170571,2023,Croatia,Bulgaria,0,3,2,5,31/05/2023,0,0,0,0,5,3,17,25,0,3,5,8,0,0,8,8,5,0,2,7
147402,2023,Croatia,Türkiye,0,0,3,3,2/7/2023,0,0,0,0,1,0,0,1,0,0,0,0,2,1,5,8,2,1,1,4
147402,2023,Italy,Croatia,0,0,7,7,1/7/2023,0,0,2,2,1,1,5,7,1,0,0,1,3,0,11,14,4,0,0,4
147402,2023,Croatia,Netherlands,0,0,4,4,29/06/2023,0,0,0,0,3,2,6,11,0,0,0,0,3,2,15,20,0,4,0,4
147402,2023,Croatia,Canada,0,1,8,9,27/06/2023,0,0,3,3,4,3,10,17,0,0,1,1,4,0,10,14,2,1,0,3
147402,2023,Thailand,Croatia,0,0,6,6,18/06/2023,0,0,0,0,0,0,0,0,0,0,0,0,0,0,0,0,1,0,0,1
147402,2023,Serbia,Croatia,1,1,11,13,18/06/2023,0,0,1,1,10,8,15,33,0,1,1,2,4,0,12,16,12,3,1,16
147402,2023,Korea,Croatia,0,0,0,0,16/06/2023,0,0,0,0,0,0,0,0,0,0,0,0,0,0,0,0,0,0,0,0
147402,2023,Croatia,USA,0,0,2,2,13/06/2023,0,0,0,0,1,2,0,3,0,0,0,0,1,0,6,7,0,1,1,2
189437,2023,Croatia,Türkiye,0,0,6,6,2/7/2023,0,0,1,1,3,2,6,11,0,1,0,1,2,1,9,12,1,1,1,3
189437,2023,Italy,Croatia,0,0,3,3,1/7/2023,0,0,1,1,0,4,9,13,0,0,1,1,0,0,5,5,2,1,0,3
189437,2023,Croatia,Netherlands,0,0,2,2,29/06/2023,0,0,2,2,2,0,4,6,0,1,0,1,2,0,18,20,7,1,1,9
189437,2023,Croatia,Canada,0,0,5,5,27/06/2023,0,0,0,0,0,4,1,5,0,0,0,0,2,2,4,8,4,1,2,7
189437,2023,Thailand,Croatia,1,0,16,17,18/06/2023,0,0,3,3,7,2,12,21,1,2,0,3,6,0,19,25,12,3,1,16
189437,2023,Serbia,Croatia,0,1,3,4,18/06/2023,0,0,1,1,1,0,1,2,0,1,0,1,1,1,10,12,2,3,0,5
189437,2023,Korea,Croatia,1,0,9,10,16/06/2023,0,0,1,1,8,3,9,20,2,2,0,4,3,3,19,25,8,0,1,9
189437,2023,Croatia,USA,2,0,15,17,13/06/2023,0,0,3,3,11,4,8,23,1,1,0,2,5,1,25,31,5,6,2,13
189437,2023,Croatia,Brazil,0,1,7,8,4/6/2023,0,0,0,0,4,7,6,17,2,0,1,3,0,0,23,23,4,0,2,6
189437,2023,Croatia,Japan,0,0,9,9,2/6/2023,0,0,2,2,9,0,14,23,1,0,2,3,4,1,18,23,6,0,2,8
189437,2023,Croatia,Germany,0,0,17,17,1/6/2023,0,0,2,2,4,0,12,16,0,1,0,1,5,3,16,24,7,0,0,7
189437,2023,Croatia,Bulgaria,0,0,11,11,31/05/2023,0,0,0,0,3,0,7,10,0,3,0,3,3,2,16,21,5,0,0,5
189256,2023,Croatia,Türkiye,0,0,0,0,2/7/2023,0,0,0,0,0,0,0,0,0,0,0,0,0,0,0,0,1,0,0,1
189256,2023,Italy,Croatia,0,0,0,0,1/7/2023,0,0,0,0,0,0,0,0,0,0,0,0,0,0,0,0,0,0,0,0
189256,2023,Croatia,Netherlands,0,0,2,2,29/06/2023,0,0,3,3,1,4,6,11,0,0,1,1,1,0,8,9,4,0,0,4
189256,2023,Croatia,Canada,0,0,1,1,27/06/2023,0,0,0,0,1,0,0,1,0,0,0,0,1,0,0,1,0,0,0,0
189256,2023,Thailand,Croatia,0,0,0,0,18/06/2023,0,0,0,0,0,0,0,0,0,0,0,0,0,0,0,0,0,0,0,0
189256,2023,Serbia,Croatia,0,0,9,9,18/06/2023,0,0,2,2,9,2,15,26,0,2,6,8,7,4,26,37,3,2,3,8
189256,2023,Korea,Croatia,0,0,0,0,16/06/2023,0,0,0,0,0,0,0,0,0,0,0,0,0,0,0,0,0,0,0,0
189256,2023,Croatia,USA,0,0,0,0,13/06/2023,0,0,0,0,0,1,0,1,0,0,0,0,0,0,1,1,0,0,0,0
189256,2023,Croatia,Brazil,0,0,1,1,4/6/2023,0,0,0,0,0,0,1,1,0,0,0,0,0,1,3,4,1,0,0,1
189256,2023,Croatia,Japan,0,0,0,0,2/6/2023,0,0,0,0,0,1,3,4,0,0,0,0,0,0,0,0,1,0,0,1
189256,2023,Croatia,Germany,0,1,1,2,1/6/2023,0,0,3,3,1,0,5,6,1,0,1,2,1,0,6,7,2,0,1,3
189256,2023,Croatia,Bulgaria,0,0,2,2,31/05/2023,0,0,0,0,1,3,3,7,0,2,0,2,2,3,5,10,1,1,0,2
140914,2023,Croatia,Türkiye,0,2,6,8,2/7/2023,0,0,4,4,5,6,12,23,2,2,4,8,0,0,0,0,0,0,2,2
140914,2023,Italy,Croatia,0,1,10,11,1/7/2023,0,0,0,0,8,8,18,34,0,2,1,3,0,0,1,1,10,2,1,13
140914,2023,Croatia,Netherlands,0,0,0,0,29/06/2023,0,0,0,0,0,0,0,0,0,0,0,0,0,0,0,0,0,0,0,0
140914,2023,Croatia,Canada,0,0,10,10,27/06/2023,0,0,0,0,8,11,13,32,1,0,7,8,0,0,0,0,7,3,2,12
136824,2023,Croatia,Türkiye,0,1,7,8,2/7/2023,0,0,0,0,5,2,2,9,0,6,2,8,0,0,0,0,3,0,0,3
136824,2023,Italy,Croatia,0,1,4,5,1/7/2023,0,0,0,0,3,2,4,9,3,5,8,16,0,0,0,0,1,1,0,2
136824,2023,Croatia,Netherlands,1,0,6,7,29/06/2023,0,0,4,4,8,3,7,18,2,2,3,7,0,0,1,1,0,0,1,1
136824,2023,Croatia,Canada,0,2,6,8,27/06/2023,0,0,0,0,10,4,3,17,0,2,5,7,0,0,0,0,3,0,2,5
136824,2023,Thailand,Croatia,1,0,7,8,18/06/2023,0,0,2,2,10,2,4,16,3,0,4,7,0,0,0,0,1,1,2,4
136824,2023,Serbia,Croatia,0,2,7,9,18/06/2023,0,0,2,2,8,2,6,16,2,2,2,6,0,0,0,0,3,2,1,6
136824,2023,Korea,Croatia,3,0,13,16,16/06/2023,0,0,3,3,12,2,9,23,3,5,4,12,0,0,1,1,7,1,0,8
136824,2023,Croatia,USA,0,2,12,14,13/06/2023,0,0,3,3,8,2,10,20,1,6,9,16,0,0,0,0,4,1,0,5
136824,2023,Croatia,Brazil,1,1,7,9,4/6/2023,0,0,1,1,7,1,2,10,3,0,1,4,1,0,0,1,1,1,0,2
136824,2023,Croatia,Japan,0,1,2,3,2/6/2023,0,0,0,0,2,1,10,13,0,1,1,2,0,0,0,0,0,0,1,1
136824,2023,Croatia,Germany,0,0,11,11,1/6/2023,0,1,2,3,7,0,6,13,0,0,3,3,0,0,1,1,2,0,0,2
136824,2023,Croatia,Bulgaria,0,1,6,7,31/05/2023,0,0,1,1,9,2,4,15,1,3,0,4,0,0,0,0,2,0,0,2
186153,2023,Croatia,Türkiye,0,0,0,0,2/7/2023,0,0,0,0,0,0,0,0,0,0,0,0,0,0,0,0,0,0,0,0
186153,2023,Italy,Croatia,0,0,0,0,1/7/2023,0,0,0,0,0,0,0,0,0,0,0,0,0,0,0,0,0,0,0,0
186153,2023,Croatia,Netherlands,0,0,3,3,29/06/2023,0,0,1,1,0,1,0,1,0,0,0,0,0,0,0,0,0,0,0,0
186153,2023,Croatia,Canada,0,0,0,0,27/06/2023,0,0,0,0,0,0,0,0,0,0,0,0,0,0,0,0,0,0,0,0
186153,2023,Thailand,Croatia,0,0,0,0,18/06/2023,0,0,0,0,0,0,0,0,0,0,0,0,0,0,0,0,0,0,0,0
186153,2023,Serbia,Croatia,0,0,0,0,18/06/2023,0,0,0,0,0,0,0,0,0,0,0,0,0,0,0,0,0,0,0,0
186153,2023,Korea,Croatia,0,0,0,0,16/06/2023,0,0,0,0,0,0,0,0,0,0,0,0,0,0,0,0,0,0,0,0
186153,2023,Croatia,USA,0,0,0,0,13/06/2023,0,0,0,0,0,0,0,0,0,0,0,0,0,0,0,0,0,0,0,0
186153,2023,Croatia,Brazil,0,0,0,0,4/6/2023,0,0,0,0,0,0,0,0,0,0,0,0,0,0,0,0,0,0,0,0
186153,2023,Croatia,Japan,0,1,4,5,2/6/2023,0,0,0,0,0,0,3,3,1,0,1,2,0,0,0,0,1,0,0,1
186153,2023,Croatia,Germany,1,0,4,5,1/6/2023,0,0,0,0,0,0,0,0,0,0,0,0,0,0,0,0,0,0,1,1
186153,2023,Croatia,Bulgaria,0,0,0,0,31/05/2023,0,0,0,0,0,0,0,0,0,0,0,0,0,0,0,0,0,0,0,0
164734,2023,Croatia,Türkiye,0,2,1,3,2/7/2023,0,0,1,1,2,1,2,5,0,0,0,0,0,0,0,0,0,0,0,0
164734,2023,Italy,Croatia,0,0,0,0,1/7/2023,0,0,0,0,0,0,0,0,0,0,0,0,0,0,0,0,0,0,0,0
164734,2023,Croatia,Netherlands,1,1,0,2,29/06/2023,0,0,0,0,3,1,2,6,0,0,0,0,0,0,0,0,0,0,0,0
164734,2023,Croatia,Canada,0,0,0,0,27/06/2023,0,0,0,0,0,0,0,0,0,0,0,0,0,0,0,0,0,0,0,0
164734,2023,Thailand,Croatia,0,0,0,0,18/06/2023,0,0,0,0,0,0,0,0,0,0,0,0,0,0,0,0,0,0,0,0
164734,2023,Serbia,Croatia,0,2,2,4,18/06/2023,0,0,1,1,3,2,3,8,0,0,1,1,0,0,0,0,4,4,0,8
164734,2023,Korea,Croatia,0,0,0,0,16/06/2023,0,0,0,0,0,0,0,0,0,0,0,0,0,0,0,0,0,0,0,0
164734,2023,Croatia,USA,0,0,0,0,13/06/2023,0,0,0,0,0,1,0,1,0,0,0,0,0,0,0,0,0,0,0,0
189270,2023,Croatia,Türkiye,0,0,0,0,2/7/2023,0,0,11,11,0,0,0,0,0,0,0,0,7,0,13,20,7,6,3,16
189270,2023,Italy,Croatia,0,0,0,0,1/7/2023,0,0,10,10,0,0,0,0,0,0,0,0,7,2,15,24,9,5,0,14
189270,2023,Croatia,Netherlands,0,0,0,0,29/06/2023,0,0,11,11,0,0,0,0,0,0,0,0,4,2,8,14,9,1,0,10
189270,2023,Croatia,Canada,0,0,0,0,27/06/2023,0,0,10,10,0,0,0,0,0,0,0,0,6,0,18,24,18,5,0,23
189270,2023,Thailand,Croatia,0,0,0,0,18/06/2023,0,0,5,5,0,0,0,0,0,0,0,0,8,0,4,12,14,5,1,20
189270,2023,Serbia,Croatia,0,0,0,0,18/06/2023,0,0,17,17,0,0,0,0,0,0,0,0,5,3,13,21,14,5,1,20
189270,2023,Korea,Croatia,0,0,0,0,16/06/2023,0,0,5,5,0,0,0,0,0,0,0,0,5,3,5,13,20,1,2,23
189270,2023,Croatia,USA,0,0,0,0,13/06/2023,0,0,8,8,0,0,0,0,0,0,0,0,5,1,8,14,14,8,1,23
189270,2023,Croatia,Brazil,0,0,0,0,4/6/2023,0,0,3,3,0,0,0,0,0,0,0,0,5,3,13,21,6,1,3,10
189270,2023,Croatia,Japan,0,0,0,0,2/6/2023,0,0,5,5,0,0,0,0,0,0,0,0,15,1,10,26,22,0,4,26
189270,2023,Croatia,Germany,0,0,0,0,1/6/2023,0,0,9,9,0,0,0,0,0,0,0,0,7,0,4,11,14,1,4,19
189270,2023,Croatia,Bulgaria,0,0,0,0,31/05/2023,0,0,7,7,0,0,0,0,0,0,0,0,7,4,16,27,13,2,2,17
158817,2023,Serbia,Dominican Republic,0,1,6,7,1/7/2023,0,0,1,1,0,0,0,0,0,0,0,0,1,0,3,4,1,1,1,3
158817,2023,China,Dominican Republic,0,1,8,9,30/06/2023,0,0,3,3,0,0,0,0,0,0,0,0,2,0,5,7,3,3,0,6
158817,2023,Dominican Republic,Korea,0,1,4,5,29/06/2023,0,0,2,2,0,0,0,0,0,0,0,0,0,0,0,0,6,1,0,7
158817,2023,Germany,Dominican Republic,0,0,3,3,27/06/2023,0,0,0,0,0,0,0,0,0,0,0,0,0,0,3,3,5,0,1,6
158817,2023,Dominican Republic,Türkiye,0,1,5,6,18/06/2023,0,0,0,0,0,0,0,0,0,0,0,0,2,0,3,5,2,3,1,6
158817,2023,Dominican Republic,Canada,0,0,0,0,17/06/2023,0,0,0,0,0,0,0,0,0,0,0,0,0,0,0,0,0,0,0,0
158817,2023,Dominican Republic,Italy,0,0,0,0,15/06/2023,0,0,0,0,0,0,0,0,0,0,0,0,0,0,0,0,0,0,0,0
158817,2023,Dominican Republic,Poland,0,0,0,0,13/06/2023,0,0,0,0,0,0,0,0,0,0,0,0,0,0,0,0,0,0,0,0
158817,2023,Brazil,Dominican Republic,0,1,2,3,3/6/2023,0,0,7,7,0,0,0,0,0,0,0,0,4,1,20,25,7,0,1,8
158817,2023,Dominican Republic,Netherlands,0,0,0,0,2/6/2023,1,0,6,7,0,0,0,0,0,0,0,0,5,2,21,28,16,0,2,18
158817,2023,Bulgaria,Dominican Republic,0,0,0,0,1/6/2023,0,0,9,9,0,0,0,0,0,0,0,0,6,3,6,15,11,1,2,14
158817,2023,Japan,Dominican Republic,0,0,0,0,30/05/2023,1,0,9,10,0,0,0,0,0,0,0,0,2,2,8,12,22,4,2,28
119591,2023,Serbia,Dominican Republic,0,0,0,0,1/7/2023,0,0,0,0,0,0,0,0,0,0,0,0,0,0,0,0,0,0,0,0
119591,2023,China,Dominican Republic,0,0,0,0,30/06/2023,0,0,0,0,0,0,0,0,0,0,0,0,0,0,0,0,0,0,0,0
119591,2023,Dominican Republic,Korea,0,0,0,0,29/06/2023,0,0,0,0,0,0,0,0,0,0,0,0,0,0,0,0,0,0,0,0
119591,2023,Germany,Dominican Republic,0,0,0,0,27/06/2023,0,0,0,0,0,0,0,0,0,0,0,0,0,0,0,0,0,0,0,0
119591,2023,Dominican Republic,Türkiye,0,0,0,0,18/06/2023,0,0,0,0,0,0,0,0,0,0,0,0,0,0,0,0,0,0,0,0
119591,2023,Dominican Republic,Canada,0,0,0,0,17/06/2023,0,0,0,0,0,0,0,0,0,0,0,0,0,0,0,0,0,0,0,0
119591,2023,Dominican Republic,Italy,0,0,0,0,15/06/2023,0,0,0,0,0,0,0,0,0,0,0,0,0,0,0,0,0,0,0,0
119591,2023,Dominican Republic,Poland,1,2,14,17,13/06/2023,0,0,1,1,1,1,5,7,1,4,8,13,0,0,0,0,2,1,1,4
119591,2023,Brazil,Dominican Republic,0,0,13,13,3/6/2023,0,0,0,0,6,3,4,13,2,2,3,7,0,0,0,0,6,0,1,7
119591,2023,Dominican Republic,Netherlands,2,1,22,25,2/6/2023,0,0,6,6,2,2,1,5,6,2,5,13,0,0,0,0,3,0,0,3
119591,2023,Bulgaria,Dominican Republic,1,1,17,19,1/6/2023,0,0,5,5,9,1,2,12,3,4,4,11,0,2,0,2,5,0,0,5
119591,2023,Japan,Dominican Republic,1,0,11,12,30/05/2023,0,0,8,8,6,1,7,14,3,5,6,14,0,0,1,1,2,0,0,2
151087,2023,Serbia,Dominican Republic,0,0,0,0,1/7/2023,0,0,0,0,0,0,0,0,0,0,0,0,0,0,0,0,0,0,0,0
151087,2023,China,Dominican Republic,0,0,3,3,30/06/2023,0,1,0,1,2,3,1,6,0,0,0,0,0,0,3,3,3,0,0,3
151087,2023,Dominican Republic,Korea,0,1,3,4,29/06/2023,0,0,1,1,8,1,9,18,0,1,3,4,3,1,9,13,1,2,0,3
151087,2023,Germany,Dominican Republic,0,0,0,0,27/06/2023,0,1,0,1,0,0,2,2,0,0,1,1,0,0,1,1,0,0,0,0
151087,2023,Dominican Republic,Türkiye,0,0,0,0,18/06/2023,0,0,0,0,0,0,0,0,0,0,0,0,0,0,0,0,0,0,0,0
151087,2023,Dominican Republic,Canada,0,0,2,2,17/06/2023,0,0,1,1,0,0,0,0,0,0,0,0,0,0,0,0,0,1,0,1
151087,2023,Dominican Republic,Italy,0,0,3,3,15/06/2023,0,0,0,0,0,0,0,0,0,0,0,0,0,0,0,0,0,1,0,1
151087,2023,Dominican Republic,Poland,0,0,4,4,13/06/2023,0,0,0,0,0,0,0,0,0,0,0,0,0,0,0,0,0,1,1,2
151087,2023,Brazil,Dominican Republic,0,0,3,3,3/6/2023,0,0,0,0,0,0,0,0,0,0,0,0,0,0,0,0,0,0,0,0
151087,2023,Dominican Republic,Netherlands,0,0,2,2,2/6/2023,0,0,0,0,0,1,0,1,0,0,0,0,0,0,0,0,0,0,1,1
151087,2023,Bulgaria,Dominican Republic,0,0,0,0,1/6/2023,0,0,1,1,1,0,0,1,0,0,0,0,0,0,0,0,1,0,0,1
151087,2023,Japan,Dominican Republic,0,0,0,0,30/05/2023,0,0,0,0,0,0,0,0,0,0,0,0,0,0,1,1,0,0,0,0
119039,2023,Serbia,Dominican Republic,0,0,0,0,1/7/2023,0,0,26,26,0,0,0,0,0,0,0,0,6,0,12,18,19,2,3,24
119039,2023,China,Dominican Republic,0,0,0,0,30/06/2023,0,1,21,22,0,0,0,0,0,0,0,0,9,3,17,29,19,10,0,29
119039,2023,Dominican Republic,Korea,0,0,0,0,29/06/2023,1,0,11,12,0,0,0,0,0,0,0,0,4,1,6,11,7,1,1,9
119039,2023,Germany,Dominican Republic,0,0,0,0,27/06/2023,0,1,21,22,0,0,0,0,0,0,0,0,4,2,12,18,12,7,2,21
119039,2023,Dominican Republic,Türkiye,0,0,0,0,18/06/2023,0,0,30,30,0,0,0,0,0,0,0,0,5,0,10,15,13,7,1,21
119039,2023,Dominican Republic,Canada,0,0,0,0,17/06/2023,0,0,35,35,0,0,0,0,0,0,0,0,3,1,11,15,16,3,2,21
119039,2023,Dominican Republic,Italy,0,0,0,0,15/06/2023,0,0,23,23,0,0,0,0,0,0,0,0,1,0,9,10,16,6,0,22
119039,2023,Dominican Republic,Poland,0,0,0,0,13/06/2023,0,0,27,27,0,0,0,0,0,0,0,0,5,0,12,17,13,8,1,22
119585,2023,Serbia,Dominican Republic,0,0,16,16,1/7/2023,7,0,102,109,1,0,1,2,1,5,6,12,0,0,2,2,8,6,1,15
119585,2023,China,Dominican Republic,0,1,17,18,30/06/2023,22,1,90,113,0,0,3,3,0,1,1,2,0,0,0,0,8,2,1,11
119585,2023,Dominican Republic,Korea,2,1,14,17,29/06/2023,19,2,47,68,2,0,0,2,0,2,6,8,0,0,0,0,6,1,1,8
119585,2023,Germany,Dominican Republic,0,1,17,18,27/06/2023,9,1,79,89,1,0,1,2,0,1,1,2,0,0,1,1,9,3,3,15
119585,2023,Dominican Republic,Türkiye,1,0,14,15,18/06/2023,7,2,88,97,0,0,3,3,0,1,2,3,0,0,0,0,6,3,0,9
119585,2023,Dominican Republic,Canada,0,1,14,15,17/06/2023,11,1,76,88,1,2,0,3,0,3,3,6,0,0,0,0,5,2,0,7
119585,2023,Dominican Republic,Italy,0,0,18,18,15/06/2023,16,1,85,102,0,1,0,1,0,2,5,7,0,0,0,0,14,1,2,17
119585,2023,Dominican Republic,Poland,0,1,18,19,13/06/2023,6,0,92,98,1,0,0,1,0,1,2,3,0,0,0,0,9,1,5,15
119585,2023,Brazil,Dominican Republic,0,2,11,13,3/6/2023,10,1,87,98,0,0,1,1,1,1,2,4,0,0,0,0,4,0,1,5
119585,2023,Dominican Republic,Netherlands,0,0,15,15,2/6/2023,5,3,108,116,1,0,1,2,0,0,2,2,0,0,0,0,13,0,3,16
119585,2023,Bulgaria,Dominican Republic,0,1,20,21,1/6/2023,5,2,96,103,2,0,2,4,0,2,3,5,0,0,0,0,12,0,4,16
119585,2023,Japan,Dominican Republic,0,0,9,9,30/05/2023,24,1,98,123,0,0,1,1,1,1,6,8,0,0,0,0,5,1,2,8
183317,2023,Serbia,Dominican Republic,0,0,0,0,1/7/2023,0,0,0,0,0,0,2,2,0,0,0,0,0,0,0,0,0,0,0,0
183317,2023,Dominican Republic,Korea,0,0,0,0,29/06/2023,0,0,0,0,0,0,0,0,0,0,0,0,0,0,0,0,0,0,0,0
183317,2023,Germany,Dominican Republic,0,0,0,0,27/06/2023,0,0,0,0,0,0,0,0,0,0,0,0,0,0,0,0,0,0,0,0
183317,2023,Dominican Republic,Türkiye,0,0,0,0,18/06/2023,0,0,0,0,0,0,0,0,0,0,0,0,0,0,0,0,0,0,0,0
183317,2023,Dominican Republic,Canada,0,0,0,0,17/06/2023,0,0,0,0,0,0,0,0,0,0,0,0,0,0,0,0,0,0,0,0
183317,2023,Dominican Republic,Italy,0,0,0,0,15/06/2023,0,0,0,0,0,0,1,1,0,1,1,2,0,0,0,0,0,0,0,0
183317,2023,Dominican Republic,Poland,0,0,0,0,13/06/2023,0,0,0,0,1,0,1,2,0,0,1,1,0,0,0,0,0,0,0,0
183317,2023,Brazil,Dominican Republic,0,0,0,0,3/6/2023,0,0,1,1,0,0,0,0,0,0,0,0,0,0,0,0,0,0,0,0
183317,2023,Dominican Republic,Netherlands,0,0,0,0,2/6/2023,0,0,0,0,0,0,0,0,0,0,0,0,0,0,0,0,0,0,0,0
183317,2023,Bulgaria,Dominican Republic,0,0,0,0,1/6/2023,0,0,0,0,0,0,0,0,0,0,0,0,0,0,0,0,0,0,0,0
183317,2023,Japan,Dominican Republic,0,0,0,0,30/05/2023,0,0,0,0,0,0,0,0,0,0,0,0,0,0,0,0,0,0,0,0
143961,2023,Serbia,Dominican Republic,0,0,0,0,1/7/2023,0,0,0,0,0,0,0,0,0,0,0,0,0,0,0,0,0,0,0,0
143961,2023,China,Dominican Republic,0,0,0,0,30/06/2023,1,0,2,3,0,0,0,0,0,0,0,0,0,0,0,0,0,0,0,0
143961,2023,Dominican Republic,Korea,0,0,0,0,29/06/2023,0,0,0,0,0,0,0,0,0,0,0,0,0,0,0,0,0,0,0,0
143961,2023,Germany,Dominican Republic,1,1,6,8,27/06/2023,0,0,0,0,1,1,2,4,0,0,0,0,0,0,0,0,0,1,0,1
143961,2023,Dominican Republic,Türkiye,0,0,0,0,18/06/2023,0,0,0,0,0,0,0,0,0,0,0,0,0,0,0,0,0,0,0,0
143961,2023,Dominican Republic,Canada,0,0,0,0,17/06/2023,0,0,0,0,0,0,0,0,0,0,0,0,0,0,0,0,0,0,0,0
143961,2023,Dominican Republic,Italy,0,0,0,0,15/06/2023,0,0,0,0,0,0,0,0,0,0,0,0,0,0,0,0,0,0,0,0
143961,2023,Dominican Republic,Poland,0,0,0,0,13/06/2023,0,0,0,0,0,0,0,0,0,0,0,0,0,0,0,0,0,0,0,0
143961,2023,Brazil,Dominican Republic,0,0,0,0,3/6/2023,0,0,0,0,0,0,0,0,0,0,0,0,0,0,0,0,0,0,0,0
143961,2023,Dominican Republic,Netherlands,0,0,0,0,2/6/2023,0,0,0,0,0,0,0,0,0,0,0,0,0,0,0,0,0,0,0,0
143961,2023,Bulgaria,Dominican Republic,0,0,0,0,1/6/2023,0,0,0,0,0,0,0,0,0,0,0,0,0,0,0,0,0,0,0,0
143961,2023,Japan,Dominican Republic,0,0,0,0,30/05/2023,0,0,0,0,0,0,0,0,0,0,0,0,0,0,0,0,0,0,0,0
149530,2023,Serbia,Dominican Republic,0,2,7,9,1/7/2023,0,0,2,2,1,3,5,9,1,4,4,9,0,0,4,4,1,1,0,2
149530,2023,China,Dominican Republic,0,3,4,7,30/06/2023,0,0,2,2,3,1,7,11,2,4,5,11,0,0,0,0,2,1,1,4
149530,2023,Dominican Republic,Korea,0,2,5,7,29/06/2023,0,0,0,0,3,0,3,6,2,6,3,11,0,0,1,1,1,0,0,1
149530,2023,Germany,Dominican Republic,0,1,3,4,27/06/2023,0,0,2,2,1,1,1,3,0,1,0,1,0,2,1,3,1,0,1,2
149530,2023,Dominican Republic,Türkiye,1,2,6,9,18/06/2023,0,0,1,1,7,0,6,13,0,2,2,4,0,0,0,0,2,0,0,2
149530,2023,Dominican Republic,Canada,0,4,11,15,17/06/2023,0,0,2,2,1,2,5,8,4,8,5,17,0,0,0,0,3,1,2,6
149530,2023,Dominican Republic,Italy,0,1,7,8,15/06/2023,0,0,4,4,7,2,4,13,5,5,8,18,0,1,4,5,1,1,0,2
149530,2023,Dominican Republic,Poland,0,0,0,0,13/06/2023,0,0,0,0,0,0,0,0,0,0,0,0,0,0,0,0,1,0,0,1
149530,2023,Brazil,Dominican Republic,0,0,0,0,3/6/2023,0,0,5,5,0,0,0,0,0,0,0,0,0,0,0,0,0,0,0,0
149530,2023,Dominican Republic,Netherlands,0,0,0,0,2/6/2023,0,0,1,1,0,0,0,0,0,1,0,1,0,0,0,0,0,0,0,0
149530,2023,Bulgaria,Dominican Republic,0,0,0,0,1/6/2023,0,0,0,0,0,0,0,0,0,0,0,0,0,0,0,0,0,0,0,0
149530,2023,Japan,Dominican Republic,0,0,0,0,30/05/2023,0,0,0,0,0,0,0,0,0,0,1,1,0,0,0,0,0,0,0,0
139912,2023,Serbia,Dominican Republic,0,0,0,0,1/7/2023,0,0,0,0,0,0,0,0,0,0,0,0,0,0,0,0,0,0,0,0
139912,2023,China,Dominican Republic,0,0,0,0,30/06/2023,0,0,0,0,0,0,0,0,0,0,0,0,0,0,0,0,0,0,0,0
139912,2023,Dominican Republic,Korea,0,0,0,0,29/06/2023,0,0,0,0,0,0,0,0,0,0,0,0,0,0,0,0,0,0,0,0
139912,2023,Germany,Dominican Republic,0,0,0,0,27/06/2023,0,0,6,6,0,0,0,0,0,0,0,0,0,0,0,0,0,1,0,1
139912,2023,Dominican Republic,Türkiye,0,0,0,0,18/06/2023,0,0,0,0,0,0,0,0,0,0,0,0,0,0,0,0,0,0,0,0
139912,2023,Dominican Republic,Canada,0,0,1,1,17/06/2023,1,0,3,4,0,0,0,0,0,0,0,0,0,0,0,0,0,0,0,0
139912,2023,Dominican Republic,Italy,0,0,0,0,15/06/2023,0,0,6,6,0,0,0,0,0,0,0,0,0,0,0,0,0,1,0,1
139912,2023,Dominican Republic,Poland,0,0,0,0,13/06/2023,1,0,0,1,0,0,0,0,0,0,0,0,0,0,0,0,0,0,0,0
139912,2023,Brazil,Dominican Republic,0,0,1,1,3/6/2023,0,0,0,0,0,0,0,0,0,0,0,0,0,0,0,0,0,0,0,0
139912,2023,Dominican Republic,Netherlands,0,0,0,0,2/6/2023,0,0,2,2,0,0,0,0,0,0,0,0,0,0,0,0,0,0,0,0
139912,2023,Bulgaria,Dominican Republic,0,0,1,1,1/6/2023,0,0,5,5,0,0,0,0,0,0,0,0,0,0,0,0,0,0,0,0
139912,2023,Japan,Dominican Republic,0,0,0,0,30/05/2023,0,0,0,0,0,0,0,0,0,0,0,0,0,0,0,0,0,0,0,0
123978,2023,Serbia,Dominican Republic,1,1,27,29,1/7/2023,0,0,1,1,19,3,16,38,0,3,2,5,5,2,31,38,6,4,1,11
123978,2023,China,Dominican Republic,0,1,7,8,30/06/2023,0,0,0,0,4,5,11,20,3,2,0,5,7,0,20,27,7,2,0,9
123978,2023,Dominican Republic,Korea,2,2,9,13,29/06/2023,0,0,2,2,10,2,4,16,1,1,2,4,2,1,11,14,6,0,2,8
123978,2023,Germany,Dominican Republic,0,1,13,14,27/06/2023,0,0,4,4,7,4,17,28,2,1,1,4,7,3,21,31,5,2,2,9
123978,2023,Dominican Republic,Türkiye,1,0,18,19,18/06/2023,0,0,0,0,12,9,7,28,0,3,0,3,7,2,39,48,9,3,0,12
123978,2023,Dominican Republic,Canada,0,2,19,21,17/06/2023,0,0,3,3,18,1,13,32,2,1,4,7,3,1,37,41,14,2,2,18
123978,2023,Dominican Republic,Italy,1,1,14,16,15/06/2023,0,0,3,3,11,7,15,33,2,2,3,7,6,0,31,37,14,4,0,18
123978,2023,Dominican Republic,Poland,1,3,8,12,13/06/2023,0,0,3,3,12,7,9,28,1,5,4,10,5,1,34,40,9,6,1,16
123978,2023,Brazil,Dominican Republic,1,1,19,21,3/6/2023,0,0,5,5,11,5,13,29,1,1,1,3,5,1,19,25,9,0,2,11
123978,2023,Dominican Republic,Netherlands,1,3,13,17,2/6/2023,0,0,1,1,13,4,16,33,0,2,1,3,8,0,17,25,12,0,3,15
123978,2023,Bulgaria,Dominican Republic,1,3,16,20,1/6/2023,0,0,3,3,13,7,14,34,2,2,5,9,7,1,28,36,19,0,3,22
123978,2023,Japan,Dominican Republic,0,3,13,16,30/05/2023,0,0,4,4,12,12,16,40,1,4,2,7,4,2,27,33,18,2,2,22
123982,2023,Serbia,Dominican Republic,1,2,12,15,1/7/2023,0,0,5,5,25,3,23,51,1,3,2,6,1,0,15,16,10,0,0,10
123982,2023,China,Dominican Republic,1,2,15,18,30/06/2023,0,0,3,3,18,6,20,44,0,2,2,4,5,1,22,28,5,3,1,9
123982,2023,Dominican Republic,Korea,0,0,2,2,29/06/2023,0,0,1,1,2,1,0,3,0,0,0,0,5,0,2,7,2,0,0,2
123982,2023,Germany,Dominican Republic,0,1,15,16,27/06/2023,0,0,2,2,18,2,16,36,3,3,1,7,5,1,16,22,8,4,1,13
123982,2023,Dominican Republic,Türkiye,0,1,9,10,18/06/2023,0,0,2,2,6,9,18,33,1,2,0,3,4,1,16,21,0,0,0,0
123982,2023,Dominican Republic,Canada,1,2,18,21,17/06/2023,0,0,5,5,12,3,22,37,4,1,4,9,1,1,19,21,9,2,1,12
123982,2023,Dominican Republic,Italy,1,2,17,20,15/06/2023,0,0,3,3,14,7,21,42,3,3,1,7,3,0,25,28,9,5,2,16
123982,2023,Dominican Republic,Poland,0,1,13,14,13/06/2023,0,0,0,0,19,7,21,47,2,5,2,9,2,2,22,26,5,2,0,7
123982,2023,Brazil,Dominican Republic,0,3,13,16,3/6/2023,0,0,2,2,12,5,14,31,3,3,2,8,6,2,18,26,16,1,2,19
123982,2023,Dominican Republic,Netherlands,0,1,14,15,2/6/2023,0,0,2,2,22,2,22,46,3,3,3,9,1,3,17,21,12,1,7,20
123982,2023,Bulgaria,Dominican Republic,0,1,10,11,1/6/2023,0,0,5,5,24,5,20,49,2,2,3,7,5,2,26,33,14,0,4,18
123982,2023,Japan,Dominican Republic,2,0,13,15,30/05/2023,0,0,0,0,13,3,26,42,2,0,2,4,1,1,32,34,15,4,5,24
139910,2023,Serbia,Dominican Republic,0,3,8,11,1/7/2023,0,0,2,2,5,2,6,13,4,3,7,14,0,0,1,1,2,0,0,2
139910,2023,China,Dominican Republic,4,1,12,17,30/06/2023,0,0,3,3,17,1,3,21,1,2,9,12,0,0,1,1,4,1,0,5
139910,2023,Dominican Republic,Korea,0,1,6,7,29/06/2023,0,0,1,1,11,2,6,19,3,1,1,5,0,0,1,1,1,1,0,2
139910,2023,Germany,Dominican Republic,1,1,4,6,27/06/2023,0,0,1,1,4,3,8,15,2,4,10,16,0,1,2,3,5,1,0,6
139910,2023,Dominican Republic,Türkiye,2,2,5,9,18/06/2023,0,0,1,1,12,4,5,21,2,6,3,11,0,0,0,0,2,0,0,2
139910,2023,Dominican Republic,Canada,0,1,7,8,17/06/2023,0,0,0,0,11,1,8,20,7,7,9,23,0,0,0,0,2,1,0,3
139910,2023,Dominican Republic,Italy,1,3,11,15,15/06/2023,0,0,3,3,12,2,2,16,3,4,9,16,0,0,2,2,2,1,0,3
139910,2023,Dominican Republic,Poland,0,4,7,11,13/06/2023,0,0,2,2,4,1,5,10,3,4,10,17,0,0,0,0,0,2,0,2
139910,2023,Brazil,Dominican Republic,1,2,8,11,3/6/2023,0,0,3,3,7,1,6,14,4,4,10,18,0,0,0,0,3,0,1,4
139910,2023,Dominican Republic,Netherlands,1,3,11,15,2/6/2023,0,0,2,2,6,1,9,16,1,6,5,12,0,0,0,0,6,0,0,6
139910,2023,Bulgaria,Dominican Republic,0,0,11,11,1/6/2023,0,0,4,4,14,1,4,19,2,1,5,8,0,0,0,0,3,0,2,5
139910,2023,Japan,Dominican Republic,0,2,10,12,30/05/2023,0,0,5,5,6,0,7,13,3,3,4,10,0,0,2,2,2,0,0,2
139927,2023,Serbia,Dominican Republic,3,3,13,19,1/7/2023,0,0,2,2,20,7,13,40,3,3,6,12,0,0,0,0,13,6,3,22
139927,2023,China,Dominican Republic,3,3,12,18,30/06/2023,0,0,6,6,29,8,14,51,3,6,1,10,0,1,1,2,5,7,1,13
139927,2023,Dominican Republic,Korea,1,2,8,11,29/06/2023,0,0,0,0,12,2,12,26,4,4,1,9,0,0,0,0,12,0,0,12
139927,2023,Germany,Dominican Republic,1,4,7,12,27/06/2023,0,1,2,3,15,9,13,37,1,2,3,6,0,0,0,0,8,1,1,10
139927,2023,Dominican Republic,Türkiye,0,2,15,17,18/06/2023,0,0,2,2,17,8,15,40,0,3,1,4,0,0,0,0,7,2,0,9
139927,2023,Dominican Republic,Canada,0,3,16,19,17/06/2023,0,0,3,3,14,7,17,38,3,4,5,12,0,0,0,0,9,2,2,13
139927,2023,Dominican Republic,Italy,0,4,12,16,15/06/2023,0,0,2,2,11,8,16,35,3,4,6,13,0,0,4,4,7,5,0,12
139927,2023,Dominican Republic,Poland,1,2,12,15,13/06/2023,0,0,2,2,17,9,12,38,1,2,1,4,0,0,0,0,7,5,0,12
139927,2023,Brazil,Dominican Republic,1,2,13,16,3/6/2023,0,0,1,1,18,12,18,48,3,4,3,10,3,0,1,4,3,0,3,6
139927,2023,Dominican Republic,Netherlands,2,2,14,18,2/6/2023,0,0,1,1,17,5,16,38,3,2,2,7,1,0,2,3,5,0,2,7
139927,2023,Bulgaria,Dominican Republic,2,3,15,20,1/6/2023,0,0,4,4,16,6,14,36,1,3,5,9,0,0,3,3,11,0,1,12
139927,2023,Japan,Dominican Republic,0,5,13,18,30/05/2023,0,0,5,5,11,4,24,39,3,4,7,14,0,0,3,3,14,2,3,19
139913,2023,Serbia,Dominican Republic,0,1,3,4,1/7/2023,0,0,0,0,0,0,0,0,0,0,0,0,0,0,4,4,2,2,0,4
139913,2023,China,Dominican Republic,0,0,8,8,30/06/2023,0,0,0,0,0,0,0,0,0,0,0,0,1,0,0,1,4,0,0,4
139913,2023,Dominican Republic,Korea,0,0,9,9,29/06/2023,0,0,1,1,0,0,0,0,0,0,0,0,0,0,0,0,2,1,1,4
139913,2023,Germany,Dominican Republic,0,1,1,2,27/06/2023,0,0,0,0,0,0,0,0,0,0,0,0,0,0,0,0,0,0,0,0
139913,2023,Dominican Republic,Türkiye,0,0,3,3,18/06/2023,0,0,0,0,0,0,0,0,0,0,0,0,0,0,0,0,1,0,0,1
139913,2023,Dominican Republic,Canada,0,0,8,8,17/06/2023,0,0,0,0,0,0,0,0,0,0,0,0,0,0,1,1,1,1,0,2
139913,2023,Dominican Republic,Italy,0,0,3,3,15/06/2023,0,1,0,1,0,0,0,0,0,0,0,0,1,0,0,1,1,0,0,1
139913,2023,Dominican Republic,Poland,0,1,1,2,13/06/2023,0,0,0,0,0,0,0,0,0,0,0,0,0,0,1,1,0,0,0,0
139913,2023,Brazil,Dominican Republic,0,0,0,0,3/6/2023,0,0,2,2,0,0,0,0,0,0,0,0,4,0,3,7,4,0,1,5
139913,2023,Dominican Republic,Netherlands,0,0,0,0,2/6/2023,0,0,0,0,0,0,0,0,0,0,0,0,2,1,3,6,3,0,0,3
139913,2023,Bulgaria,Dominican Republic,0,0,0,0,1/6/2023,0,0,1,1,0,0,0,0,0,0,0,0,0,0,0,0,0,0,0,0
139913,2023,Japan,Dominican Republic,0,0,0,0,30/05/2023,0,0,0,0,0,0,0,0,0,0,0,0,0,0,0,0,0,0,0,0
151011,2023,Poland,Germany,0,0,0,0,12/7/2023,0,0,0,0,0,0,0,0,0,0,0,0,0,0,0,0,0,0,0,0
151011,2023,Germany,USA,0,1,0,1,1/7/2023,0,0,0,0,0,0,0,0,0,0,0,0,1,0,1,2,1,0,1,2
151011,2023,Germany,Serbia,0,0,1,1,30/06/2023,0,0,0,0,1,0,0,1,0,0,0,0,0,0,2,2,0,0,0,0
151011,2023,Poland,Germany,0,0,0,0,29/06/2023,0,0,0,0,0,0,0,0,0,0,0,0,0,0,0,0,0,0,0,0
151011,2023,Germany,Dominican Republic,0,0,0,0,27/06/2023,0,0,0,0,0,0,0,0,0,0,0,0,0,0,0,0,0,0,0,0
151011,2023,Germany,Korea,0,0,0,0,18/06/2023,0,0,0,0,0,0,0,0,0,0,0,0,0,0,0,0,0,0,0,0
151011,2023,Brazil,Germany,1,0,14,15,17/06/2023,0,0,7,7,9,6,16,31,2,4,3,9,2,2,22,26,8,2,0,10
151011,2023,Japan,Germany,0,0,0,0,16/06/2023,0,0,0,0,0,0,0,0,0,0,0,0,0,0,1,1,0,0,0,0
151011,2023,Germany,Thailand,0,0,1,1,14/06/2023,0,0,0,0,0,0,0,0,0,0,0,0,0,0,0,0,0,0,0,0
151011,2023,Germany,Bulgaria,0,0,0,0,4/6/2023,0,0,0,0,0,0,0,0,0,0,0,0,0,0,0,0,0,0,0,0
151011,2023,China,Germany,0,0,0,0,2/6/2023,0,0,0,0,0,0,0,0,0,0,0,0,0,0,0,0,0,0,0,0
151011,2023,Croatia,Germany,0,0,0,0,1/6/2023,0,0,0,0,0,0,0,0,0,0,0,0,0,0,0,0,0,0,0,0
151011,2023,Germany,Netherlands,0,0,0,0,30/05/2023,0,0,2,2,0,0,0,0,0,0,0,0,0,0,1,1,1,0,1,2
150973,2023,Poland,Germany,1,0,13,14,12/7/2023,33,3,89,125,0,0,3,3,0,2,5,7,0,0,0,0,4,1,2,7
150973,2023,Germany,USA,1,0,12,13,1/7/2023,11,0,70,81,0,0,1,1,1,0,1,2,0,0,0,0,8,3,2,13
150973,2023,Germany,Serbia,1,0,12,13,30/06/2023,23,0,60,83,1,0,1,2,0,0,2,2,0,0,1,1,7,10,0,17
150973,2023,Poland,Germany,0,1,13,14,29/06/2023,25,1,92,118,0,0,1,1,0,2,2,4,0,0,0,0,10,6,0,16
150973,2023,Germany,Dominican Republic,3,2,8,13,27/06/2023,41,1,60,102,1,0,0,1,0,1,2,3,0,0,0,0,9,6,3,18
150973,2023,Germany,Korea,1,1,19,21,18/06/2023,28,0,64,92,1,0,1,2,1,1,3,5,0,0,0,0,18,1,2,21
150973,2023,Brazil,Germany,0,0,0,0,17/06/2023,0,0,0,0,0,0,0,0,0,0,0,0,0,0,0,0,0,0,0,0
150973,2023,Japan,Germany,1,0,16,17,16/06/2023,42,1,84,127,0,0,3,3,1,4,3,8,0,0,0,0,10,4,2,16
150973,2023,Germany,Thailand,1,1,16,18,14/06/2023,40,2,70,112,1,0,0,1,3,0,5,8,0,0,0,0,6,2,2,10
150973,2023,Germany,Bulgaria,1,2,17,20,4/6/2023,9,0,122,131,0,1,0,1,0,4,2,6,0,0,1,1,7,0,1,8
150973,2023,China,Germany,2,0,8,10,2/6/2023,11,1,66,78,0,0,1,1,0,1,1,2,0,0,0,0,2,0,0,2
150973,2023,Croatia,Germany,2,1,9,12,1/6/2023,8,0,89,97,0,0,1,1,0,0,2,2,0,0,0,0,7,0,1,8
150973,2023,Germany,Netherlands,0,1,15,16,30/05/2023,26,0,81,107,0,0,1,1,0,5,2,7,0,0,0,0,10,3,3,16
158238,2023,Poland,Germany,0,0,0,0,12/7/2023,0,0,0,0,0,0,0,0,0,0,0,0,0,0,0,0,0,0,0,0
158238,2023,Germany,USA,0,0,0,0,1/7/2023,0,0,0,0,0,0,0,0,0,0,0,0,0,0,0,0,0,1,0,1
158238,2023,Germany,Serbia,0,0,0,0,30/06/2023,0,0,0,0,0,0,0,0,0,0,0,0,0,0,0,0,0,0,0,0
158238,2023,Poland,Germany,0,0,0,0,29/06/2023,0,0,0,0,0,0,0,0,0,0,0,0,0,0,0,0,0,0,0,0
158238,2023,Germany,Dominican Republic,0,0,0,0,27/06/2023,0,0,0,0,0,0,0,0,0,0,0,0,0,0,0,0,0,0,0,0
158238,2023,Germany,Korea,0,0,0,0,18/06/2023,0,0,0,0,0,0,0,0,0,0,0,0,0,0,0,0,0,0,0,0
158238,2023,Brazil,Germany,0,0,0,0,17/06/2023,0,0,11,11,0,0,0,0,0,0,0,0,4,0,22,26,14,6,3,23
158238,2023,Japan,Germany,0,0,0,0,16/06/2023,0,0,0,0,0,0,0,0,0,0,0,0,0,0,0,0,0,0,0,0
158238,2023,Germany,Thailand,0,0,0,0,14/06/2023,0,0,0,0,0,0,0,0,0,0,0,0,0,0,0,0,0,0,1,1
158238,2023,Germany,Bulgaria,0,0,0,0,4/6/2023,0,0,0,0,0,0,0,0,0,0,0,0,0,0,0,0,0,0,0,0
158238,2023,China,Germany,0,0,0,0,2/6/2023,0,0,0,0,0,0,0,0,0,0,0,0,0,0,0,0,1,0,0,1
158238,2023,Croatia,Germany,0,0,0,0,1/6/2023,0,0,0,0,0,0,0,0,0,0,0,0,0,0,0,0,0,0,0,0
158238,2023,Germany,Netherlands,0,0,0,0,30/05/2023,0,0,0,0,0,0,0,0,0,0,0,0,0,0,0,0,0,0,0,0
136671,2023,Poland,Germany,0,0,0,0,12/7/2023,0,0,6,6,0,0,0,0,0,0,0,0,8,1,11,20,14,10,2,26
136671,2023,Germany,USA,0,0,0,0,1/7/2023,0,0,17,17,0,0,0,0,0,0,0,0,2,0,12,14,15,6,4,25
136671,2023,Germany,Serbia,0,0,0,0,30/06/2023,0,0,8,8,0,0,0,0,0,0,0,0,3,0,20,23,11,6,0,17
136671,2023,Poland,Germany,0,0,0,0,29/06/2023,0,0,13,13,0,0,0,0,0,0,0,0,7,0,16,23,15,11,2,28
136671,2023,Germany,Dominican Republic,0,0,0,0,27/06/2023,0,0,13,13,0,0,0,0,0,0,0,0,14,1,13,28,15,7,4,26
136671,2023,Germany,Korea,0,0,0,0,18/06/2023,1,0,18,19,0,0,0,0,0,0,0,0,4,0,8,12,18,9,2,29
136671,2023,Brazil,Germany,0,0,0,0,17/06/2023,0,0,0,0,0,0,0,0,0,0,0,0,0,0,2,2,1,2,1,4
136671,2023,Japan,Germany,0,0,0,0,16/06/2023,0,0,14,14,0,0,0,0,0,0,0,0,6,2,12,20,23,3,1,27
136671,2023,Germany,Thailand,0,0,0,0,14/06/2023,0,0,10,10,0,0,0,0,0,0,0,0,5,0,13,18,12,5,3,20
136671,2023,Germany,Bulgaria,0,0,0,0,4/6/2023,0,0,13,13,0,0,0,0,0,0,0,0,3,1,13,17,16,0,3,19
136671,2023,China,Germany,0,0,0,0,2/6/2023,0,0,7,7,0,0,0,0,0,0,0,0,5,0,16,21,11,1,1,13
136671,2023,Croatia,Germany,0,0,0,0,1/6/2023,0,0,6,6,0,0,0,0,0,0,0,0,7,0,11,18,12,0,1,13
136671,2023,Germany,Netherlands,0,0,0,0,30/05/2023,0,0,11,11,0,0,0,0,0,0,0,0,6,1,7,14,9,8,7,24
163661,2023,Poland,Germany,0,0,1,1,12/7/2023,0,0,2,2,0,0,0,0,0,0,0,0,0,0,0,0,0,0,0,0
163661,2023,Germany,USA,0,0,2,2,1/7/2023,4,0,11,15,0,0,1,1,0,0,0,0,0,0,0,0,2,1,0,3
163661,2023,Germany,Serbia,0,0,3,3,30/06/2023,3,0,17,20,0,0,0,0,1,0,2,3,0,0,0,0,1,2,2,5
163661,2023,Poland,Germany,0,0,0,0,29/06/2023,0,0,0,0,0,0,0,0,0,0,0,0,0,0,0,0,0,0,0,0
163661,2023,Germany,Dominican Republic,0,0,1,1,27/06/2023,2,0,4,6,0,0,0,0,0,0,1,1,0,0,0,0,1,0,0,1
163661,2023,Germany,Korea,0,0,0,0,18/06/2023,0,0,0,0,0,0,0,0,0,0,0,0,0,0,0,0,0,0,0,0
163661,2023,Brazil,Germany,0,2,11,13,17/06/2023,32,1,82,115,0,0,1,1,0,3,4,7,0,0,0,0,7,4,3,14
163661,2023,Japan,Germany,0,0,0,0,16/06/2023,0,0,3,3,0,0,0,0,0,1,0,1,0,0,0,0,1,0,0,1
163661,2023,Germany,Thailand,0,0,0,0,14/06/2023,0,0,0,0,0,0,0,0,0,0,0,0,0,0,0,0,0,0,0,0
163661,2023,Germany,Bulgaria,0,0,0,0,4/6/2023,0,0,0,0,0,0,0,0,0,0,0,0,0,0,0,0,0,0,0,0
163661,2023,China,Germany,0,0,0,0,2/6/2023,2,0,11,13,0,0,0,0,0,0,0,0,0,0,0,0,1,0,0,1
163661,2023,Croatia,Germany,0,0,0,0,1/6/2023,0,0,0,0,0,0,0,0,0,0,0,0,0,0,0,0,0,0,0,0
163661,2023,Germany,Netherlands,0,0,0,0,30/05/2023,0,0,0,0,0,0,0,0,0,0,0,0,0,0,0,0,0,0,0,0
157403,2023,Poland,Germany,0,0,2,2,12/7/2023,0,0,0,0,0,0,0,0,0,0,0,0,0,0,0,0,0,0,0,0
157403,2023,Germany,USA,0,2,4,6,1/7/2023,0,0,1,1,2,1,2,5,0,0,3,3,1,1,10,12,1,0,1,2
157403,2023,Germany,Serbia,1,1,7,9,30/06/2023,0,0,1,1,0,1,1,2,0,1,0,1,2,0,7,9,0,2,0,2
157403,2023,Poland,Germany,0,0,6,6,29/06/2023,0,0,0,0,0,0,0,0,0,0,0,0,0,0,0,0,1,1,0,2
157403,2023,Germany,Dominican Republic,0,0,6,6,27/06/2023,0,0,1,1,1,2,3,6,0,0,0,0,0,0,2,2,5,1,0,6
157403,2023,Germany,Korea,0,1,4,5,18/06/2023,0,0,0,0,0,0,0,0,0,0,0,0,0,0,0,0,0,0,0,0
157403,2023,Brazil,Germany,1,2,11,14,17/06/2023,0,0,3,3,10,3,15,28,0,2,0,2,3,3,17,23,9,3,1,13
157403,2023,Japan,Germany,0,1,6,7,16/06/2023,0,0,0,0,0,0,0,0,0,0,0,0,1,2,0,3,1,0,0,1
157403,2023,Germany,Thailand,0,0,7,7,14/06/2023,0,0,1,1,0,0,3,3,0,0,1,1,0,0,4,4,1,2,0,3
157403,2023,Germany,Bulgaria,0,0,9,9,4/6/2023,0,0,0,0,0,0,1,1,0,0,0,0,0,0,0,0,0,0,0,0
157403,2023,China,Germany,0,2,2,4,2/6/2023,0,0,0,0,0,0,0,0,0,0,0,0,1,0,1,2,0,0,1,1
157403,2023,Croatia,Germany,1,0,4,5,1/6/2023,0,0,0,0,0,0,0,0,0,0,0,0,0,0,0,0,1,0,0,1
157403,2023,Germany,Netherlands,1,0,4,5,30/05/2023,0,0,0,0,0,0,0,0,0,0,0,0,0,0,0,0,0,0,0,0
163658,2023,Poland,Germany,1,2,10,13,12/7/2023,0,0,3,3,14,3,23,40,0,1,0,1,5,0,13,18,12,5,1,18
163658,2023,Germany,USA,0,2,10,12,1/7/2023,0,0,5,5,8,2,12,22,0,4,3,7,11,4,20,35,5,2,2,9
163658,2023,Germany,Serbia,0,2,7,9,30/06/2023,0,0,3,3,13,2,17,32,1,3,2,6,5,2,5,12,3,3,1,7
163658,2023,Poland,Germany,0,1,14,15,29/06/2023,0,0,1,1,20,6,12,38,2,1,1,4,11,1,16,28,9,3,2,14
163658,2023,Germany,Dominican Republic,2,1,8,11,27/06/2023,0,0,1,1,2,3,21,26,0,2,2,4,2,0,4,6,11,3,0,14
163658,2023,Germany,Korea,1,2,24,27,18/06/2023,1,0,5,6,14,2,14,30,4,1,2,7,5,2,9,16,12,3,0,15
163658,2023,Brazil,Germany,0,0,0,0,17/06/2023,0,0,0,0,0,0,0,0,0,0,0,0,0,0,0,0,0,0,0,0
163658,2023,Japan,Germany,1,0,17,18,16/06/2023,0,0,5,5,14,5,14,33,1,3,2,6,10,0,17,27,10,4,3,17
163658,2023,Germany,Thailand,0,1,7,8,14/06/2023,1,0,2,3,6,4,11,21,2,4,2,8,2,0,2,4,9,1,3,13
163658,2023,Germany,Bulgaria,2,3,12,17,4/6/2023,0,0,1,1,11,4,15,30,3,1,2,6,10,1,20,31,15,0,4,19
163658,2023,China,Germany,0,2,7,9,2/6/2023,0,0,0,0,8,2,11,21,1,1,0,2,1,0,5,6,3,0,0,3
163658,2023,Croatia,Germany,0,0,7,7,1/6/2023,0,0,2,2,6,9,14,29,0,0,0,0,10,2,18,30,11,1,4,16
163658,2023,Germany,Netherlands,0,0,16,16,30/05/2023,0,0,1,1,10,4,18,32,5,2,2,9,8,3,22,33,4,3,7,14
144980,2023,Poland,Germany,0,0,9,9,12/7/2023,0,0,2,2,8,3,9,20,2,3,4,9,16,0,23,39,7,5,1,13
144980,2023,Germany,USA,0,1,5,6,1/7/2023,0,0,10,10,10,3,20,33,0,1,5,6,2,1,8,11,6,1,0,7
144980,2023,Germany,Serbia,0,1,6,7,30/06/2023,0,0,2,2,7,4,11,22,0,1,1,2,14,1,18,33,7,4,1,12
144980,2023,Poland,Germany,2,0,14,16,29/06/2023,0,0,5,5,13,4,14,31,1,4,4,9,6,2,23,31,11,2,0,13
144980,2023,Germany,Dominican Republic,1,0,10,11,27/06/2023,0,0,1,1,17,4,10,31,1,1,1,3,6,0,8,14,5,4,0,9
144980,2023,Germany,Korea,0,0,6,6,18/06/2023,0,0,1,1,13,2,11,26,2,2,3,7,5,2,18,25,7,3,4,14
144980,2023,Brazil,Germany,0,0,3,3,17/06/2023,0,0,0,0,1,0,1,2,0,2,1,3,1,1,6,8,1,1,0,2
144980,2023,Japan,Germany,0,1,11,12,16/06/2023,0,0,5,5,8,2,22,32,2,3,2,7,4,1,31,36,13,3,1,17
144980,2023,Germany,Thailand,0,2,12,14,14/06/2023,0,0,2,2,12,0,11,23,1,3,1,5,5,0,22,27,8,4,1,13
144980,2023,Germany,Bulgaria,1,0,10,11,4/6/2023,0,0,2,2,15,2,19,36,1,3,3,7,3,2,21,26,8,0,0,8
144980,2023,China,Germany,0,0,7,7,2/6/2023,0,0,2,2,5,2,10,17,0,1,1,2,3,0,9,12,8,0,1,9
144980,2023,Croatia,Germany,2,0,10,12,1/6/2023,0,0,4,4,8,2,9,19,1,1,0,2,1,0,6,7,4,0,0,4
144980,2023,Germany,Netherlands,1,0,10,11,30/05/2023,0,0,2,2,8,6,14,28,0,2,4,6,9,2,17,28,7,0,4,11
151016,2023,Poland,Germany,1,3,7,11,12/7/2023,0,0,1,1,21,8,21,50,0,0,4,4,4,0,7,11,6,1,1,8
151016,2023,Germany,USA,0,1,5,6,1/7/2023,0,1,1,2,13,3,18,34,0,5,2,7,4,0,8,12,6,4,2,12
151016,2023,Germany,Serbia,0,4,4,8,30/06/2023,0,0,2,2,7,4,12,23,1,2,1,4,1,0,6,7,4,6,1,11
151016,2023,Poland,Germany,1,3,11,15,29/06/2023,0,0,7,7,16,9,25,50,2,1,4,7,0,1,6,7,8,4,1,13
151016,2023,Germany,Dominican Republic,0,4,11,15,27/06/2023,0,0,2,2,16,8,12,36,3,2,2,7,11,1,8,20,5,0,0,5
151016,2023,Germany,Korea,2,3,12,17,18/06/2023,0,0,2,2,21,4,14,39,0,2,4,6,5,0,6,11,6,1,2,9
151016,2023,Brazil,Germany,0,0,0,0,17/06/2023,0,0,0,0,2,3,3,8,0,0,1,1,0,0,3,3,1,0,0,1
151016,2023,Japan,Germany,1,4,7,12,16/06/2023,0,0,3,3,21,6,25,52,1,1,7,9,0,1,6,7,8,1,2,11
151016,2023,Germany,Thailand,1,5,1,7,14/06/2023,0,0,0,0,13,5,15,33,2,3,1,6,7,1,14,22,9,1,1,11
151016,2023,Germany,Bulgaria,0,6,8,14,4/6/2023,0,0,1,1,13,6,20,39,0,1,1,2,3,1,12,16,9,1,4,14
151016,2023,China,Germany,2,2,7,11,2/6/2023,0,0,0,0,15,7,14,36,2,0,3,5,10,0,19,29,6,0,4,10
151016,2023,Croatia,Germany,3,2,7,12,1/6/2023,0,0,1,1,20,4,13,37,0,3,0,3,0,0,4,4,7,1,0,8
151016,2023,Germany,Netherlands,5,2,11,18,30/05/2023,0,0,2,2,18,5,14,37,1,1,5,7,0,0,0,0,8,1,3,12
150812,2023,Poland,Germany,0,1,5,6,12/7/2023,0,0,2,2,4,2,4,10,0,2,4,6,0,0,0,0,2,0,0,2
150812,2023,Germany,USA,0,1,4,5,1/7/2023,0,0,0,0,5,1,6,12,2,7,4,13,0,0,0,0,0,3,0,3
150812,2023,Germany,Serbia,0,1,5,6,30/06/2023,0,0,1,1,5,0,2,7,0,1,2,3,0,0,0,0,2,0,1,3
150812,2023,Poland,Germany,0,0,0,0,29/06/2023,0,0,0,0,0,0,0,0,0,0,0,0,0,0,0,0,0,0,0,0
150812,2023,Germany,Dominican Republic,0,0,1,1,27/06/2023,0,0,0,0,2,2,1,5,0,3,2,5,0,0,0,0,1,0,0,1
150812,2023,Germany,Korea,0,0,4,4,18/06/2023,0,0,1,1,3,2,4,9,1,2,3,6,1,0,0,1,2,1,1,4
150812,2023,Brazil,Germany,0,0,0,0,17/06/2023,0,0,0,0,0,0,0,0,0,0,0,0,0,0,0,0,0,0,0,0
150812,2023,Japan,Germany,0,1,8,9,16/06/2023,0,0,0,0,11,2,6,19,5,5,6,16,0,0,0,0,5,1,0,6
150812,2023,Germany,Thailand,1,1,14,16,14/06/2023,0,0,1,1,12,3,10,25,1,3,4,8,0,0,0,0,1,1,0,2
150812,2023,Germany,Bulgaria,0,1,7,8,4/6/2023,0,0,1,1,8,2,6,16,4,6,6,16,0,0,0,0,2,0,1,3
150812,2023,China,Germany,0,0,3,3,2/6/2023,0,0,0,0,5,2,4,11,0,0,4,4,0,0,0,0,2,0,0,2
150812,2023,Croatia,Germany,1,0,4,5,1/6/2023,0,0,2,2,7,1,4,12,1,5,2,8,1,0,0,1,4,1,0,5
150812,2023,Germany,Netherlands,0,0,2,2,30/05/2023,0,0,0,0,2,2,1,5,0,3,2,5,0,0,0,0,0,0,1,1
177765,2023,Poland,Germany,0,0,0,0,12/7/2023,0,0,1,1,0,0,0,0,0,0,0,0,0,0,0,0,0,0,0,0
177765,2023,Germany,Korea,0,0,0,0,18/06/2023,0,0,0,0,0,0,0,0,0,0,0,0,0,0,0,0,0,0,0,0
177765,2023,Brazil,Germany,0,3,5,8,17/06/2023,0,0,0,0,0,1,4,5,0,5,1,6,0,0,0,0,2,1,0,3
177765,2023,Japan,Germany,0,0,0,0,16/06/2023,0,0,0,0,0,0,0,0,0,0,0,0,0,0,0,0,0,0,0,0
177765,2023,Germany,Thailand,0,0,0,0,14/06/2023,0,0,0,0,0,0,0,0,0,0,0,0,0,0,0,0,0,0,0,0
177765,2023,Germany,Bulgaria,0,0,0,0,4/6/2023,0,0,0,0,0,0,0,0,0,0,0,0,0,0,0,0,0,0,0,0
177765,2023,China,Germany,0,0,0,0,2/6/2023,0,0,0,0,0,0,0,0,0,0,0,0,0,0,0,0,0,0,0,0
177765,2023,Croatia,Germany,0,0,0,0,1/6/2023,0,0,0,0,0,0,0,0,0,0,0,0,0,0,0,0,0,0,0,0
177765,2023,Germany,Netherlands,0,0,0,0,30/05/2023,0,0,0,0,0,0,0,0,0,0,0,0,0,0,0,0,0,0,0,0
163939,2023,Poland,Germany,1,0,5,6,12/7/2023,0,0,0,0,0,2,3,5,0,2,0,2,0,0,0,0,0,0,0,0
163939,2023,Germany,USA,2,1,6,9,1/7/2023,0,0,0,0,1,1,6,8,2,0,1,3,0,0,0,0,3,0,0,3
163939,2023,Germany,Serbia,0,0,7,7,30/06/2023,0,0,0,0,3,4,4,11,1,0,0,1,0,0,0,0,2,2,0,4
163939,2023,Poland,Germany,0,0,0,0,29/06/2023,0,0,0,0,0,0,0,0,0,0,1,1,0,0,0,0,0,0,0,0
163939,2023,Germany,Dominican Republic,0,0,1,1,27/06/2023,0,0,0,0,2,2,3,7,0,0,1,1,0,0,0,0,1,0,0,1
163939,2023,Germany,Korea,0,0,0,0,18/06/2023,0,0,0,0,0,0,0,0,0,0,0,0,0,0,0,0,0,0,0,0
163939,2023,Brazil,Germany,0,1,11,12,17/06/2023,0,0,0,0,26,5,13,44,2,3,3,8,0,0,0,0,13,2,4,19
163939,2023,Japan,Germany,0,0,2,2,16/06/2023,0,0,0,0,3,0,1,4,0,0,0,0,0,0,0,0,0,0,0,0
163939,2023,Germany,Thailand,0,0,3,3,14/06/2023,0,0,0,0,0,1,3,4,1,0,1,2,0,0,0,0,3,0,1,4
153929,2023,Poland,Germany,2,2,10,14,12/7/2023,0,0,1,1,10,0,3,13,1,4,6,11,0,1,0,1,4,0,0,4
153929,2023,Germany,USA,0,2,14,16,1/7/2023,0,0,7,7,8,1,12,21,7,6,10,23,0,0,0,0,3,0,1,4
153929,2023,Germany,Serbia,2,1,12,15,30/06/2023,0,1,6,7,14,1,11,26,0,3,9,12,0,0,0,0,3,1,2,6
153929,2023,Poland,Germany,1,2,17,20,29/06/2023,0,0,5,5,11,0,8,19,4,10,8,22,1,0,0,1,7,0,1,8
153929,2023,Germany,Dominican Republic,2,1,15,18,27/06/2023,0,0,1,1,5,0,9,14,0,5,7,12,0,0,0,0,1,0,0,1
153929,2023,Germany,Korea,1,2,12,15,18/06/2023,0,0,1,1,8,3,2,13,3,4,9,16,0,0,0,0,2,1,0,3
153929,2023,Brazil,Germany,1,0,4,5,17/06/2023,0,0,5,5,1,0,0,1,4,1,3,8,0,0,0,0,0,0,0,0
153929,2023,Japan,Germany,3,2,13,18,16/06/2023,0,0,2,2,8,2,12,22,2,9,8,19,0,0,0,0,4,4,1,9
153929,2023,Germany,Thailand,1,0,15,16,14/06/2023,0,0,3,3,13,0,11,24,3,5,9,17,0,0,0,0,4,0,1,5
153929,2023,Germany,Bulgaria,2,1,16,19,4/6/2023,0,0,1,1,9,1,10,20,3,3,3,9,0,0,0,0,3,0,0,3
153929,2023,China,Germany,1,3,10,14,2/6/2023,0,0,2,2,6,0,8,14,1,4,1,6,0,0,0,0,2,0,0,2
153929,2023,Croatia,Germany,1,2,12,15,1/6/2023,0,0,1,1,9,1,9,19,3,1,8,12,1,0,1,2,5,0,0,5
153929,2023,Germany,Netherlands,1,2,11,14,30/05/2023,0,0,2,2,7,2,5,14,4,4,9,17,0,0,0,0,2,1,3,6
182628,2023,Poland,Germany,0,1,6,7,12/7/2023,0,0,2,2,0,1,2,3,2,3,4,9,0,0,0,0,4,0,1,5
182628,2023,Germany,USA,2,0,5,7,1/7/2023,0,0,1,1,1,0,0,1,0,0,0,0,0,0,0,0,0,2,0,2
182628,2023,Germany,Serbia,1,0,6,7,30/06/2023,0,0,0,0,0,1,2,3,1,1,3,5,0,0,0,0,1,1,1,3
182628,2023,Poland,Germany,0,1,17,18,29/06/2023,0,0,2,2,5,2,5,12,3,9,9,21,0,0,0,0,3,1,2,6
182628,2023,Germany,Dominican Republic,1,1,13,15,27/06/2023,0,0,1,1,3,1,3,7,2,2,6,10,0,0,0,0,2,0,0,2
182628,2023,Germany,Korea,0,1,3,4,18/06/2023,0,0,1,1,0,0,1,1,0,1,2,3,0,0,1,1,0,1,0,1
182628,2023,Brazil,Germany,0,1,12,13,17/06/2023,0,0,2,2,7,2,10,19,0,3,12,15,0,0,0,0,1,2,2,5
182628,2023,Japan,Germany,0,0,3,3,16/06/2023,0,0,0,0,0,0,0,0,0,0,0,0,0,0,0,0,0,0,0,0
182628,2023,Germany,Thailand,0,0,3,3,14/06/2023,0,0,1,1,0,0,0,0,0,0,0,0,0,0,0,0,1,0,0,1
182628,2023,Germany,Bulgaria,0,1,2,3,4/6/2023,0,0,0,0,0,0,0,0,0,0,0,0,0,0,0,0,1,0,0,1
182628,2023,China,Germany,0,0,4,4,2/6/2023,0,0,0,0,0,1,0,1,0,1,0,1,0,0,0,0,0,0,0,0
182628,2023,Croatia,Germany,0,1,4,5,1/6/2023,0,0,1,1,0,0,0,0,0,1,1,2,0,0,0,0,0,0,0,0
182628,2023,Germany,Netherlands,1,1,10,12,30/05/2023,0,0,0,0,3,1,4,8,1,1,2,4,0,0,0,0,1,0,1,2
143370,2023,Türkiye,Italy,0,1,4,5,13/07/2023,0,0,1,1,7,2,2,11,0,1,0,1,1,0,7,8,2,2,0,4
143370,2023,Italy,Japan,0,2,1,3,2/7/2023,0,0,1,1,5,3,7,15,1,0,1,2,2,0,13,15,6,0,1,7
143370,2023,Italy,Croatia,2,2,8,12,1/7/2023,0,1,4,5,11,4,11,26,0,0,6,6,6,1,19,26,11,0,0,11
143370,2023,Canada,Italy,4,1,15,20,30/06/2023,0,0,3,3,15,5,13,33,2,2,4,8,2,2,15,19,7,1,1,9
143370,2023,Brazil,Italy,0,2,0,2,28/06/2023,0,0,2,2,2,3,3,8,0,0,1,1,1,1,6,8,0,0,1,1
143370,2023,Italy,China,0,2,5,7,18/06/2023,0,0,0,0,14,4,4,22,0,0,0,0,2,0,19,21,3,2,1,6
143370,2023,Netherlands,Italy,0,0,0,0,17/06/2023,0,0,0,0,0,0,0,0,0,0,0,0,0,0,0,0,0,0,0,0
143370,2023,Dominican Republic,Italy,0,0,2,2,15/06/2023,0,0,0,0,1,1,1,3,0,1,0,1,0,0,4,4,0,1,0,1
143370,2023,Italy,Bulgaria,0,0,0,0,14/06/2023,0,0,0,0,0,0,0,0,0,0,0,0,0,0,0,0,0,0,0,0
143370,2023,Türkiye,Italy,0,3,7,10,3/6/2023,0,1,0,1,11,9,8,28,2,3,2,7,9,0,22,31,4,1,0,5
143370,2023,USA,Italy,0,0,0,0,2/6/2023,0,0,0,0,0,0,0,0,0,0,0,0,0,0,0,0,0,0,0,0
143370,2023,Poland,Italy,0,4,3,7,1/6/2023,0,0,1,1,9,5,11,25,2,2,4,8,5,0,18,23,3,1,0,4
143370,2023,Italy,Thailand,2,2,6,10,30/05/2023,0,0,2,2,7,6,10,23,1,2,3,6,4,1,18,23,5,2,1,8
142394,2023,Türkiye,Italy,2,1,7,10,13/07/2023,0,0,2,2,9,5,10,24,0,3,0,3,6,1,21,28,1,3,2,6
142394,2023,Italy,Japan,0,1,0,1,2/7/2023,0,0,1,1,2,4,2,8,0,0,0,0,0,2,7,9,1,2,0,3
142394,2023,Italy,Croatia,1,0,5,6,1/7/2023,0,0,7,7,3,2,6,11,1,0,1,2,4,0,4,8,1,0,0,1
142394,2023,Canada,Italy,1,4,13,18,30/06/2023,0,0,4,4,19,6,13,38,1,1,1,3,12,2,23,37,11,2,1,14
142394,2023,Brazil,Italy,0,2,11,13,28/06/2023,0,0,6,6,19,4,16,39,2,0,1,3,4,2,26,32,10,4,1,15
151986,2023,Türkiye,Italy,0,3,9,12,13/07/2023,12,0,62,74,0,0,0,0,2,1,3,6,0,0,0,0,2,2,0,4
151986,2023,Italy,Japan,1,0,16,17,2/7/2023,11,0,96,107,0,0,2,2,2,3,6,11,0,0,0,0,4,1,1,6
151986,2023,Italy,Croatia,0,0,14,14,1/7/2023,11,0,63,74,2,1,0,3,2,1,2,5,0,0,0,0,11,0,1,12
151986,2023,Canada,Italy,1,0,15,16,30/06/2023,26,0,95,121,0,0,0,0,2,1,0,3,0,0,0,0,3,4,0,7
151986,2023,Brazil,Italy,0,1,11,12,28/06/2023,13,0,93,106,1,1,2,4,2,4,5,11,0,0,0,0,6,3,0,9
151986,2023,Italy,China,0,1,12,13,18/06/2023,27,0,89,116,0,0,2,2,1,1,3,5,0,0,0,0,7,1,2,10
151986,2023,Netherlands,Italy,0,0,15,15,17/06/2023,21,0,95,116,0,0,1,1,2,2,3,7,0,0,0,0,7,5,1,13
151986,2023,Dominican Republic,Italy,0,0,12,12,15/06/2023,32,1,81,114,0,0,0,0,2,3,7,12,0,0,0,0,6,4,0,10
151986,2023,Italy,Bulgaria,0,0,11,11,14/06/2023,12,0,57,69,2,1,0,3,1,5,8,14,0,1,0,1,9,3,0,12
151986,2023,Türkiye,Italy,0,0,12,12,3/6/2023,9,0,67,76,0,0,0,0,0,3,1,4,0,0,0,0,3,1,1,5
151986,2023,USA,Italy,0,1,13,14,2/6/2023,3,2,97,102,2,0,1,3,2,0,5,7,0,0,0,0,6,1,4,11
151986,2023,Poland,Italy,2,0,10,12,1/6/2023,17,1,74,92,0,0,0,0,0,3,3,6,0,0,0,0,2,2,2,6
151986,2023,Italy,Thailand,0,0,19,19,30/05/2023,25,0,110,135,1,0,0,1,2,3,4,9,0,0,0,0,5,4,4,13
173402,2023,Türkiye,Italy,0,0,0,0,13/07/2023,0,0,3,3,0,0,0,0,0,0,0,0,0,1,8,9,8,2,0,10
173402,2023,Italy,Croatia,0,0,0,0,1/7/2023,0,0,0,0,0,0,0,0,0,0,0,0,0,0,0,0,0,0,0,0
173402,2023,Canada,Italy,0,0,0,0,30/06/2023,0,0,6,6,0,0,0,0,0,0,0,0,9,1,13,23,18,3,2,23
173402,2023,Brazil,Italy,0,0,0,0,28/06/2023,0,0,12,12,0,0,0,0,0,0,0,0,3,0,11,14,8,4,4,16
173402,2023,Italy,China,0,0,0,0,18/06/2023,0,1,4,5,0,0,0,0,0,0,0,0,4,0,4,8,15,2,3,20
173402,2023,Netherlands,Italy,0,0,0,0,17/06/2023,0,0,1,1,0,0,0,0,0,0,0,0,2,1,2,5,0,0,2,2
173402,2023,Dominican Republic,Italy,0,0,0,0,15/06/2023,0,0,3,3,0,0,0,0,0,0,0,0,1,0,2,3,1,2,0,3
173402,2023,Italy,Bulgaria,0,0,0,0,14/06/2023,0,0,0,0,0,0,0,0,0,0,0,0,2,0,0,2,0,1,0,1
136694,2023,Türkiye,Italy,0,0,5,5,13/07/2023,0,0,0,0,1,2,5,8,1,2,6,9,0,0,1,1,0,1,0,1
136694,2023,Italy,Japan,1,1,15,17,2/7/2023,0,0,2,2,4,1,8,13,4,3,5,12,0,0,0,0,5,0,0,5
136694,2023,Italy,Croatia,2,0,10,12,1/7/2023,0,0,1,1,3,1,3,7,4,2,2,8,1,0,0,1,1,1,0,2
136694,2023,Canada,Italy,0,3,16,19,30/06/2023,0,0,0,0,7,2,4,13,3,6,4,13,0,0,0,0,3,1,0,4
136694,2023,Brazil,Italy,0,0,12,12,28/06/2023,0,0,1,1,5,0,5,10,0,7,1,8,0,0,0,0,3,4,0,7
136694,2023,Italy,China,0,0,15,15,18/06/2023,0,0,3,3,8,4,3,15,2,2,3,7,0,0,0,0,2,1,0,3
136694,2023,Netherlands,Italy,2,1,14,17,17/06/2023,0,0,1,1,10,1,2,13,5,6,5,16,0,0,0,0,2,2,0,4
136694,2023,Dominican Republic,Italy,1,3,11,15,15/06/2023,0,0,2,2,8,3,4,15,2,6,7,15,0,0,2,2,0,2,0,2
136694,2023,Italy,Bulgaria,0,1,12,13,14/06/2023,0,0,0,0,6,0,2,8,0,0,4,4,2,0,1,3,0,0,1,1
136694,2023,Türkiye,Italy,0,0,0,0,3/6/2023,0,0,0,0,0,0,0,0,0,0,0,0,0,0,0,0,0,0,0,0
136694,2023,USA,Italy,0,1,10,11,2/6/2023,0,0,1,1,2,2,3,7,2,3,4,9,0,1,1,2,0,2,0,2
136694,2023,Poland,Italy,0,0,10,10,1/6/2023,0,0,0,0,5,1,4,10,2,4,3,9,0,0,0,0,0,0,0,0
136694,2023,Italy,Thailand,0,1,14,15,30/05/2023,0,0,1,1,9,2,4,15,3,6,9,18,0,0,0,0,3,2,0,5
151661,2023,Türkiye,Italy,0,1,4,5,13/07/2023,0,0,0,0,4,1,1,6,0,2,1,3,0,0,0,0,0,0,1,1
151661,2023,Italy,Japan,0,1,9,10,2/7/2023,0,0,0,0,2,0,0,2,2,1,3,6,0,1,1,2,3,0,2,5
151661,2023,Italy,Croatia,1,2,8,11,1/7/2023,0,0,2,2,3,1,3,7,0,1,3,4,1,0,1,2,2,0,0,2
151661,2023,Canada,Italy,0,0,11,11,30/06/2023,0,0,1,1,7,1,2,10,6,0,7,13,0,0,0,0,5,3,1,9
151661,2023,Brazil,Italy,0,0,11,11,28/06/2023,0,0,3,3,5,0,2,7,3,4,9,16,0,0,0,0,3,0,1,4
151661,2023,Italy,China,1,2,10,13,18/06/2023,0,0,1,1,6,0,4,10,3,3,4,10,0,0,0,0,5,1,2,8
151661,2023,Netherlands,Italy,0,0,13,13,17/06/2023,0,0,0,0,3,1,4,8,1,2,4,7,0,0,1,1,3,1,2,6
151661,2023,Dominican Republic,Italy,0,1,5,6,15/06/2023,0,0,0,0,2,0,1,3,0,1,2,3,0,0,0,0,1,0,0,1
151661,2023,Italy,Bulgaria,1,1,13,15,14/06/2023,0,0,0,0,3,0,6,9,4,3,2,9,0,0,0,0,3,0,1,4
151661,2023,Türkiye,Italy,0,0,11,11,3/6/2023,0,0,2,2,4,0,2,6,1,5,1,7,0,0,1,1,3,0,0,3
151661,2023,USA,Italy,0,1,2,3,2/6/2023,0,0,0,0,1,0,0,1,0,1,1,2,0,0,0,0,0,0,0,0
151661,2023,Poland,Italy,0,0,1,1,1/6/2023,0,0,0,0,0,0,0,0,0,2,0,2,0,0,0,0,0,0,0,0
151661,2023,Italy,Thailand,1,1,21,23,30/05/2023,0,0,1,1,7,1,7,15,0,2,5,7,0,0,0,0,6,2,4,12
151664,2023,Türkiye,Italy,0,1,6,7,13/07/2023,0,0,1,1,8,8,9,25,2,1,3,6,0,0,0,0,5,5,1,11
151664,2023,Italy,Japan,0,1,14,15,2/7/2023,0,0,4,4,18,6,18,42,5,5,10,20,0,0,0,0,9,3,1,13
151664,2023,Italy,Croatia,0,0,10,10,1/7/2023,0,0,1,1,17,7,10,34,3,2,1,6,0,0,0,0,8,1,1,10
151664,2023,Canada,Italy,0,4,15,19,30/06/2023,0,0,2,2,14,6,17,37,3,3,0,6,0,0,0,0,3,1,0,4
151664,2023,Brazil,Italy,0,2,15,17,28/06/2023,0,0,0,0,20,7,14,41,1,3,3,7,0,0,1,1,5,6,4,15
151664,2023,Italy,China,0,3,11,14,18/06/2023,0,0,3,3,12,5,16,33,3,0,0,3,0,0,0,0,8,0,1,9
151664,2023,Netherlands,Italy,0,1,17,18,17/06/2023,0,0,1,1,22,9,16,47,1,5,0,6,0,0,0,0,10,6,2,18
151664,2023,Dominican Republic,Italy,0,2,16,18,15/06/2023,0,0,4,4,18,7,17,42,3,3,5,11,0,0,0,0,10,2,0,12
151664,2023,Italy,Bulgaria,1,1,14,16,14/06/2023,0,0,3,3,15,2,8,25,2,6,6,14,0,0,0,0,5,4,1,10
151664,2023,Türkiye,Italy,0,2,9,11,3/6/2023,0,0,0,0,15,5,10,30,2,0,0,2,0,0,0,0,6,5,1,12
151664,2023,USA,Italy,0,2,20,22,2/6/2023,0,0,1,1,17,7,15,39,3,3,1,7,0,0,0,0,15,1,2,18
151664,2023,Poland,Italy,1,1,10,12,1/6/2023,0,0,1,1,15,3,13,31,1,2,6,9,0,0,0,0,4,3,1,8
151664,2023,Italy,Thailand,1,3,7,11,30/05/2023,0,0,2,2,19,5,17,41,4,1,2,7,0,0,0,0,2,2,0,4
143391,2023,Türkiye,Italy,0,0,0,0,13/07/2023,0,0,0,0,0,0,0,0,0,0,0,0,0,0,0,0,0,0,0,0
143391,2023,Italy,Japan,0,2,2,4,2/7/2023,0,0,2,2,8,2,9,19,0,2,3,5,4,4,18,26,5,0,1,6
143391,2023,Italy,Croatia,0,0,2,2,1/7/2023,0,0,1,1,2,0,1,3,0,0,0,0,0,0,1,1,3,0,0,3
143391,2023,Canada,Italy,0,0,0,0,30/06/2023,0,0,0,0,0,0,0,0,0,0,0,0,0,0,0,0,0,0,0,0
143391,2023,Brazil,Italy,0,2,0,2,28/06/2023,0,0,0,0,0,0,0,0,0,0,0,0,1,1,1,3,1,0,0,1
143391,2023,Italy,China,1,0,3,4,18/06/2023,0,0,0,0,0,0,0,0,0,0,0,0,1,1,0,2,2,0,0,2
143391,2023,Netherlands,Italy,0,0,0,0,17/06/2023,0,0,0,0,0,0,0,0,0,0,0,0,0,0,0,0,0,0,0,0
143391,2023,Dominican Republic,Italy,0,0,0,0,15/06/2023,0,0,0,0,0,0,0,0,0,0,0,0,0,0,0,0,0,0,0,0
143391,2023,Italy,Bulgaria,0,0,0,0,14/06/2023,0,0,0,0,0,0,0,0,0,0,0,0,0,0,0,0,0,0,0,0
143391,2023,Türkiye,Italy,0,0,2,2,3/6/2023,0,0,1,1,3,2,3,8,0,0,0,0,0,0,3,3,3,0,0,3
143391,2023,USA,Italy,0,0,0,0,2/6/2023,0,0,0,0,0,0,0,0,0,0,0,0,0,0,0,0,0,0,0,0
143391,2023,Poland,Italy,0,2,4,6,1/6/2023,0,0,1,1,3,2,6,11,1,2,0,3,2,1,10,13,2,0,0,2
143391,2023,Italy,Thailand,0,3,8,11,30/05/2023,0,0,3,3,8,2,7,17,1,0,2,3,6,0,17,23,6,3,3,12
136701,2023,Türkiye,Italy,1,0,3,4,13/07/2023,0,0,2,2,3,5,7,15,1,1,0,2,6,0,13,19,3,0,0,3
136701,2023,Italy,China,0,0,16,16,18/06/2023,0,0,8,8,15,2,20,37,0,0,1,1,11,1,24,36,5,5,2,12
136701,2023,Netherlands,Italy,1,2,16,19,17/06/2023,0,0,6,6,23,5,12,40,2,5,1,8,11,3,42,56,11,7,3,21
136701,2023,Dominican Republic,Italy,0,1,17,18,15/06/2023,0,0,7,7,14,5,17,36,1,2,1,4,18,2,35,55,11,6,3,20
136701,2023,Italy,Bulgaria,0,1,6,7,14/06/2023,0,0,6,6,10,3,6,19,0,1,4,5,3,2,18,23,8,3,0,11
136701,2023,Türkiye,Italy,0,0,0,0,3/6/2023,0,0,0,0,0,0,0,0,0,0,0,0,0,0,0,0,0,0,0,0
136701,2023,USA,Italy,0,1,13,14,2/6/2023,0,0,11,11,16,6,15,37,0,4,1,5,1,0,10,11,6,5,5,16
136701,2023,Poland,Italy,0,0,0,0,1/6/2023,0,0,0,0,0,0,0,0,0,0,0,0,0,0,0,0,0,0,0,0
136701,2023,Italy,Thailand,0,0,0,0,30/05/2023,0,0,0,0,0,0,0,0,0,0,0,0,0,0,0,0,0,0,0,0
173917,2023,Türkiye,Italy,1,1,1,3,13/07/2023,0,0,0,0,0,0,0,0,0,0,0,0,0,0,0,0,0,1,0,1
173917,2023,Italy,Japan,0,2,2,4,2/7/2023,0,0,0,0,1,2,0,3,2,0,4,6,0,0,0,0,0,0,1,1
173917,2023,Italy,Croatia,0,0,0,0,1/7/2023,0,0,0,0,0,0,0,0,0,0,0,0,0,0,0,0,0,0,0,0
173917,2023,Canada,Italy,0,2,3,5,30/06/2023,0,0,0,0,0,0,0,0,0,0,0,0,0,0,0,0,0,0,0,0
173917,2023,Brazil,Italy,0,0,0,0,28/06/2023,0,0,0,0,0,0,0,0,0,0,0,0,0,0,0,0,0,0,0,0
173917,2023,Italy,China,0,3,5,8,18/06/2023,0,0,0,0,4,0,0,4,0,0,0,0,0,0,2,2,0,1,0,1
173917,2023,Netherlands,Italy,0,3,5,8,17/06/2023,0,0,0,0,2,0,1,3,0,1,0,1,0,0,0,0,0,0,0,0
173917,2023,Dominican Republic,Italy,0,5,8,13,15/06/2023,0,0,0,0,4,1,5,10,2,1,3,6,0,0,0,0,1,1,0,2
173917,2023,Italy,Bulgaria,0,0,0,0,14/06/2023,0,0,0,0,0,0,0,0,0,0,0,0,0,0,0,0,0,0,0,0
173917,2023,Türkiye,Italy,2,1,3,6,3/6/2023,0,0,1,1,0,1,0,1,1,0,0,1,0,0,0,0,2,0,0,2
173917,2023,USA,Italy,3,6,7,16,2/6/2023,0,0,2,2,5,4,9,18,2,6,6,14,0,0,0,0,1,0,1,2
173917,2023,Poland,Italy,1,5,4,10,1/6/2023,0,0,0,0,7,3,5,15,2,5,5,12,0,0,0,0,1,0,0,1
173917,2023,Italy,Thailand,1,2,3,6,30/05/2023,0,0,0,0,0,0,0,0,0,0,0,0,0,0,0,0,1,1,0,2
136689,2023,Türkiye,Italy,0,0,0,0,13/07/2023,0,0,0,0,0,0,0,0,0,0,0,0,0,0,0,0,0,0,0,0
136689,2023,Italy,Japan,0,0,0,0,2/7/2023,0,0,11,11,0,0,0,0,0,0,0,0,5,1,9,15,22,4,1,27
136689,2023,Italy,Croatia,0,0,0,0,1/7/2023,0,0,6,6,0,0,0,0,0,0,0,0,1,0,3,4,18,2,0,20
136689,2023,Canada,Italy,0,0,0,0,30/06/2023,0,0,0,0,0,0,0,0,0,0,0,0,0,0,0,0,0,0,0,0
136689,2023,Brazil,Italy,0,0,0,0,28/06/2023,0,0,0,0,0,0,0,0,0,0,0,0,0,0,0,0,0,0,0,0
136689,2023,Italy,China,0,0,0,0,18/06/2023,0,0,0,0,0,0,0,0,0,0,0,0,0,0,0,0,0,0,0,0
136689,2023,Netherlands,Italy,0,0,0,0,17/06/2023,0,0,12,12,0,0,0,0,0,0,0,0,3,2,10,15,11,5,0,16
136689,2023,Dominican Republic,Italy,0,0,0,0,15/06/2023,0,0,6,6,0,0,0,0,0,0,0,0,1,0,6,7,21,9,1,31
136689,2023,Italy,Bulgaria,0,0,0,0,14/06/2023,0,0,11,11,0,0,0,0,0,0,0,0,0,0,2,2,12,2,0,14
136689,2023,Türkiye,Italy,0,0,0,0,3/6/2023,0,0,10,10,0,0,0,0,0,0,0,0,5,0,4,9,5,2,0,7
136689,2023,USA,Italy,0,0,0,0,2/6/2023,0,0,0,0,0,0,0,0,0,0,0,0,0,0,0,0,0,0,0,0
136689,2023,Italy,Thailand,0,0,0,0,30/05/2023,0,0,8,8,0,0,0,0,0,0,0,0,6,0,18,24,21,9,2,32
173730,2023,Türkiye,Italy,0,0,1,1,13/07/2023,0,0,0,0,1,0,1,2,0,0,0,0,1,1,1,3,1,0,0,1
173730,2023,Italy,Japan,0,1,14,15,2/7/2023,0,0,4,4,16,4,16,36,2,1,2,5,6,0,14,20,11,0,0,11
173730,2023,Italy,Croatia,0,1,5,6,1/7/2023,0,0,4,4,3,2,8,13,1,2,4,7,1,1,2,4,2,0,0,2
173730,2023,Canada,Italy,0,0,2,2,30/06/2023,0,0,0,0,2,0,6,8,0,2,0,2,0,2,7,9,4,2,0,6
173730,2023,Brazil,Italy,1,2,26,29,28/06/2023,0,0,3,3,11,8,14,33,2,2,2,6,7,1,36,44,7,6,1,14
173730,2023,Italy,China,0,1,5,6,18/06/2023,0,0,5,5,6,6,9,21,2,1,1,4,5,1,26,32,4,1,0,5
173730,2023,Netherlands,Italy,1,1,16,18,17/06/2023,0,0,3,3,16,4,16,36,2,3,2,7,2,2,20,24,6,7,1,14
173730,2023,Dominican Republic,Italy,0,1,14,15,15/06/2023,0,0,1,1,11,5,17,33,3,0,0,3,3,1,12,16,7,2,2,11
173730,2023,Italy,Bulgaria,1,1,10,12,14/06/2023,0,0,0,0,6,5,12,23,1,3,1,5,3,2,15,20,8,6,2,16
173730,2023,Türkiye,Italy,1,0,7,8,3/6/2023,0,0,1,1,4,5,5,14,0,1,1,2,3,2,14,19,3,2,1,6
173730,2023,USA,Italy,1,1,10,12,2/6/2023,0,0,4,4,16,3,14,33,0,5,2,7,6,2,53,61,7,2,2,11
173730,2023,Poland,Italy,1,1,13,15,1/6/2023,0,0,2,2,7,5,11,23,1,2,1,4,6,2,31,39,13,2,1,16
173730,2023,Italy,Thailand,2,0,18,20,30/05/2023,0,0,3,3,16,4,18,38,4,2,1,7,6,1,25,32,18,2,1,21
143396,2023,Türkiye,Italy,0,2,1,3,13/07/2023,1,0,9,10,0,0,0,0,0,0,0,0,0,0,0,0,0,1,1,2
143396,2023,Italy,Japan,1,0,3,4,2/7/2023,1,0,13,14,0,0,0,0,0,1,0,1,0,0,0,0,0,1,0,1
143396,2023,Italy,Croatia,0,0,0,0,1/7/2023,1,0,1,2,0,0,0,0,0,0,0,0,0,0,0,0,0,2,0,2
143396,2023,Canada,Italy,0,1,0,1,30/06/2023,0,0,2,2,0,0,0,0,0,0,0,0,0,0,0,0,1,0,0,1
143396,2023,Brazil,Italy,0,1,4,5,28/06/2023,5,0,17,22,0,0,0,0,1,0,2,3,0,0,0,0,4,0,1,5
143396,2023,Italy,China,1,0,3,4,18/06/2023,0,0,1,1,0,0,0,0,0,0,0,0,0,0,0,0,0,0,0,0
143396,2023,Netherlands,Italy,0,1,0,1,17/06/2023,0,0,0,0,0,0,0,0,0,0,0,0,0,0,0,0,0,0,0,0
143396,2023,Dominican Republic,Italy,0,0,0,0,15/06/2023,3,0,5,8,0,0,0,0,0,0,0,0,0,0,0,0,2,0,0,2
143396,2023,Italy,Bulgaria,0,0,0,0,14/06/2023,0,0,0,0,0,0,0,0,0,0,0,0,0,0,0,0,0,0,0,0
173731,2023,Türkiye,Italy,0,0,0,0,13/07/2023,0,0,0,0,1,1,2,4,0,1,2,3,0,0,0,0,1,0,0,1
173731,2023,Italy,Japan,0,0,1,1,2/7/2023,0,0,0,0,2,1,3,6,0,1,0,1,0,0,1,1,0,0,0,0
173731,2023,Italy,Croatia,0,0,0,0,1/7/2023,0,0,0,0,1,0,0,1,0,0,0,0,0,0,0,0,0,0,0,0
173731,2023,Canada,Italy,0,0,0,0,30/06/2023,0,0,0,0,0,0,1,1,0,0,0,0,0,0,0,0,1,0,0,1
173731,2023,Brazil,Italy,0,0,1,1,28/06/2023,0,0,0,0,6,2,5,13,0,1,2,3,0,0,0,0,1,0,0,1
173731,2023,Italy,China,0,2,3,5,18/06/2023,0,0,1,1,3,2,1,6,0,2,0,2,0,0,0,0,0,1,0,1
173731,2023,Netherlands,Italy,0,0,0,0,17/06/2023,0,0,0,0,0,0,0,0,0,0,0,0,0,0,0,0,0,0,0,0
173731,2023,Dominican Republic,Italy,0,0,2,2,15/06/2023,0,0,0,0,1,3,0,4,0,0,1,1,0,0,0,0,0,0,0,0
173731,2023,Italy,Bulgaria,0,0,0,0,14/06/2023,0,0,0,0,0,0,0,0,0,0,0,0,0,0,0,0,0,0,0,0
173731,2023,Türkiye,Italy,0,0,0,0,3/6/2023,0,0,0,0,0,0,1,1,0,0,0,0,0,0,0,0,0,0,0,0
173731,2023,USA,Italy,0,2,1,3,2/6/2023,0,0,0,0,1,1,0,2,0,1,0,1,0,0,0,0,0,0,0,0
173731,2023,Poland,Italy,0,1,1,2,1/6/2023,0,0,0,0,1,2,3,6,0,1,0,1,0,0,0,0,0,0,0,0
173731,2023,Italy,Thailand,0,1,3,4,30/05/2023,0,0,2,2,4,4,5,13,1,1,0,2,0,0,0,0,2,0,0,2
119385,2023,USA,Japan,0,0,0,0,13/07/2023,0,0,0,0,0,0,0,0,0,0,0,0,0,0,0,0,0,0,0,0
119385,2023,Italy,Japan,0,0,12,12,2/7/2023,0,0,4,4,13,6,24,43,2,3,3,8,0,0,0,0,10,6,4,20
119385,2023,Thailand,Japan,0,0,0,0,1/7/2023,0,0,0,0,0,0,0,0,0,0,0,0,0,0,0,0,0,0,0,0
119385,2023,Netherlands,Japan,0,1,0,1,30/06/2023,0,0,0,0,0,0,0,0,0,0,0,0,0,0,0,0,0,0,0,0
119385,2023,Japan,Türkiye,1,2,8,11,28/06/2023,0,0,3,3,10,2,12,24,1,2,3,6,0,0,0,0,10,1,2,13
151953,2023,USA,Japan,0,0,6,6,13/07/2023,0,0,4,4,4,4,6,14,0,1,5,6,2,0,7,9,6,1,0,7
151953,2023,Italy,Japan,0,0,0,0,2/7/2023,0,0,0,0,0,0,0,0,0,0,0,0,4,0,5,9,2,0,0,2
151953,2023,Thailand,Japan,0,0,6,6,1/7/2023,0,0,1,1,13,1,14,28,0,0,4,4,2,0,7,9,10,1,0,11
151953,2023,Netherlands,Japan,1,1,12,14,30/06/2023,0,0,5,5,7,8,6,21,0,2,0,2,12,1,15,28,7,2,2,11
151953,2023,Japan,Türkiye,0,0,2,2,28/06/2023,0,0,0,0,4,0,6,10,0,0,1,1,2,0,8,10,3,0,0,3
151953,2023,Japan,USA,0,0,0,0,17/06/2023,0,0,0,0,0,0,0,0,0,0,0,0,0,0,0,0,0,0,0,0
151953,2023,Japan,Germany,0,0,9,9,16/06/2023,0,0,8,8,12,2,18,32,0,4,1,5,5,2,18,25,14,3,1,18
151953,2023,Japan,Korea,0,1,7,8,15/06/2023,0,0,2,2,9,5,2,16,1,2,0,3,1,1,6,8,13,0,1,14
151953,2023,Japan,Serbia,0,2,15,17,14/06/2023,0,0,7,7,12,6,15,33,0,5,5,10,4,1,6,11,12,4,1,17
151953,2023,Japan,China,0,0,11,11,4/6/2023,0,0,6,6,13,3,7,23,0,1,1,2,2,0,7,9,7,0,3,10
151953,2023,Bulgaria,Japan,0,1,3,4,3/6/2023,0,0,1,1,10,1,7,18,1,1,1,3,6,1,6,13,5,1,0,6
151953,2023,Croatia,Japan,0,1,8,9,2/6/2023,0,0,2,2,11,1,10,22,1,0,3,4,4,0,2,6,6,0,7,13
151953,2023,Japan,Dominican Republic,1,1,19,21,30/05/2023,0,0,5,5,9,3,13,25,0,1,4,5,2,0,5,7,23,2,1,26
143437,2023,USA,Japan,1,0,11,12,13/07/2023,0,0,3,3,8,5,30,43,1,2,5,8,3,0,11,14,5,2,1,8
143437,2023,Italy,Japan,1,1,7,9,2/7/2023,0,0,0,0,6,4,12,22,1,3,0,4,5,1,9,15,2,0,1,3
143437,2023,Thailand,Japan,2,0,12,14,1/7/2023,0,0,3,3,14,3,20,37,3,1,4,8,1,0,12,13,13,0,1,14
143437,2023,Netherlands,Japan,2,2,10,14,30/06/2023,0,0,3,3,13,4,18,35,1,3,2,6,3,1,10,14,8,5,2,15
143437,2023,Japan,Türkiye,2,4,17,23,28/06/2023,0,0,6,6,22,9,28,59,1,3,0,4,6,0,21,27,7,1,1,9
143437,2023,Japan,USA,0,1,22,23,17/06/2023,0,0,4,4,12,5,26,43,0,0,1,1,6,1,13,20,17,9,1,27
143437,2023,Japan,Germany,2,2,21,25,16/06/2023,0,0,5,5,20,6,31,57,2,1,0,3,1,1,8,10,12,1,0,13
143437,2023,Japan,Korea,0,0,2,2,15/06/2023,0,0,1,1,1,0,1,2,0,0,0,0,0,0,4,4,2,0,0,2
143437,2023,Japan,Serbia,1,2,15,18,14/06/2023,0,0,3,3,19,6,23,48,1,2,5,8,3,0,13,16,11,4,1,16
143437,2023,Japan,China,2,1,10,13,4/6/2023,0,0,1,1,16,4,13,33,1,0,0,1,1,1,10,12,10,0,3,13
143437,2023,Bulgaria,Japan,1,2,11,14,3/6/2023,0,0,2,2,11,4,10,25,2,1,2,5,5,2,6,13,9,0,3,12
143437,2023,Croatia,Japan,3,2,10,15,2/6/2023,0,0,3,3,13,4,14,31,2,1,1,4,2,2,9,13,11,1,1,13
143437,2023,Japan,Dominican Republic,1,2,12,15,30/05/2023,0,0,4,4,18,7,26,51,3,4,2,9,1,1,12,14,11,1,0,12
162218,2023,USA,Japan,1,1,7,9,13/07/2023,0,0,3,3,4,3,8,15,0,1,1,2,4,0,6,10,6,1,0,7
162218,2023,Italy,Japan,2,0,13,15,2/7/2023,0,0,2,2,5,2,7,14,0,1,2,3,7,0,12,19,6,2,2,10
162218,2023,Thailand,Japan,0,2,12,14,1/7/2023,0,0,3,3,8,5,16,29,1,1,2,4,2,0,5,7,10,2,0,12
162218,2023,Netherlands,Japan,0,1,8,9,30/06/2023,0,0,2,2,6,2,17,25,0,2,3,5,3,0,5,8,3,3,1,7
162218,2023,Japan,Türkiye,1,1,14,16,28/06/2023,0,0,8,8,16,9,17,42,2,0,2,4,6,1,34,41,13,3,0,16
162218,2023,Japan,USA,2,2,11,15,17/06/2023,0,0,3,3,16,7,24,47,1,0,1,2,6,0,11,17,16,12,1,29
162218,2023,Japan,Germany,2,1,6,9,16/06/2023,0,0,0,0,0,1,1,2,0,0,0,0,0,0,1,1,0,0,1,1
162218,2023,Japan,Korea,2,3,7,12,15/06/2023,0,0,1,1,9,4,8,21,0,2,3,5,2,0,6,8,6,5,1,12
162218,2023,Japan,Serbia,0,2,2,4,14/06/2023,0,0,0,0,4,1,0,5,0,0,0,0,0,0,1,1,0,0,0,0
151944,2023,USA,Japan,0,0,11,11,13/07/2023,11,0,96,107,2,0,0,2,0,1,4,5,0,0,0,0,13,6,3,22
151944,2023,Italy,Japan,3,1,20,24,2/7/2023,11,1,114,126,0,0,1,1,0,2,4,6,0,0,0,0,5,3,2,10
151944,2023,Thailand,Japan,1,2,12,15,1/7/2023,23,3,67,93,0,1,2,3,0,4,2,6,0,0,0,0,12,2,1,15
151944,2023,Netherlands,Japan,1,0,5,6,30/06/2023,11,1,21,33,0,0,0,0,0,0,0,0,0,1,0,1,3,3,1,7
151944,2023,Japan,Türkiye,0,1,0,1,28/06/2023,10,0,9,19,0,0,0,0,0,0,0,0,0,0,0,0,1,0,0,1
151944,2023,Japan,USA,0,1,0,1,17/06/2023,0,0,0,0,0,0,0,0,0,0,0,0,0,0,0,0,0,0,0,0
151944,2023,Japan,Germany,2,1,15,18,16/06/2023,52,0,79,131,2,0,1,3,0,1,1,2,0,0,0,0,18,4,1,23
151944,2023,Japan,Korea,0,0,9,9,15/06/2023,29,0,50,79,0,0,0,0,0,2,3,5,0,0,0,0,4,5,0,9
151944,2023,Japan,Serbia,1,1,14,16,14/06/2023,24,0,94,118,2,0,2,4,0,3,4,7,0,0,0,0,13,7,0,20
151944,2023,Japan,China,1,1,8,10,4/6/2023,13,1,72,86,0,0,1,1,0,0,0,0,0,0,1,1,5,0,1,6
151944,2023,Bulgaria,Japan,1,0,12,13,3/6/2023,4,1,58,63,0,0,1,1,0,1,1,2,0,0,0,0,6,0,2,8
151944,2023,Croatia,Japan,1,2,13,16,2/6/2023,2,0,79,81,1,0,1,2,0,0,2,2,0,1,0,1,5,0,1,6
151944,2023,Japan,Dominican Republic,2,0,18,20,30/05/2023,41,0,87,128,2,1,2,5,1,3,2,6,0,0,1,1,8,2,0,10
152457,2023,USA,Japan,0,0,1,1,13/07/2023,3,0,19,22,0,0,0,0,0,0,1,1,0,0,0,0,4,1,0,5
152457,2023,Japan,USA,1,0,20,21,17/06/2023,12,1,117,130,2,1,2,5,0,1,2,3,0,0,0,0,20,8,3,31
152457,2023,Japan,Germany,0,0,0,0,16/06/2023,2,0,1,3,0,0,0,0,0,0,0,0,0,0,0,0,0,1,0,1
152457,2023,Japan,Korea,0,0,2,2,15/06/2023,0,0,2,2,0,0,0,0,0,0,0,0,0,0,0,0,2,0,0,2
152457,2023,Japan,Serbia,0,0,1,1,14/06/2023,2,0,7,9,0,0,0,0,0,0,0,0,0,0,0,0,1,1,0,2
142372,2023,USA,Japan,0,1,10,11,13/07/2023,0,0,1,1,12,2,21,35,0,1,1,2,1,0,9,10,13,4,0,17
142372,2023,Italy,Japan,1,1,6,8,2/7/2023,0,0,1,1,4,3,13,20,0,0,3,3,2,0,9,11,4,0,0,4
142372,2023,Thailand,Japan,0,0,0,0,1/7/2023,0,0,0,0,0,0,0,0,0,0,0,0,0,0,0,0,0,0,0,0
142372,2023,Netherlands,Japan,0,0,2,2,30/06/2023,0,0,0,0,0,1,4,5,0,1,0,1,0,0,0,0,1,2,0,3
142372,2023,Japan,Türkiye,0,0,3,3,28/06/2023,0,0,1,1,1,2,3,6,0,0,1,1,0,0,1,1,1,1,0,2
142372,2023,Japan,USA,0,0,0,0,17/06/2023,0,0,0,0,0,0,0,0,0,0,0,0,0,0,0,0,0,0,0,0
142372,2023,Japan,Germany,0,2,8,10,16/06/2023,0,0,2,2,20,8,21,49,0,3,5,8,1,1,7,9,8,2,1,11
142372,2023,Japan,Korea,3,1,12,16,15/06/2023,0,0,2,2,9,1,12,22,0,1,2,3,1,0,6,7,5,4,0,9
142372,2023,Japan,Serbia,1,1,16,18,14/06/2023,0,0,3,3,16,4,20,40,1,2,2,5,2,1,10,13,8,6,0,14
142372,2023,Japan,China,0,0,2,2,4/6/2023,0,0,0,0,1,1,5,7,0,0,1,1,0,0,5,5,1,0,0,1
142372,2023,Bulgaria,Japan,0,2,6,8,3/6/2023,0,1,2,3,13,4,12,29,1,2,0,3,2,1,4,7,7,0,0,7
142372,2023,Croatia,Japan,0,1,13,14,2/6/2023,0,0,1,1,9,2,13,24,0,0,2,2,2,0,5,7,11,0,5,16
142372,2023,Japan,Dominican Republic,0,2,8,10,30/05/2023,0,0,4,4,14,2,29,45,1,0,4,5,0,2,10,12,14,3,1,18
162227,2023,USA,Japan,0,1,13,14,13/07/2023,0,0,1,1,2,0,3,5,2,8,4,14,0,0,1,1,1,1,0,2
162227,2023,Italy,Japan,0,0,6,6,2/7/2023,0,0,1,1,4,3,6,13,1,5,9,15,0,0,0,0,2,1,1,4
162227,2023,Thailand,Japan,0,1,9,10,1/7/2023,0,0,4,4,8,1,5,14,3,2,4,9,0,0,0,0,1,0,2,3
162227,2023,Netherlands,Japan,2,1,8,11,30/06/2023,0,0,3,3,7,1,8,16,0,3,3,6,0,0,0,0,0,1,1,2
162227,2023,Japan,Türkiye,0,0,11,11,28/06/2023,0,0,1,1,6,1,13,20,2,3,4,9,0,0,0,0,3,1,1,5
162227,2023,Japan,USA,0,1,11,12,17/06/2023,0,0,0,0,6,3,4,13,2,7,4,13,0,0,3,3,7,1,0,8
162227,2023,Japan,Germany,0,1,15,16,16/06/2023,0,0,2,2,6,1,7,14,4,3,1,8,0,0,1,1,7,2,1,10
162227,2023,Japan,Korea,0,2,3,5,15/06/2023,0,0,1,1,9,1,6,16,2,3,6,11,0,0,0,0,2,0,0,2
162227,2023,Japan,Serbia,2,1,10,13,14/06/2023,0,0,0,0,3,1,5,9,2,4,4,10,1,1,3,5,3,0,2,5
189198,2023,USA,Japan,0,0,0,0,13/07/2023,0,0,1,1,0,0,0,0,0,0,0,0,0,0,0,0,4,1,0,5
189198,2023,Italy,Japan,0,0,0,0,2/7/2023,0,0,5,5,0,0,0,0,0,0,0,0,1,2,6,9,11,2,1,14
189198,2023,Thailand,Japan,0,0,0,0,1/7/2023,0,0,0,0,0,0,0,0,0,0,0,0,0,0,0,0,0,0,0,0
189198,2023,Netherlands,Japan,0,0,0,0,30/06/2023,0,0,8,8,0,0,0,0,0,0,0,0,3,0,10,13,5,2,2,9
189198,2023,Japan,Türkiye,0,0,0,0,28/06/2023,0,0,13,13,0,0,0,0,0,0,0,0,4,0,11,15,22,9,1,32
187806,2023,USA,Japan,0,0,3,3,13/07/2023,0,0,2,2,0,0,0,0,0,0,0,0,2,1,1,4,2,0,0,2
187806,2023,Japan,USA,0,0,0,0,17/06/2023,0,0,0,0,0,0,0,0,0,0,0,0,0,0,0,0,0,0,0,0
187806,2023,Japan,Germany,0,0,0,0,16/06/2023,0,0,0,0,0,0,0,0,0,0,0,0,0,0,0,0,0,0,0,0
187806,2023,Japan,Korea,0,0,0,0,15/06/2023,0,0,4,4,0,0,0,0,0,0,0,0,2,1,12,15,10,1,0,11
187806,2023,Japan,Serbia,0,0,0,0,14/06/2023,0,0,0,0,0,0,0,0,0,0,0,0,0,0,0,0,0,0,0,0
146519,2023,USA,Japan,0,2,13,15,13/07/2023,0,0,3,3,5,1,9,15,5,5,6,16,2,0,3,5,1,2,0,3
146519,2023,Italy,Japan,1,3,7,11,2/7/2023,0,0,1,1,10,2,10,22,5,6,6,17,0,0,1,1,4,0,0,4
146519,2023,Thailand,Japan,0,0,0,0,1/7/2023,0,0,1,1,0,0,0,0,0,0,0,0,0,0,0,0,0,0,0,0
146519,2023,Netherlands,Japan,0,0,3,3,30/06/2023,0,0,0,0,0,0,0,0,0,2,0,2,0,0,0,0,0,0,0,0
146519,2023,Japan,Türkiye,0,2,6,8,28/06/2023,0,0,2,2,5,0,10,15,2,4,7,13,0,0,0,0,3,3,0,6
151947,2023,USA,Japan,0,0,0,0,13/07/2023,0,0,0,0,0,0,0,0,0,0,0,0,0,0,0,0,0,0,0,0
151947,2023,Italy,Japan,0,0,0,0,2/7/2023,0,0,0,0,0,0,0,0,0,0,0,0,0,0,0,0,0,0,0,0
151947,2023,Thailand,Japan,1,0,5,6,1/7/2023,0,0,0,0,1,1,1,3,0,2,3,5,0,0,0,0,1,0,0,1
151947,2023,Netherlands,Japan,0,1,3,4,30/06/2023,0,0,0,0,1,1,3,5,0,1,0,1,0,0,0,0,1,0,0,1
151947,2023,Japan,Türkiye,0,2,2,4,28/06/2023,0,0,0,0,0,2,2,4,0,2,1,3,1,0,1,2,0,0,0,0
151947,2023,Japan,USA,1,1,6,8,17/06/2023,0,0,0,0,0,0,0,0,0,0,0,0,0,0,0,0,0,1,0,1
151947,2023,Japan,Germany,0,0,0,0,16/06/2023,0,0,0,0,0,0,0,0,0,1,0,1,0,0,0,0,0,0,0,0
151947,2023,Japan,Korea,0,0,0,0,15/06/2023,0,0,0,0,0,0,0,0,0,0,0,0,0,0,0,0,0,0,0,0
151947,2023,Japan,Serbia,1,1,2,4,14/06/2023,0,0,1,1,1,0,2,3,0,4,3,7,0,0,0,0,1,0,0,1
151947,2023,Japan,China,1,2,7,10,4/6/2023,0,0,0,0,1,3,3,7,0,1,4,5,1,0,1,2,1,0,0,1
151947,2023,Bulgaria,Japan,0,1,11,12,3/6/2023,0,0,0,0,2,1,2,5,0,1,3,4,0,0,0,0,3,0,0,3
151947,2023,Croatia,Japan,0,3,5,8,2/6/2023,0,0,0,0,2,0,1,3,1,1,1,3,0,0,0,0,1,0,0,1
151947,2023,Japan,Dominican Republic,0,1,7,8,30/05/2023,0,0,2,2,7,4,2,13,4,3,10,17,0,0,0,0,3,0,0,3
189509,2023,USA,Japan,0,0,0,0,13/07/2023,0,0,13,13,0,0,0,0,0,0,0,0,2,1,21,24,16,5,2,23
189509,2023,Italy,Japan,0,0,0,0,2/7/2023,0,0,8,8,0,0,0,0,0,0,0,0,2,0,6,8,9,4,0,13
189509,2023,Thailand,Japan,0,0,0,0,1/7/2023,0,0,11,11,0,0,0,0,0,0,0,0,7,1,18,26,10,3,2,15
189509,2023,Netherlands,Japan,0,0,0,0,30/06/2023,0,0,7,7,0,0,0,0,0,0,0,0,4,0,14,18,7,3,2,12
189509,2023,Japan,Türkiye,0,0,0,0,28/06/2023,0,0,0,0,0,0,0,0,0,0,0,0,0,0,0,0,0,0,0,0
189509,2023,Japan,USA,0,0,0,0,17/06/2023,0,0,26,26,0,0,0,0,0,0,0,0,10,2,30,42,17,7,2,26
189509,2023,Japan,Germany,0,0,0,0,16/06/2023,0,0,17,17,0,0,0,0,0,0,0,0,11,2,28,41,19,9,2,30
189509,2023,Japan,Korea,0,0,0,0,15/06/2023,0,0,0,0,0,0,0,0,0,0,0,0,0,0,0,0,1,0,0,1
189509,2023,Japan,Serbia,0,0,0,0,14/06/2023,0,0,16,16,0,0,0,0,0,0,0,0,5,1,33,39,24,10,1,35
189509,2023,Japan,China,0,0,0,0,4/6/2023,0,0,4,4,0,0,0,0,0,0,0,0,8,1,25,34,8,1,1,10
189509,2023,Bulgaria,Japan,0,0,0,0,3/6/2023,0,0,5,5,0,0,0,0,0,0,0,0,5,0,12,17,13,0,0,13
189509,2023,Croatia,Japan,0,0,0,0,2/6/2023,0,0,2,2,0,0,0,0,0,0,0,0,7,0,14,21,17,0,2,19
189509,2023,Japan,Dominican Republic,0,0,0,0,30/05/2023,0,0,9,9,0,0,0,0,0,0,0,0,8,0,30,38,26,2,5,33
174243,2023,USA,Japan,0,2,4,6,13/07/2023,0,0,3,3,13,7,18,38,1,1,0,2,0,0,2,2,5,2,1,8
174243,2023,Italy,Japan,0,0,9,9,2/7/2023,0,0,0,0,8,4,6,18,0,1,1,2,2,0,6,8,6,3,0,9
174243,2023,Thailand,Japan,0,1,1,2,1/7/2023,0,0,0,0,0,0,0,0,0,0,0,0,0,0,0,0,0,0,0,0
174243,2023,Netherlands,Japan,0,2,7,9,30/06/2023,0,0,1,1,17,5,12,34,1,0,0,1,0,0,6,6,5,3,1,9
174243,2023,Japan,Türkiye,0,1,1,2,28/06/2023,0,0,0,0,0,0,0,0,0,0,0,0,0,0,0,0,0,0,0,0
174243,2023,Japan,USA,1,3,16,20,17/06/2023,0,0,5,5,28,3,21,52,3,1,3,7,0,0,2,2,8,5,1,14
174243,2023,Japan,Germany,0,1,4,5,16/06/2023,0,0,0,0,1,0,1,2,0,0,0,0,0,0,0,0,1,0,0,1
174243,2023,Japan,Korea,1,2,1,4,15/06/2023,0,0,0,0,3,0,3,6,0,0,1,1,0,0,0,0,3,0,0,3
174243,2023,Japan,Serbia,0,0,1,1,14/06/2023,0,0,2,2,2,2,3,7,0,0,0,0,0,0,0,0,2,0,0,2
174243,2023,Japan,China,0,3,1,4,4/6/2023,0,0,0,0,9,4,6,19,0,1,0,1,0,0,4,4,0,0,0,0
174243,2023,Bulgaria,Japan,1,0,1,2,3/6/2023,0,0,1,1,3,0,4,7,0,0,2,2,0,0,0,0,0,0,0,0
174243,2023,Croatia,Japan,0,0,1,1,2/6/2023,0,0,0,0,2,1,1,4,0,0,0,0,0,0,0,0,1,0,1,2
174243,2023,Japan,Dominican Republic,0,0,1,1,30/05/2023,0,0,0,0,0,0,0,0,0,0,0,0,0,0,0,0,0,0,0,0
163830,2023,Poland,Korea,2,2,4,8,2/7/2023,0,0,1,1,11,7,8,26,0,2,3,5,0,0,6,6,3,0,2,5
163830,2023,Korea,China,1,3,9,13,1/7/2023,1,0,6,7,16,6,16,38,0,1,2,3,0,0,8,8,8,1,3,12
163830,2023,Dominican Republic,Korea,1,2,3,6,29/06/2023,0,0,0,0,7,3,9,19,0,4,4,8,0,0,0,0,1,2,0,3
163830,2023,Bulgaria,Korea,0,3,7,10,27/06/2023,0,0,4,4,18,7,24,49,1,1,4,6,0,0,1,1,10,2,0,12
163830,2023,Germany,Korea,0,2,4,6,18/06/2023,0,2,4,6,8,6,22,36,1,7,1,9,0,0,0,0,3,0,0,3
163830,2023,Korea,Croatia,0,0,5,5,16/06/2023,0,0,1,1,2,2,9,13,0,2,1,3,0,0,0,0,8,0,2,10
163830,2023,Japan,Korea,0,0,3,3,15/06/2023,0,0,2,2,4,3,1,8,0,2,1,3,0,0,0,0,2,0,0,2
163830,2023,Brazil,Korea,2,0,8,10,15/06/2023,0,0,1,1,8,5,10,23,1,0,1,2,0,0,0,0,8,3,1,12
163760,2023,Poland,Korea,1,1,9,11,2/7/2023,0,0,1,1,3,1,6,10,1,4,1,6,0,0,0,0,1,2,0,3
163760,2023,Korea,China,0,1,11,12,1/7/2023,0,0,1,1,9,1,3,13,1,3,4,8,0,0,3,3,6,0,0,6
163760,2023,Dominican Republic,Korea,0,0,6,6,29/06/2023,0,0,0,0,4,1,8,13,1,5,3,9,0,0,0,0,2,0,0,2
163760,2023,Bulgaria,Korea,0,1,8,9,27/06/2023,0,0,1,1,6,1,7,14,1,2,4,7,0,0,0,0,4,1,0,5
163760,2023,Germany,Korea,0,0,0,0,18/06/2023,0,0,0,0,0,0,0,0,0,0,0,0,0,0,0,0,0,0,0,0
163760,2023,Korea,Croatia,1,0,1,2,16/06/2023,0,0,0,0,2,1,1,4,0,1,1,2,0,0,0,0,1,0,0,1
163760,2023,Japan,Korea,0,0,2,2,15/06/2023,0,0,0,0,1,0,5,6,1,0,3,4,0,0,1,1,2,1,0,3
163760,2023,Brazil,Korea,0,0,0,0,15/06/2023,0,0,0,0,0,0,1,1,0,1,0,1,0,0,0,0,0,0,0,0
163760,2023,Thailand,Korea,1,1,7,9,4/6/2023,0,0,1,1,6,1,4,11,1,3,2,6,0,0,0,0,2,0,0,2
163760,2023,USA,Korea,0,0,0,0,3/6/2023,0,0,0,0,0,0,1,1,0,1,0,1,0,0,0,0,0,0,0,0
163760,2023,Canada,Korea,0,0,4,4,2/6/2023,0,0,0,0,4,1,4,9,0,1,1,2,0,0,1,1,0,0,1,1
163760,2023,Korea,Türkiye,0,1,8,9,31/05/2023,0,0,2,2,3,0,6,9,1,2,1,4,0,0,0,0,0,1,0,1
120148,2023,Poland,Korea,0,0,0,0,2/7/2023,0,0,0,0,0,0,0,0,0,0,0,0,0,0,0,0,0,0,0,0
120148,2023,Korea,China,0,0,1,1,1/7/2023,0,0,0,0,0,0,0,0,0,0,0,0,0,0,0,0,0,1,0,1
120148,2023,Dominican Republic,Korea,0,0,2,2,29/06/2023,2,0,5,7,0,0,0,0,0,0,0,0,0,0,0,0,1,1,2,4
120148,2023,Bulgaria,Korea,0,0,0,0,27/06/2023,0,0,0,0,0,0,0,0,0,0,0,0,0,0,0,0,0,0,0,0
120148,2023,Germany,Korea,0,2,6,8,18/06/2023,3,0,10,13,0,0,0,0,0,0,0,0,0,0,1,1,1,0,0,1
120148,2023,Korea,Croatia,1,0,3,4,16/06/2023,13,1,40,54,0,1,0,1,0,0,1,1,0,0,0,0,4,1,2,7
120148,2023,Japan,Korea,0,1,3,4,15/06/2023,8,0,22,30,0,0,0,0,0,0,0,0,0,0,0,0,2,1,0,3
120148,2023,Brazil,Korea,0,1,1,2,15/06/2023,2,0,8,10,0,0,0,0,0,0,0,0,0,0,0,0,0,1,1,2
120148,2023,Thailand,Korea,0,0,10,10,4/6/2023,3,0,46,49,0,1,1,2,0,0,2,2,0,0,0,0,7,0,1,8
120148,2023,USA,Korea,0,0,2,2,3/6/2023,0,0,3,3,0,0,0,0,0,0,0,0,0,0,0,0,0,0,0,0
120148,2023,Canada,Korea,0,1,2,3,2/6/2023,3,1,29,33,0,0,0,0,0,0,0,0,0,0,0,0,1,3,3,7
120148,2023,Korea,Türkiye,0,2,5,7,31/05/2023,11,1,52,64,1,0,0,1,0,0,0,0,0,0,1,1,4,4,1,9
181159,2023,Poland,Korea,1,3,3,7,2/7/2023,11,0,62,73,0,0,1,1,0,3,3,6,0,0,0,0,2,3,0,5
181159,2023,Korea,China,0,2,7,9,1/7/2023,26,0,83,109,0,0,3,3,0,1,1,2,0,0,1,1,5,2,0,7
181159,2023,Dominican Republic,Korea,0,1,7,8,29/06/2023,24,0,40,64,0,0,1,1,0,0,2,2,0,0,0,0,5,2,1,8
181159,2023,Bulgaria,Korea,3,2,16,21,27/06/2023,13,1,102,116,1,1,1,3,0,1,0,1,0,0,0,0,4,3,3,10
181159,2023,Thailand,Korea,0,0,6,6,4/6/2023,10,0,45,55,0,0,2,2,0,1,1,2,0,0,0,0,3,1,1,5
181159,2023,USA,Korea,0,2,6,8,3/6/2023,6,2,81,89,1,0,1,2,0,0,1,1,0,0,0,0,1,1,5,7
181159,2023,Canada,Korea,0,0,7,7,2/6/2023,3,2,54,59,0,1,0,1,0,0,1,1,0,0,0,0,1,2,2,5
181159,2023,Korea,Türkiye,0,0,0,0,31/05/2023,0,1,3,4,0,0,0,0,0,0,0,0,0,0,0,0,0,0,0,0
200723,2023,Poland,Korea,0,0,1,1,2/7/2023,2,0,16,18,0,0,0,0,0,0,0,0,0,0,0,0,1,1,0,2
200723,2023,Korea,China,0,0,0,0,1/7/2023,1,0,2,3,0,0,0,0,0,0,0,0,0,0,0,0,0,0,0,0
200723,2023,Dominican Republic,Korea,0,0,0,0,29/06/2023,2,0,6,8,0,0,0,0,0,0,0,0,0,0,0,0,0,0,0,0
200723,2023,Bulgaria,Korea,0,0,0,0,27/06/2023,1,0,4,5,0,0,0,0,0,0,0,0,0,0,0,0,0,0,0,0
200723,2023,Germany,Korea,1,2,8,11,18/06/2023,17,0,84,101,1,0,1,2,0,0,0,0,0,0,0,0,10,2,0,12
200723,2023,Korea,Croatia,1,1,2,4,16/06/2023,6,0,42,48,1,0,0,1,0,0,1,1,0,0,0,0,2,0,0,2
200723,2023,Japan,Korea,1,1,3,5,15/06/2023,11,1,34,46,0,0,1,1,0,1,1,2,0,0,0,0,8,2,0,10
200723,2023,Brazil,Korea,0,1,12,13,15/06/2023,17,1,54,72,0,0,2,2,1,1,2,4,0,0,1,1,11,3,0,14
133479,2023,Poland,Korea,0,0,0,0,2/7/2023,0,0,4,4,0,0,0,0,0,0,0,0,3,1,11,15,9,5,2,16
133479,2023,Korea,China,0,0,0,0,1/7/2023,0,0,7,7,0,0,0,0,0,0,0,0,5,3,13,21,9,5,2,16
133479,2023,Dominican Republic,Korea,0,0,0,0,29/06/2023,0,0,7,7,0,0,0,0,0,0,0,0,6,5,18,29,8,5,1,14
133479,2023,Bulgaria,Korea,0,0,0,0,27/06/2023,0,0,13,13,0,0,0,0,0,0,0,0,3,0,9,12,18,6,0,24
133479,2023,Germany,Korea,0,0,0,0,18/06/2023,0,0,15,15,0,0,0,0,0,0,0,0,10,3,24,37,17,8,2,27
133479,2023,Korea,Croatia,0,0,0,0,16/06/2023,0,0,12,12,0,0,0,0,0,0,0,0,8,0,11,19,16,5,3,24
133479,2023,Japan,Korea,0,0,0,0,15/06/2023,0,1,11,12,0,0,0,0,0,0,0,0,4,1,8,13,5,6,1,12
133479,2023,Brazil,Korea,0,0,0,0,15/06/2023,0,0,16,16,0,0,0,0,0,0,0,0,4,1,13,18,8,15,3,26
133479,2023,Thailand,Korea,0,0,0,0,4/6/2023,0,0,13,13,0,0,0,0,0,0,0,0,3,1,9,13,12,5,2,19
133479,2023,USA,Korea,0,0,0,0,3/6/2023,0,0,8,8,0,0,0,0,0,0,0,0,6,0,5,11,7,8,3,18
133479,2023,Canada,Korea,0,0,0,0,2/6/2023,0,0,5,5,0,0,0,0,0,0,0,0,1,0,7,8,6,7,3,16
133479,2023,Korea,Türkiye,0,0,0,0,31/05/2023,0,0,1,1,0,0,0,0,0,0,0,0,0,0,0,0,0,0,0,0
131893,2023,Poland,Korea,0,0,4,4,2/7/2023,0,0,0,0,2,6,6,14,0,0,1,1,1,1,6,8,2,1,0,3
131893,2023,Korea,China,0,0,0,0,1/7/2023,0,0,0,0,0,0,0,0,0,0,0,0,0,0,0,0,0,0,0,0
131893,2023,Dominican Republic,Korea,0,0,0,0,29/06/2023,0,0,0,0,0,0,0,0,0,0,0,0,0,0,0,0,0,0,0,0
131893,2023,Bulgaria,Korea,0,0,3,3,27/06/2023,0,0,1,1,2,3,5,10,0,0,1,1,1,0,3,4,3,1,0,4
131893,2023,Germany,Korea,0,0,0,0,18/06/2023,0,0,0,0,2,1,4,7,0,4,1,5,0,0,0,0,0,1,0,1
131893,2023,Korea,Croatia,0,0,3,3,16/06/2023,0,0,0,0,1,3,5,9,1,0,1,2,0,0,6,6,1,0,0,1
131893,2023,Japan,Korea,1,0,3,4,15/06/2023,0,0,0,0,1,3,13,17,0,2,0,2,0,1,11,12,2,1,1,4
131893,2023,Brazil,Korea,0,0,0,0,15/06/2023,0,0,0,0,0,0,0,0,0,0,0,0,0,0,0,0,0,0,0,0
131893,2023,Thailand,Korea,0,0,12,12,4/6/2023,0,0,2,2,11,2,22,35,3,2,3,8,2,1,18,21,8,2,1,11
131893,2023,USA,Korea,0,0,0,0,3/6/2023,0,0,0,0,0,0,0,0,0,0,0,0,0,0,0,0,0,0,0,0
131893,2023,Canada,Korea,0,1,3,4,2/6/2023,0,0,2,2,7,3,10,20,0,1,0,1,1,2,7,10,4,1,3,8
131893,2023,Korea,Türkiye,0,2,5,7,31/05/2023,0,0,2,2,5,4,12,21,1,1,2,4,2,0,15,17,3,3,5,11
163822,2023,Poland,Korea,0,0,8,8,2/7/2023,0,0,0,0,2,1,5,8,1,2,4,7,0,0,1,1,1,1,0,2
163822,2023,Korea,China,4,2,12,18,1/7/2023,0,0,1,1,7,5,6,18,1,1,5,7,0,1,1,2,3,1,0,4
163822,2023,Dominican Republic,Korea,0,1,6,7,29/06/2023,0,0,2,2,4,0,2,6,1,4,0,5,0,0,0,0,0,1,0,1
163822,2023,Bulgaria,Korea,0,0,0,0,27/06/2023,0,0,0,0,0,0,1,1,0,0,0,0,0,0,0,0,0,0,0,0
163822,2023,Germany,Korea,1,0,10,11,18/06/2023,0,0,1,1,4,1,10,15,2,8,9,19,0,0,1,1,2,1,0,3
163822,2023,Korea,Croatia,0,0,5,5,16/06/2023,0,0,1,1,4,2,6,12,0,0,2,2,0,0,0,0,1,0,0,1
163822,2023,Japan,Korea,0,0,3,3,15/06/2023,0,0,1,1,1,0,1,2,2,1,2,5,0,0,1,1,1,1,1,3
163822,2023,Brazil,Korea,0,2,8,10,15/06/2023,0,1,0,1,5,1,5,11,2,1,2,5,0,0,0,0,0,3,0,3
163822,2023,Thailand,Korea,0,0,0,0,4/6/2023,0,0,0,0,0,0,0,0,0,0,0,0,0,0,0,0,0,0,0,0
163822,2023,USA,Korea,0,0,0,0,3/6/2023,0,0,0,0,0,0,0,0,0,0,0,0,0,0,0,0,0,0,0,0
163822,2023,Canada,Korea,0,1,5,6,2/6/2023,0,0,0,0,4,0,7,11,2,2,0,4,0,0,0,0,3,0,1,4
163822,2023,Korea,Türkiye,0,0,2,2,31/05/2023,0,0,0,0,1,0,1,2,1,1,2,4,1,1,0,2,0,0,0,0
163832,2023,Poland,Korea,0,1,4,5,2/7/2023,0,0,0,0,3,6,9,18,1,3,2,6,2,1,7,10,2,0,0,2
163832,2023,Korea,China,0,1,11,12,1/7/2023,0,0,1,1,8,6,18,32,1,0,4,5,2,1,19,22,5,2,1,8
163832,2023,Dominican Republic,Korea,1,2,10,13,29/06/2023,0,0,1,1,9,6,10,25,0,2,1,3,5,0,10,15,4,2,2,8
163832,2023,Bulgaria,Korea,0,1,3,4,27/06/2023,0,0,1,1,3,8,15,26,1,5,2,8,4,1,13,18,8,2,1,11
163832,2023,Germany,Korea,0,1,11,12,18/06/2023,0,1,3,4,16,4,15,35,0,2,1,3,3,1,26,30,6,4,2,12
163832,2023,Korea,Croatia,0,1,2,3,16/06/2023,0,0,2,2,5,1,7,13,0,2,2,4,0,1,10,11,5,3,0,8
163832,2023,Japan,Korea,0,0,5,5,15/06/2023,0,0,3,3,5,2,5,12,1,3,1,5,1,0,11,12,0,3,0,3
163832,2023,Brazil,Korea,0,1,6,7,15/06/2023,0,0,4,4,6,5,14,25,0,2,1,3,5,3,27,35,5,2,0,7
163832,2023,Thailand,Korea,0,2,2,4,4/6/2023,0,0,3,3,2,2,5,9,0,2,1,3,1,0,0,1,3,0,1,4
163832,2023,USA,Korea,0,0,1,1,3/6/2023,0,0,0,0,0,1,0,1,0,0,0,0,0,0,0,0,0,0,0,0
163832,2023,Canada,Korea,0,2,7,9,2/6/2023,0,0,2,2,2,4,9,15,0,0,0,0,0,0,0,0,1,2,2,5
163832,2023,Korea,Türkiye,0,1,12,13,31/05/2023,0,0,3,3,9,5,12,26,1,2,0,3,0,0,0,0,5,5,1,11
168184,2023,Poland,Korea,0,0,0,0,2/7/2023,0,0,0,0,0,0,0,0,0,0,0,0,0,0,0,0,0,0,0,0
168184,2023,Korea,China,0,0,0,0,1/7/2023,0,0,0,0,0,0,0,0,0,0,0,0,0,0,0,0,0,0,0,0
168184,2023,Dominican Republic,Korea,0,0,0,0,29/06/2023,0,0,0,0,0,0,0,0,0,0,0,0,0,0,0,0,0,0,0,0
168184,2023,Bulgaria,Korea,0,3,10,13,27/06/2023,0,0,1,1,0,1,4,5,1,5,7,13,0,0,2,2,0,1,1,2
168184,2023,Germany,Korea,0,0,0,0,18/06/2023,0,0,0,0,0,0,0,0,0,0,0,0,0,0,0,0,0,0,0,0
168184,2023,Korea,Croatia,1,0,11,12,16/06/2023,0,0,2,2,7,2,3,12,2,3,4,9,0,1,0,1,2,0,2,4
168184,2023,Japan,Korea,0,0,6,6,15/06/2023,0,0,1,1,1,1,2,4,2,1,4,7,0,0,1,1,1,1,0,2
168184,2023,Brazil,Korea,0,0,0,0,15/06/2023,0,0,0,0,0,0,0,0,0,0,0,0,0,0,0,0,0,0,0,0
168184,2023,Thailand,Korea,1,1,5,7,4/6/2023,0,0,3,3,5,3,7,15,1,5,5,11,0,0,0,0,0,1,1,2
168184,2023,USA,Korea,0,0,10,10,3/6/2023,0,0,2,2,7,1,2,10,0,2,3,5,0,0,0,0,1,0,0,1
168184,2023,Canada,Korea,0,0,0,0,2/6/2023,0,0,0,0,0,0,0,0,0,0,0,0,0,0,0,0,0,0,0,0
168184,2023,Korea,Türkiye,0,0,4,4,31/05/2023,0,0,1,1,2,0,5,7,0,5,3,8,0,0,0,0,1,1,1,3
135949,2023,Poland,Korea,0,0,0,0,2/7/2023,0,0,0,0,0,0,0,0,0,0,0,0,0,0,0,0,0,0,0,0
135949,2023,Germany,Korea,0,1,3,4,18/06/2023,0,0,0,0,0,0,0,0,0,0,0,0,0,0,2,2,2,0,0,2
135949,2023,Korea,Croatia,0,0,3,3,16/06/2023,0,0,0,0,0,0,0,0,0,0,0,0,0,0,3,3,0,0,0,0
135949,2023,Japan,Korea,0,0,0,0,15/06/2023,0,0,1,1,0,0,0,0,0,0,0,0,1,1,3,5,3,3,1,7
135949,2023,Brazil,Korea,0,0,3,3,15/06/2023,0,0,0,0,0,0,0,0,0,0,0,0,1,0,0,1,0,2,0,2
135949,2023,Thailand,Korea,1,0,3,4,4/6/2023,0,0,0,0,1,2,4,7,0,0,0,0,1,0,7,8,0,1,0,1
135949,2023,USA,Korea,0,0,9,9,3/6/2023,0,1,1,2,6,6,13,25,1,1,3,5,0,3,21,24,10,3,1,14
135949,2023,Canada,Korea,0,1,3,4,2/6/2023,0,0,3,3,8,3,1,12,0,0,1,1,0,1,10,11,2,3,3,8
135949,2023,Korea,Türkiye,0,1,0,1,31/05/2023,0,0,0,0,0,0,0,0,0,0,0,0,0,0,0,0,0,0,0,0
133482,2023,Poland,Korea,0,0,1,1,2/7/2023,0,0,0,0,1,0,1,2,0,0,0,0,0,0,1,1,0,0,0,0
133482,2023,Korea,China,0,0,0,0,1/7/2023,0,0,0,0,0,0,1,1,0,0,1,1,1,0,1,2,0,0,0,0
133482,2023,Dominican Republic,Korea,0,0,2,2,29/06/2023,0,0,0,0,0,1,3,4,0,0,2,2,0,0,3,3,2,0,0,2
133482,2023,Bulgaria,Korea,1,1,5,7,27/06/2023,0,0,0,0,1,2,2,5,0,0,2,2,1,1,5,7,2,1,0,3
133482,2023,Germany,Korea,0,0,0,0,18/06/2023,0,0,0,0,0,0,0,0,0,0,0,0,0,0,0,0,0,0,0,0
133482,2023,Korea,Croatia,1,2,7,10,16/06/2023,0,0,0,0,8,5,13,26,0,2,0,2,7,2,7,16,6,3,2,11
133482,2023,Japan,Korea,0,2,4,6,15/06/2023,0,0,1,1,2,1,7,10,0,2,1,3,3,2,8,13,2,2,2,6
133482,2023,Brazil,Korea,0,0,0,0,15/06/2023,0,0,0,0,0,0,0,0,0,0,0,0,0,0,0,0,0,0,0,0
133482,2023,Thailand,Korea,0,0,6,6,4/6/2023,0,0,0,0,5,6,3,14,0,3,0,3,1,0,14,15,5,1,1,7
133482,2023,USA,Korea,0,2,3,5,3/6/2023,0,0,2,2,9,3,14,26,2,0,0,2,3,2,19,24,8,2,1,11
133482,2023,Canada,Korea,1,0,4,5,2/6/2023,0,0,1,1,4,2,10,16,0,2,0,2,3,0,14,17,3,2,0,5
133482,2023,Korea,Türkiye,0,1,3,4,31/05/2023,0,0,2,2,3,0,2,5,0,0,1,1,0,1,7,8,4,1,1,6
163833,2023,Poland,Korea,0,0,2,2,2/7/2023,0,0,0,0,1,2,1,4,0,0,0,0,0,0,0,0,2,0,0,2
163833,2023,Korea,China,0,0,0,0,1/7/2023,0,0,0,0,0,1,0,1,0,0,0,0,0,0,0,0,1,0,0,1
163833,2023,Dominican Republic,Korea,0,0,0,0,29/06/2023,0,0,0,0,1,0,2,3,0,0,0,0,0,0,0,0,1,0,1,2
163833,2023,Bulgaria,Korea,0,0,0,0,27/06/2023,0,0,0,0,0,2,0,2,0,0,0,0,0,0,0,0,0,1,0,1
163833,2023,Germany,Korea,0,0,0,0,18/06/2023,0,0,0,0,0,0,0,0,0,0,0,0,0,0,0,0,0,0,0,0
163833,2023,Korea,Croatia,0,2,2,4,16/06/2023,0,0,0,0,3,4,7,14,2,0,1,3,0,0,0,0,3,0,0,3
163833,2023,Japan,Korea,0,1,5,6,15/06/2023,0,0,0,0,8,3,10,21,0,0,1,1,0,0,0,0,8,2,0,10
163833,2023,Brazil,Korea,0,0,0,0,15/06/2023,0,0,0,0,2,2,1,5,0,0,0,0,0,0,0,0,0,0,0,0
163833,2023,Thailand,Korea,0,1,4,5,4/6/2023,0,0,2,2,9,2,6,17,0,1,2,3,0,0,0,0,2,2,1,5
163833,2023,USA,Korea,0,3,7,10,3/6/2023,0,0,3,3,6,10,10,26,0,0,0,0,0,0,0,0,7,1,2,10
163833,2023,Canada,Korea,0,1,3,4,2/6/2023,0,0,1,1,2,1,2,5,1,1,0,2,0,0,0,0,1,3,1,5
163833,2023,Korea,Türkiye,0,0,0,0,31/05/2023,0,0,0,0,1,0,0,1,0,0,0,0,0,0,0,0,0,0,0,0
156286,2023,Poland,Korea,3,1,7,11,2/7/2023,0,0,1,1,9,0,8,17,0,0,0,0,6,0,19,25,7,2,0,9
156286,2023,Korea,China,0,0,10,10,1/7/2023,0,0,3,3,12,6,14,32,0,0,0,0,6,1,24,31,8,7,0,15
156286,2023,Dominican Republic,Korea,1,0,8,9,29/06/2023,0,0,4,4,4,5,13,22,1,2,5,8,7,0,11,18,6,0,0,6
156286,2023,Bulgaria,Korea,2,2,11,15,27/06/2023,0,0,4,4,10,4,15,29,0,0,4,4,4,4,34,42,9,1,2,12
156286,2023,Germany,Korea,2,2,10,14,18/06/2023,0,0,4,4,11,7,15,33,2,2,1,5,2,1,15,18,12,2,2,16
156286,2023,Korea,Croatia,2,1,3,6,16/06/2023,0,0,1,1,3,3,8,14,0,0,3,3,1,2,13,16,3,2,1,6
156286,2023,Japan,Korea,0,1,4,5,15/06/2023,0,0,2,2,2,3,7,12,0,1,1,2,1,1,3,5,5,4,0,9
156286,2023,Brazil,Korea,1,1,8,10,15/06/2023,0,0,4,4,8,3,16,27,0,1,0,1,1,0,15,16,6,6,1,13
156286,2023,Thailand,Korea,0,1,2,3,4/6/2023,0,0,0,0,2,2,8,12,0,1,0,1,3,1,8,12,2,1,0,3
156286,2023,USA,Korea,0,0,1,1,3/6/2023,0,0,0,0,1,2,1,4,0,0,0,0,0,0,5,5,2,0,0,2
156286,2023,Canada,Korea,0,1,4,5,2/6/2023,0,0,1,1,3,1,3,7,0,1,0,1,3,0,7,10,1,1,0,2
156286,2023,Korea,Türkiye,1,0,9,10,31/05/2023,0,0,3,3,3,2,7,12,0,1,0,1,2,1,16,19,4,2,2,8
124071,2023,Netherlands,Canada,0,0,1,1,1/7/2023,0,0,5,5,0,0,0,0,0,0,0,0,4,1,14,19,4,4,0,8
124071,2023,Netherlands,Japan,0,0,0,0,30/06/2023,0,0,0,0,0,0,0,0,0,0,0,0,0,0,0,0,1,0,0,1
124071,2023,Croatia,Netherlands,0,0,0,0,29/06/2023,0,0,3,3,0,0,0,0,0,0,0,0,2,0,6,8,13,3,1,17
124071,2023,Thailand,Netherlands,0,0,0,0,27/06/2023,0,0,0,0,0,0,0,0,0,0,0,0,0,0,0,0,0,0,0,0
124071,2023,Bulgaria,Netherlands,0,0,0,0,18/06/2023,0,0,6,6,0,0,0,0,0,0,0,0,3,4,16,23,9,3,1,13
124071,2023,Netherlands,Italy,0,0,0,0,17/06/2023,0,0,0,0,0,0,0,0,0,0,0,0,0,0,0,0,0,0,0,0
124071,2023,Poland,Netherlands,0,0,0,0,16/06/2023,0,0,0,0,0,0,0,0,0,0,0,0,0,0,0,0,0,0,0,0
124071,2023,Netherlands,Türkiye,0,0,0,0,14/06/2023,0,0,11,11,0,0,0,0,0,0,0,0,3,2,14,19,5,8,1,14
124071,2023,China,Netherlands,0,0,0,0,3/6/2023,0,0,0,0,0,0,0,0,0,0,0,0,0,0,0,0,0,0,0,0
124071,2023,Dominican Republic,Netherlands,0,0,0,0,2/6/2023,0,0,7,7,0,0,0,0,0,0,0,0,5,1,28,34,15,0,1,16
124071,2023,Brazil,Netherlands,0,0,0,0,1/6/2023,0,0,4,4,0,0,0,0,0,0,0,0,2,0,6,8,8,2,2,12
124071,2023,Germany,Netherlands,0,0,0,0,30/05/2023,0,0,5,5,0,0,0,0,0,0,0,0,1,2,9,12,7,7,6,20
167778,2023,Netherlands,Canada,0,0,0,0,1/7/2023,0,0,0,0,0,0,0,0,0,0,0,0,0,0,0,0,0,0,0,0
167778,2023,Netherlands,Japan,0,0,0,0,30/06/2023,0,0,0,0,0,0,0,0,0,0,0,0,0,0,0,0,0,0,0,0
167778,2023,Croatia,Netherlands,0,0,0,0,29/06/2023,0,0,2,2,0,0,0,0,0,0,0,0,0,1,2,3,0,0,0,0
167778,2023,Thailand,Netherlands,0,0,0,0,27/06/2023,0,0,0,0,0,0,0,0,0,0,0,0,0,0,0,0,0,0,0,0
167778,2023,China,Netherlands,0,0,0,0,3/6/2023,0,0,0,0,0,0,0,0,0,0,0,0,0,0,0,0,0,0,0,0
167778,2023,Dominican Republic,Netherlands,0,0,0,0,2/6/2023,0,0,0,0,0,0,0,0,0,0,0,0,0,0,1,1,0,0,0,0
167778,2023,Brazil,Netherlands,0,0,0,0,1/6/2023,0,0,0,0,0,0,0,0,0,0,0,0,0,0,0,0,1,0,0,1
167778,2023,Germany,Netherlands,0,2,7,9,30/05/2023,0,0,2,2,5,5,9,19,0,1,0,1,3,1,15,19,7,1,2,10
142880,2023,Netherlands,Canada,0,1,9,10,1/7/2023,0,0,1,1,2,3,6,11,1,5,1,7,0,0,0,0,1,0,0,1
142880,2023,Netherlands,Japan,0,0,12,12,30/06/2023,0,0,3,3,20,3,12,35,4,12,5,21,0,0,0,0,9,3,0,12
142880,2023,Croatia,Netherlands,0,1,5,6,29/06/2023,0,0,1,1,10,0,9,19,3,0,4,7,0,0,0,0,7,0,1,8
142880,2023,Thailand,Netherlands,0,2,10,12,27/06/2023,0,0,0,0,7,1,16,24,2,3,2,7,0,0,0,0,9,1,1,11
142880,2023,Bulgaria,Netherlands,0,1,4,5,18/06/2023,0,0,0,0,9,3,6,18,1,2,4,7,0,0,1,1,3,3,1,7
142880,2023,Netherlands,Italy,0,0,0,0,17/06/2023,0,0,0,0,0,0,0,0,0,0,0,0,0,0,0,0,0,0,0,0
142880,2023,Poland,Netherlands,0,0,0,0,16/06/2023,0,0,0,0,0,0,0,0,0,0,0,0,0,0,0,0,0,0,0,0
142880,2023,Netherlands,Türkiye,0,0,0,0,14/06/2023,0,0,0,0,0,0,0,0,0,0,0,0,0,0,0,0,0,0,0,0
167482,2023,Netherlands,Japan,0,0,0,0,30/06/2023,0,0,0,0,0,0,0,0,0,0,0,0,0,0,0,0,0,0,0,0
167482,2023,Croatia,Netherlands,2,0,9,11,29/06/2023,0,0,1,1,8,1,3,12,2,0,0,2,4,0,12,16,3,1,3,7
167482,2023,Thailand,Netherlands,1,1,8,10,27/06/2023,0,0,0,0,12,1,6,19,2,1,2,5,4,0,23,27,9,3,1,13
167482,2023,Bulgaria,Netherlands,0,0,9,9,18/06/2023,0,0,3,3,7,3,9,19,4,1,2,7,1,0,10,11,3,1,1,5
167482,2023,Netherlands,Italy,1,0,13,14,17/06/2023,0,0,0,0,9,3,7,19,0,2,0,2,5,0,15,20,8,0,1,9
167482,2023,Poland,Netherlands,1,0,14,15,16/06/2023,0,0,1,1,14,3,10,27,2,2,7,11,9,0,13,22,3,4,1,8
167482,2023,Netherlands,Türkiye,0,0,1,1,14/06/2023,0,0,0,0,1,0,0,1,0,0,0,0,1,0,4,5,0,0,0,0
167482,2023,China,Netherlands,1,2,13,16,3/6/2023,0,0,2,2,14,5,12,31,2,0,0,2,6,3,27,36,9,0,2,11
167482,2023,Dominican Republic,Netherlands,1,2,16,19,2/6/2023,0,0,2,2,11,4,12,27,2,1,2,5,11,4,25,40,14,1,4,19
167482,2023,Brazil,Netherlands,1,1,12,14,1/6/2023,0,0,0,0,8,6,12,26,2,0,1,3,3,5,19,27,16,2,1,19
167482,2023,Germany,Netherlands,0,0,10,10,30/05/2023,0,0,1,1,11,3,20,34,2,0,1,3,6,5,28,39,5,1,6,12
151194,2023,Netherlands,Canada,0,0,8,8,1/7/2023,0,0,2,2,6,1,1,8,1,2,7,10,0,0,0,0,3,1,0,4
151194,2023,Netherlands,Japan,0,1,18,19,30/06/2023,0,0,4,4,2,0,3,5,7,4,6,17,0,0,0,0,3,1,1,5
151194,2023,Croatia,Netherlands,0,0,0,0,29/06/2023,0,0,0,0,0,0,0,0,0,0,0,0,0,0,0,0,0,0,0,0
151194,2023,Thailand,Netherlands,1,1,10,12,27/06/2023,0,0,5,5,5,0,6,11,1,2,7,10,0,0,1,1,1,0,1,2
151194,2023,Bulgaria,Netherlands,0,0,10,10,18/06/2023,0,0,1,1,3,0,6,9,5,3,9,17,0,0,0,0,0,0,1,1
151194,2023,Netherlands,Italy,2,0,10,12,17/06/2023,0,0,0,0,3,0,0,3,1,2,4,7,0,0,0,0,3,2,1,6
151194,2023,Poland,Netherlands,0,1,4,5,16/06/2023,0,0,0,0,0,0,0,0,0,0,0,0,0,0,0,0,1,0,0,1
151194,2023,Netherlands,Türkiye,1,0,9,10,14/06/2023,0,0,1,1,2,0,9,11,1,5,4,10,0,0,0,0,2,1,1,4
162356,2023,Netherlands,Canada,0,1,16,17,1/7/2023,16,1,98,115,0,0,0,0,0,5,2,7,0,2,0,2,5,2,2,9
162356,2023,Netherlands,Japan,1,0,4,5,30/06/2023,4,1,29,34,0,0,0,0,0,2,4,6,0,0,0,0,1,1,0,2
162356,2023,Croatia,Netherlands,1,0,10,11,29/06/2023,9,0,49,58,2,1,1,4,0,0,0,0,0,0,0,0,3,1,1,5
162356,2023,Thailand,Netherlands,0,0,0,0,27/06/2023,0,0,0,0,0,0,0,0,0,0,0,0,0,0,0,0,0,0,0,0
162356,2023,Bulgaria,Netherlands,0,0,3,3,18/06/2023,7,1,9,17,0,0,0,0,1,1,1,3,0,0,0,0,0,0,0,0
162356,2023,Netherlands,Italy,0,0,9,9,17/06/2023,11,0,47,58,0,0,1,1,1,0,0,1,0,0,0,0,1,1,0,2
162356,2023,Poland,Netherlands,0,0,0,0,16/06/2023,2,0,5,7,1,0,0,1,0,0,2,2,0,0,0,0,0,0,0,0
162356,2023,Netherlands,Türkiye,0,0,12,12,14/06/2023,18,2,56,76,0,0,1,1,0,3,2,5,0,0,0,0,8,2,1,11
162356,2023,China,Netherlands,0,1,13,14,3/6/2023,6,2,105,113,0,1,0,1,1,2,4,7,0,0,1,1,3,0,1,4
162356,2023,Dominican Republic,Netherlands,1,3,11,15,2/6/2023,5,1,69,75,3,1,1,5,0,2,1,3,0,0,1,1,3,0,0,3
162356,2023,Brazil,Netherlands,1,1,8,10,1/6/2023,4,0,60,64,1,0,0,1,1,2,0,3,0,0,0,0,3,0,1,4
162356,2023,Germany,Netherlands,0,0,4,4,30/05/2023,7,0,43,50,1,0,0,1,0,2,1,3,0,0,0,0,1,0,3,4
147432,2023,Netherlands,Canada,0,0,4,4,1/7/2023,0,1,14,15,0,0,0,0,0,0,0,0,0,0,0,0,0,1,0,1
147432,2023,Netherlands,Japan,0,0,9,9,30/06/2023,21,2,44,67,0,0,0,0,1,3,0,4,0,0,0,0,4,3,0,7
147432,2023,Croatia,Netherlands,0,0,4,4,29/06/2023,2,0,5,7,0,0,0,0,1,0,0,1,0,0,0,0,0,0,0,0
147432,2023,Thailand,Netherlands,4,1,13,18,27/06/2023,26,0,66,92,0,0,3,3,1,3,2,6,0,0,0,0,6,2,0,8
147432,2023,Bulgaria,Netherlands,0,0,11,11,18/06/2023,18,0,27,45,1,0,2,3,2,3,1,6,0,0,0,0,3,3,1,7
147432,2023,Netherlands,Italy,1,1,10,12,17/06/2023,18,0,54,72,0,0,1,1,0,6,2,8,0,0,0,0,3,4,1,8
147432,2023,Poland,Netherlands,0,0,11,11,16/06/2023,22,1,56,79,5,0,2,7,0,2,6,8,0,0,0,0,8,5,0,13
147432,2023,Netherlands,Türkiye,0,1,4,5,14/06/2023,1,0,12,13,0,0,0,0,0,0,0,0,0,0,0,0,2,1,0,3
168148,2023,Netherlands,Canada,2,4,6,12,1/7/2023,0,0,0,0,13,3,3,19,4,5,2,11,0,0,0,0,0,0,0,0
168148,2023,Netherlands,Japan,1,0,10,11,30/06/2023,0,0,0,0,10,1,5,16,0,2,4,6,0,0,0,0,1,2,1,4
168148,2023,Croatia,Netherlands,2,0,8,10,29/06/2023,0,0,0,0,9,0,4,13,5,5,10,20,0,0,1,1,0,1,0,1
168148,2023,Thailand,Netherlands,0,2,5,7,27/06/2023,0,0,1,1,9,2,6,17,4,6,7,17,0,0,0,0,2,0,1,3
168148,2023,Bulgaria,Netherlands,0,1,0,1,18/06/2023,0,0,0,0,2,0,1,3,0,1,0,1,0,0,0,0,0,0,0,0
168148,2023,Netherlands,Italy,0,0,11,11,17/06/2023,0,0,0,0,9,3,5,17,1,4,8,13,0,0,0,0,1,2,0,3
168148,2023,Poland,Netherlands,0,2,5,7,16/06/2023,0,0,0,0,8,1,5,14,2,2,3,7,0,0,1,1,1,0,1,2
168148,2023,Netherlands,Türkiye,0,0,6,6,14/06/2023,0,0,1,1,8,1,2,11,2,2,1,5,0,0,0,0,3,2,1,6
168148,2023,China,Netherlands,0,2,5,7,3/6/2023,0,0,0,0,7,3,4,14,1,0,1,2,0,0,0,0,2,0,0,2
168148,2023,Dominican Republic,Netherlands,0,2,7,9,2/6/2023,0,0,1,1,9,4,8,21,3,5,6,14,0,0,0,0,3,0,2,5
168148,2023,Brazil,Netherlands,0,2,1,3,1/6/2023,0,0,0,0,6,2,4,12,0,0,0,0,0,0,1,1,1,0,0,1
168148,2023,Germany,Netherlands,0,4,5,9,30/05/2023,0,0,1,1,14,3,6,23,3,5,6,14,0,0,1,1,2,1,2,5
181648,2023,Netherlands,Canada,0,0,0,0,1/7/2023,0,0,0,0,0,0,0,0,0,0,0,0,0,0,0,0,0,0,0,0
181648,2023,Netherlands,Japan,0,0,0,0,30/06/2023,0,0,0,0,0,0,0,0,0,0,0,0,0,0,0,0,0,0,0,0
181648,2023,Croatia,Netherlands,0,0,0,0,29/06/2023,0,0,0,0,0,1,3,4,0,0,1,1,0,0,0,0,0,1,0,1
181648,2023,Thailand,Netherlands,0,0,0,0,27/06/2023,0,0,0,0,0,0,0,0,0,0,0,0,0,0,0,0,0,0,0,0
181648,2023,Bulgaria,Netherlands,0,1,0,1,18/06/2023,0,0,0,0,0,0,2,2,0,0,1,1,0,1,0,1,0,1,0,1
181648,2023,Netherlands,Italy,0,0,0,0,17/06/2023,0,0,0,0,0,0,0,0,0,0,0,0,0,0,0,0,0,0,0,0
181648,2023,Poland,Netherlands,0,0,0,0,16/06/2023,0,0,0,0,0,0,0,0,0,0,0,0,0,0,0,0,0,0,0,0
181648,2023,Netherlands,Türkiye,0,1,0,1,14/06/2023,0,0,0,0,1,1,1,3,0,0,0,0,1,0,1,2,0,0,0,0
181648,2023,China,Netherlands,0,0,0,0,3/6/2023,0,0,0,0,0,0,0,0,0,0,0,0,0,0,0,0,0,0,0,0
181648,2023,Dominican Republic,Netherlands,0,0,0,0,2/6/2023,0,0,0,0,0,0,0,0,0,0,0,0,0,0,1,1,1,0,0,1
181648,2023,Brazil,Netherlands,0,0,0,0,1/6/2023,0,0,0,0,0,0,0,0,0,0,0,0,0,1,2,3,0,0,0,0
181648,2023,Germany,Netherlands,0,0,2,2,30/05/2023,0,0,0,0,0,0,1,1,0,0,0,0,0,0,1,1,1,0,2,3
150809,2023,Netherlands,Canada,1,3,12,16,1/7/2023,0,0,2,2,13,9,15,37,3,4,3,10,10,0,23,33,8,4,2,14
150809,2023,Netherlands,Japan,0,2,10,12,30/06/2023,0,0,2,2,12,2,13,27,4,3,3,10,9,4,31,44,11,5,4,20
150809,2023,Croatia,Netherlands,0,0,0,0,29/06/2023,0,0,0,0,0,0,0,0,0,0,0,0,0,0,0,0,0,0,0,0
150809,2023,Thailand,Netherlands,1,2,11,14,27/06/2023,0,0,0,0,9,3,20,32,1,4,4,9,2,0,13,15,10,3,0,13
150809,2023,Bulgaria,Netherlands,0,0,0,0,18/06/2023,0,0,0,0,0,0,0,0,0,0,0,0,0,0,0,0,0,0,0,0
150809,2023,Netherlands,Italy,2,2,11,15,17/06/2023,0,0,3,3,19,6,13,38,1,7,4,12,3,0,24,27,12,3,3,18
150809,2023,Poland,Netherlands,0,1,11,12,16/06/2023,0,0,2,2,13,2,10,25,0,1,1,2,5,1,14,20,4,3,0,7
150809,2023,Netherlands,Türkiye,1,0,11,12,14/06/2023,0,0,1,1,11,7,11,29,0,3,2,5,2,2,24,28,4,1,0,5
172894,2023,Netherlands,Canada,0,1,4,5,1/7/2023,0,0,0,0,2,2,5,9,2,2,3,7,0,0,1,1,3,0,0,3
172894,2023,Netherlands,Japan,1,0,2,3,30/06/2023,0,0,0,0,0,0,0,0,0,0,0,0,0,0,0,0,0,1,0,1
172894,2023,Croatia,Netherlands,1,1,18,20,29/06/2023,0,0,1,1,4,2,1,7,2,2,9,13,0,0,0,0,3,1,0,4
172894,2023,Thailand,Netherlands,0,0,4,4,27/06/2023,0,0,0,0,0,0,0,0,0,1,0,1,0,0,0,0,0,0,0,0
172894,2023,Bulgaria,Netherlands,3,0,19,22,18/06/2023,0,0,1,1,1,0,1,2,3,2,2,7,0,0,0,0,4,1,0,5
172894,2023,Netherlands,Italy,1,0,8,9,17/06/2023,0,0,0,0,4,1,4,9,1,9,3,13,0,0,1,1,1,1,0,2
172894,2023,Poland,Netherlands,0,1,6,7,16/06/2023,0,0,0,0,6,0,3,9,0,6,4,10,1,0,0,1,2,1,1,4
172894,2023,Netherlands,Türkiye,0,1,0,1,14/06/2023,0,0,0,0,0,0,0,0,0,0,1,1,0,0,0,0,0,0,0,0
172894,2023,China,Netherlands,0,1,15,16,3/6/2023,0,0,2,2,7,0,7,14,0,0,1,1,0,0,0,0,4,0,0,4
172894,2023,Dominican Republic,Netherlands,2,2,17,21,2/6/2023,0,0,0,0,3,1,4,8,1,5,8,14,0,0,2,2,7,0,2,9
172894,2023,Brazil,Netherlands,0,1,11,12,1/6/2023,0,0,1,1,2,3,4,9,1,1,2,4,0,0,0,0,1,0,0,1
172894,2023,Germany,Netherlands,1,3,10,14,30/05/2023,0,0,1,1,10,0,4,14,2,5,8,15,1,0,0,1,3,1,3,7
148581,2023,Netherlands,Canada,0,0,0,0,1/7/2023,0,0,6,6,0,0,0,0,0,0,0,0,4,1,5,10,9,4,0,13
148581,2023,Netherlands,Japan,0,0,0,0,30/06/2023,0,0,7,7,0,0,0,0,0,0,0,0,3,0,4,7,12,8,4,24
148581,2023,Croatia,Netherlands,0,0,0,0,29/06/2023,0,0,0,0,0,0,0,0,0,0,0,0,0,0,0,0,0,0,0,0
148581,2023,Thailand,Netherlands,0,0,0,0,27/06/2023,0,0,6,6,0,0,0,0,0,0,0,0,7,0,6,13,10,7,1,18
148581,2023,Bulgaria,Netherlands,0,0,0,0,18/06/2023,0,0,0,0,0,0,0,0,0,0,0,0,0,0,0,0,0,0,0,0
148581,2023,Netherlands,Italy,0,0,0,0,17/06/2023,0,0,8,8,0,0,0,0,0,0,0,0,14,2,22,38,8,9,5,22
148581,2023,Poland,Netherlands,0,0,0,0,16/06/2023,0,0,6,6,0,0,0,0,0,0,0,0,5,1,9,15,13,9,4,26
148581,2023,Netherlands,Türkiye,0,0,0,0,14/06/2023,0,0,0,0,0,0,0,0,0,0,0,0,0,0,0,0,0,0,0,0
148581,2023,China,Netherlands,0,0,0,0,3/6/2023,0,0,8,8,0,0,0,0,0,0,0,0,4,2,8,14,9,2,2,13
148581,2023,Dominican Republic,Netherlands,0,0,0,0,2/6/2023,0,0,0,0,0,0,0,0,0,0,0,0,0,0,0,0,1,0,0,1
148581,2023,Brazil,Netherlands,0,0,0,0,1/6/2023,0,0,0,0,0,0,0,0,0,0,0,0,0,1,1,2,0,0,0,0
148581,2023,Germany,Netherlands,0,0,0,0,30/05/2023,0,0,0,0,0,0,0,0,0,0,0,0,0,0,0,0,0,0,0,0
162372,2023,Netherlands,Canada,0,2,7,9,1/7/2023,0,0,1,1,5,4,11,20,1,0,3,4,0,0,0,0,8,0,0,8
162372,2023,Netherlands,Japan,0,0,0,0,30/06/2023,0,0,0,0,0,0,0,0,0,0,0,0,0,0,0,0,0,0,0,0
162372,2023,Croatia,Netherlands,0,0,0,0,29/06/2023,0,0,0,0,0,1,1,2,0,0,0,0,0,0,0,0,0,0,0,0
162372,2023,Thailand,Netherlands,0,0,0,0,27/06/2023,0,0,0,0,0,0,0,0,0,0,0,0,0,0,0,0,0,0,0,0
162372,2023,Bulgaria,Netherlands,0,0,5,5,18/06/2023,0,0,0,0,2,2,2,6,0,2,0,2,0,0,0,0,1,1,0,2
162372,2023,Netherlands,Italy,0,0,1,1,17/06/2023,0,0,0,0,4,1,0,5,0,3,0,3,0,0,0,0,0,0,0,0
162372,2023,Poland,Netherlands,0,0,1,1,16/06/2023,0,0,0,0,1,0,1,2,0,1,0,1,0,0,0,0,1,1,1,3
162372,2023,Netherlands,Türkiye,0,0,1,1,14/06/2023,0,0,0,0,4,2,3,9,1,1,1,3,0,0,0,0,1,0,0,1
164777,2023,Netherlands,Canada,0,3,16,19,1/7/2023,0,0,2,2,15,7,25,47,2,0,0,2,6,1,26,33,11,1,0,12
164777,2023,Netherlands,Japan,1,4,20,25,30/06/2023,0,0,1,1,10,5,13,28,1,0,3,4,4,2,16,22,6,1,3,10
164777,2023,Croatia,Netherlands,0,1,11,12,29/06/2023,0,0,1,1,7,2,8,17,1,4,1,6,1,1,14,16,3,6,1,10
164777,2023,Thailand,Netherlands,0,0,0,0,27/06/2023,0,0,0,0,0,0,0,0,0,0,0,0,0,0,0,0,0,0,0,0
164777,2023,Bulgaria,Netherlands,0,1,7,8,18/06/2023,0,0,2,2,7,1,9,17,0,3,1,4,2,0,7,9,12,2,2,16
164777,2023,Netherlands,Italy,1,3,6,10,17/06/2023,0,0,0,0,9,3,5,17,0,2,0,2,3,2,9,14,4,0,1,5
164777,2023,Poland,Netherlands,0,0,1,1,16/06/2023,0,0,0,0,0,0,0,0,0,0,0,0,0,0,0,0,0,0,0,0
164777,2023,Netherlands,Türkiye,0,1,11,12,14/06/2023,0,0,0,0,10,3,12,25,1,3,0,4,5,0,13,18,9,3,2,14
164777,2023,China,Netherlands,4,3,20,27,3/6/2023,0,0,1,1,17,4,8,29,0,1,1,2,8,1,28,37,12,0,4,16
164777,2023,Dominican Republic,Netherlands,2,3,11,16,2/6/2023,0,0,5,5,13,8,20,41,1,2,3,6,6,1,11,18,13,1,2,16
164777,2023,Brazil,Netherlands,1,0,8,9,1/6/2023,0,0,0,0,8,4,15,27,0,0,0,0,2,0,22,24,6,0,0,6
164777,2023,Germany,Netherlands,2,2,9,13,30/05/2023,0,0,1,1,8,1,7,16,0,0,1,1,2,1,10,13,1,0,1,2
152233,2023,Poland,USA,0,0,0,0,16/07/2023,0,1,15,16,0,0,0,0,0,0,0,0,12,0,12,24,17,4,0,21
152233,2023,Poland,China,0,0,0,0,15/07/2023,0,0,12,12,0,0,0,0,0,0,0,0,6,0,16,22,8,2,1,11
152233,2023,Poland,Germany,0,0,0,0,12/7/2023,0,0,15,15,0,0,0,0,0,0,0,0,3,1,9,13,15,4,1,20
152233,2023,Poland,Korea,0,0,0,0,2/7/2023,0,0,0,0,0,0,0,0,0,0,0,0,0,0,0,0,0,0,0,0
152233,2023,Bulgaria,Poland,0,0,0,0,30/06/2023,0,0,12,12,0,0,0,0,0,0,0,0,3,2,10,15,10,1,0,11
152233,2023,Poland,Germany,0,0,0,0,29/06/2023,0,2,11,13,0,0,0,0,0,0,0,0,8,0,11,19,15,9,2,26
152233,2023,USA,Poland,0,0,0,0,28/06/2023,0,0,19,19,0,0,0,0,0,0,0,0,9,0,17,26,18,8,2,28
152233,2023,Poland,China,0,0,0,0,17/06/2023,0,0,7,7,0,0,0,0,0,0,0,0,6,0,9,15,10,3,0,13
152233,2023,Poland,Netherlands,0,0,0,0,16/06/2023,0,0,11,11,0,0,0,0,0,0,0,0,3,0,14,17,12,2,3,17
152233,2023,Poland,Türkiye,0,0,0,0,15/06/2023,0,0,8,8,0,0,0,0,0,0,0,0,4,1,12,17,9,1,1,11
152233,2023,Dominican Republic,Poland,0,0,0,0,13/06/2023,0,0,9,9,0,0,0,0,0,0,0,0,11,1,14,26,12,7,1,20
152233,2023,Poland,Serbia,0,0,0,0,3/6/2023,0,0,8,8,0,0,0,0,0,0,0,0,6,1,10,17,8,2,2,12
152233,2023,Thailand,Poland,0,0,0,0,2/6/2023,0,0,5,5,0,0,0,0,0,0,0,0,3,0,6,9,9,3,1,13
152233,2023,Poland,Italy,0,0,0,0,1/6/2023,0,0,12,12,0,0,0,0,0,0,0,0,2,2,16,20,16,2,0,18
152233,2023,Poland,Canada,0,0,0,0,30/05/2023,1,0,19,20,0,0,0,0,0,0,0,0,7,1,17,25,16,3,3,22
136317,2023,Poland,USA,1,2,10,13,16/07/2023,0,0,3,3,9,2,3,14,3,8,2,13,0,0,0,0,3,2,1,6
136317,2023,Poland,China,2,2,5,9,15/07/2023,0,0,0,0,9,2,3,14,2,3,3,8,0,0,0,0,0,0,1,1
136317,2023,Poland,Germany,0,3,11,14,12/7/2023,0,0,1,1,8,1,2,11,0,4,5,9,0,0,0,0,1,1,0,2
136317,2023,Poland,Korea,1,1,12,14,2/7/2023,0,0,4,4,5,1,0,6,3,6,3,12,0,0,0,0,1,1,0,2
136317,2023,Bulgaria,Poland,0,2,12,14,30/06/2023,0,0,1,1,8,1,3,12,3,5,6,14,0,0,0,0,1,3,2,6
136317,2023,Poland,Germany,0,0,12,12,29/06/2023,0,0,1,1,10,2,7,19,5,7,2,14,0,0,0,0,2,1,0,3
136317,2023,USA,Poland,1,3,13,17,28/06/2023,0,0,5,5,12,0,8,20,5,3,5,13,0,0,0,0,4,2,1,7
136317,2023,Poland,China,1,0,12,13,17/06/2023,0,0,5,5,6,0,1,7,3,7,6,16,0,0,0,0,2,2,0,4
136317,2023,Poland,Netherlands,0,1,6,7,16/06/2023,0,1,0,1,5,2,4,11,0,2,8,10,0,0,0,0,2,3,0,5
136317,2023,Poland,Türkiye,2,2,14,18,15/06/2023,0,1,1,2,7,0,4,11,4,5,7,16,0,0,0,0,2,0,1,3
136317,2023,Dominican Republic,Poland,1,2,18,21,13/06/2023,0,0,2,2,6,0,11,17,4,5,3,12,0,0,0,0,3,0,2,5
136317,2023,Poland,Serbia,0,1,12,13,3/6/2023,0,0,4,4,6,1,4,11,7,2,9,18,0,0,0,0,5,1,3,9
136317,2023,Thailand,Poland,2,1,19,22,2/6/2023,0,0,4,4,6,3,0,9,1,1,3,5,0,0,0,0,0,0,0,0
136317,2023,Poland,Italy,2,0,16,18,1/6/2023,0,0,3,3,7,0,6,13,4,7,8,19,0,0,0,0,2,0,1,3
136317,2023,Poland,Canada,0,1,23,24,30/05/2023,0,0,6,6,11,1,7,19,4,10,7,21,0,0,0,0,4,2,0,6
143465,2023,Poland,USA,0,0,2,2,16/07/2023,0,0,1,1,3,2,3,8,0,2,0,2,0,0,0,0,1,0,0,1
143465,2023,Poland,China,1,0,2,3,15/07/2023,0,0,0,0,1,1,3,5,0,0,0,0,0,0,0,0,2,1,0,3
143465,2023,Poland,Germany,0,0,0,0,12/7/2023,0,0,0,0,0,0,1,1,0,0,0,0,0,0,0,0,0,0,0,0
143465,2023,Poland,Korea,0,0,0,0,2/7/2023,0,0,1,1,3,0,2,5,1,0,1,2,0,0,0,0,0,0,0,0
143465,2023,Bulgaria,Poland,1,0,3,4,30/06/2023,0,0,1,1,2,1,3,6,0,1,1,2,0,0,0,0,0,0,0,0
143465,2023,Poland,Germany,0,1,0,1,29/06/2023,0,0,0,0,4,0,3,7,0,0,2,2,0,0,0,0,2,0,1,3
143465,2023,USA,Poland,0,0,0,0,28/06/2023,0,0,0,0,0,2,3,5,0,0,1,1,0,0,0,0,1,0,0,1
143465,2023,Poland,China,0,0,0,0,17/06/2023,0,0,0,0,2,0,2,4,0,1,1,2,0,0,0,0,1,0,0,1
143465,2023,Poland,Netherlands,0,0,1,1,16/06/2023,0,0,0,0,2,1,1,4,0,1,0,1,0,0,0,0,1,0,0,1
143465,2023,Poland,Türkiye,0,0,0,0,15/06/2023,0,0,0,0,4,0,1,5,0,2,1,3,0,0,1,1,0,0,0,0
143465,2023,Dominican Republic,Poland,0,0,0,0,13/06/2023,0,0,0,0,2,1,3,6,1,1,1,3,0,0,0,0,0,1,0,1
143465,2023,Poland,Serbia,0,0,0,0,3/6/2023,0,0,0,0,0,0,2,2,0,0,0,0,0,0,0,0,0,0,0,0
143465,2023,Thailand,Poland,0,0,2,2,2/6/2023,0,0,0,0,2,0,2,4,1,1,1,3,0,0,0,0,0,1,0,1
143465,2023,Poland,Italy,0,0,0,0,1/6/2023,0,0,0,0,0,0,0,0,0,0,0,0,0,0,0,0,0,0,0,0
143465,2023,Poland,Canada,0,0,4,4,30/05/2023,0,0,0,0,1,2,6,9,1,2,1,4,0,0,0,0,1,0,0,1
152217,2023,Poland,USA,2,3,12,17,16/07/2023,0,0,3,3,20,13,20,53,1,1,7,9,0,0,0,0,10,2,1,13
152217,2023,Poland,China,0,3,5,8,15/07/2023,0,0,0,0,15,5,14,34,0,4,3,7,0,0,0,0,4,1,1,6
152217,2023,Poland,Germany,1,2,13,16,12/7/2023,0,0,2,2,17,4,17,38,0,4,2,6,0,0,0,0,21,1,0,22
152217,2023,Poland,Korea,0,3,2,5,2/7/2023,0,0,0,0,13,3,10,26,3,5,5,13,0,0,0,0,6,3,2,11
152217,2023,Bulgaria,Poland,0,3,14,17,30/06/2023,0,0,3,3,14,5,8,27,5,4,5,14,0,0,0,0,16,2,2,20
152217,2023,Poland,Germany,1,3,13,17,29/06/2023,0,0,2,2,19,8,16,43,2,2,3,7,0,0,0,0,9,2,1,12
152217,2023,USA,Poland,1,5,13,19,28/06/2023,0,0,2,2,24,6,20,50,3,4,4,11,0,0,0,0,7,6,0,13
152217,2023,Poland,China,0,2,4,6,17/06/2023,0,0,1,1,19,5,11,35,1,0,5,6,0,0,0,0,7,2,0,9
152217,2023,Poland,Netherlands,1,1,8,10,16/06/2023,0,0,1,1,15,2,12,29,2,0,0,2,0,0,0,0,7,4,2,13
152217,2023,Poland,Türkiye,0,1,5,6,15/06/2023,0,0,2,2,15,5,10,30,2,2,3,7,0,0,0,0,6,9,1,16
152217,2023,Dominican Republic,Poland,0,5,12,17,13/06/2023,0,0,1,1,24,5,20,49,4,2,0,6,0,0,0,0,11,4,1,16
152217,2023,Poland,Serbia,0,4,4,8,3/6/2023,0,0,3,3,17,10,11,38,3,1,1,5,0,0,0,0,6,3,2,11
152217,2023,Thailand,Poland,0,1,4,5,2/6/2023,0,0,0,0,9,4,9,22,0,1,1,2,0,0,0,0,3,1,3,7
152217,2023,Poland,Italy,0,2,9,11,1/6/2023,0,0,0,0,22,8,19,49,2,3,4,9,0,0,0,0,7,1,0,8
152217,2023,Poland,Canada,1,1,12,14,30/05/2023,0,1,0,1,15,10,25,50,5,2,3,10,0,0,0,0,7,1,1,9
152231,2023,Poland,USA,1,1,1,3,16/07/2023,0,0,0,0,0,1,1,2,0,0,0,0,0,0,3,3,2,1,0,3
152231,2023,Poland,China,0,0,1,1,15/07/2023,0,0,0,0,0,0,0,0,0,0,0,0,0,0,0,0,0,0,0,0
152231,2023,Poland,Germany,0,0,3,3,12/7/2023,0,0,0,0,0,0,0,0,0,0,0,0,1,1,2,4,0,2,0,2
152231,2023,Poland,Korea,0,1,0,1,2/7/2023,0,0,0,0,0,0,0,0,0,0,0,0,0,0,1,1,2,0,0,2
152231,2023,Bulgaria,Poland,1,0,1,2,30/06/2023,0,0,1,1,0,0,0,0,0,0,0,0,0,0,4,4,0,0,0,0
152231,2023,Poland,Germany,0,0,0,0,29/06/2023,0,0,0,0,0,0,0,0,0,0,0,0,0,0,0,0,0,0,0,0
152231,2023,USA,Poland,0,1,0,1,28/06/2023,0,0,0,0,0,0,0,0,0,1,1,2,1,0,5,6,0,1,0,1
152231,2023,Poland,China,0,1,1,2,17/06/2023,0,0,1,1,0,0,0,0,0,0,0,0,0,0,0,0,0,0,0,0
152231,2023,Poland,Netherlands,0,0,7,7,16/06/2023,0,0,1,1,4,2,4,10,0,1,0,1,2,0,9,11,4,2,0,6
152231,2023,Poland,Türkiye,0,1,6,7,15/06/2023,0,0,0,0,0,0,0,0,0,0,0,0,1,2,1,4,0,1,0,1
152231,2023,Dominican Republic,Poland,0,0,3,3,13/06/2023,0,0,0,0,0,0,0,0,0,0,0,0,0,0,0,0,0,1,1,2
152231,2023,Poland,Serbia,0,0,1,1,3/6/2023,0,0,0,0,2,0,0,2,0,0,0,0,1,0,1,2,0,1,0,1
152231,2023,Thailand,Poland,0,1,1,2,2/6/2023,0,0,0,0,1,2,1,4,2,0,0,2,0,0,1,1,1,0,0,1
152231,2023,Poland,Italy,0,0,0,0,1/6/2023,0,0,0,0,0,0,0,0,0,0,0,0,0,0,0,0,0,0,0,0
152231,2023,Poland,Canada,0,0,1,1,30/05/2023,0,0,0,0,0,0,0,0,0,0,0,0,0,1,1,2,0,0,0,0
163098,2023,Poland,USA,1,3,14,18,16/07/2023,0,0,4,4,12,4,17,33,1,0,6,7,5,2,16,23,6,3,3,12
163098,2023,Poland,China,1,3,10,14,15/07/2023,0,0,2,2,8,1,9,18,0,1,0,1,8,1,18,27,3,1,1,5
163098,2023,Poland,Germany,0,0,27,27,12/7/2023,0,0,5,5,15,2,12,29,0,6,2,8,9,3,24,36,8,5,1,14
163098,2023,Poland,Korea,0,0,0,0,2/7/2023,0,0,0,0,0,0,0,0,0,0,0,0,0,0,0,0,0,0,0,0
163098,2023,Bulgaria,Poland,0,0,4,4,30/06/2023,0,1,2,3,2,2,11,15,0,1,0,1,1,1,11,13,0,0,0,0
163098,2023,Poland,Germany,0,0,3,3,29/06/2023,0,0,2,2,5,1,4,10,0,0,1,1,6,2,14,22,2,4,0,6
163098,2023,USA,Poland,0,0,16,16,28/06/2023,0,0,6,6,13,3,21,37,3,1,5,9,17,2,32,51,5,3,1,9
163098,2023,Poland,China,0,1,9,10,17/06/2023,0,0,1,1,10,1,8,19,3,2,0,5,3,2,17,22,6,1,0,7
163098,2023,Poland,Netherlands,0,0,0,0,16/06/2023,0,0,1,1,0,1,5,6,0,1,0,1,0,0,1,1,1,0,1,2
163098,2023,Poland,Türkiye,0,1,9,10,15/06/2023,0,0,3,3,11,2,9,22,0,3,3,6,11,0,13,24,6,1,1,8
163098,2023,Dominican Republic,Poland,2,2,16,20,13/06/2023,0,0,4,4,7,3,5,15,1,6,3,10,10,1,19,30,6,4,1,11
163098,2023,Poland,Serbia,1,0,11,12,3/6/2023,0,0,2,2,10,2,11,23,0,1,2,3,1,1,5,7,7,4,1,12
163098,2023,Thailand,Poland,2,0,12,14,2/6/2023,0,0,2,2,7,1,12,20,2,2,1,5,2,0,12,14,8,1,1,10
163098,2023,Poland,Italy,0,2,9,11,1/6/2023,0,0,1,1,10,5,13,28,3,1,3,7,12,2,17,31,10,4,0,14
163098,2023,Poland,Canada,0,1,5,6,30/05/2023,0,0,4,4,10,5,14,29,0,1,2,3,2,0,13,15,10,3,3,16
185609,2023,Poland,USA,0,0,0,0,16/07/2023,0,0,1,1,0,0,0,0,0,0,0,0,1,0,2,3,0,0,0,0
185609,2023,Poland,China,0,0,0,0,15/07/2023,0,0,0,0,0,0,0,0,0,0,0,0,0,0,0,0,0,0,0,0
185609,2023,Poland,Germany,0,0,0,0,12/7/2023,0,0,0,0,0,0,0,0,0,0,0,0,0,0,0,0,0,0,0,0
185609,2023,Poland,Korea,0,0,0,0,2/7/2023,0,0,7,7,0,0,0,0,0,0,0,0,5,0,9,14,5,2,0,7
185609,2023,Bulgaria,Poland,0,0,0,0,30/06/2023,0,0,1,1,0,0,0,0,0,0,0,0,0,0,0,0,2,0,0,2
185609,2023,Poland,Germany,0,0,0,0,29/06/2023,0,0,0,0,0,0,0,0,0,0,0,0,2,0,1,3,2,0,0,2
185609,2023,USA,Poland,0,0,0,0,28/06/2023,0,0,0,0,0,0,0,0,0,0,0,0,0,0,0,0,0,0,0,0
185609,2023,Poland,China,0,0,0,0,17/06/2023,0,0,1,1,0,0,0,0,0,0,0,0,0,0,1,1,0,0,0,0
185609,2023,Poland,Netherlands,0,0,0,0,16/06/2023,0,0,0,0,0,0,0,0,0,0,0,0,2,1,1,4,1,0,0,1
185609,2023,Poland,Türkiye,0,0,0,0,15/06/2023,0,0,0,0,0,0,0,0,0,0,0,0,0,0,0,0,0,0,0,0
185609,2023,Dominican Republic,Poland,0,0,0,0,13/06/2023,0,0,0,0,0,0,0,0,0,0,0,0,0,0,1,1,0,0,0,0
185609,2023,Poland,Serbia,0,0,0,0,3/6/2023,0,0,0,0,0,0,0,0,0,0,0,0,1,0,1,2,0,0,0,0
185609,2023,Thailand,Poland,0,0,0,0,2/6/2023,0,0,0,0,0,0,0,0,0,0,0,0,0,0,0,0,0,0,0,0
185609,2023,Poland,Italy,0,0,0,0,1/6/2023,0,0,2,2,0,0,0,0,0,0,0,0,0,0,1,1,0,1,0,1
185609,2023,Poland,Canada,0,0,0,0,30/05/2023,0,0,1,1,0,0,0,0,0,0,0,0,2,0,4,6,0,1,0,1
181268,2023,Poland,USA,0,0,0,0,16/07/2023,0,0,0,0,0,0,0,0,0,0,0,0,0,0,0,0,0,0,0,0
181268,2023,Poland,China,0,3,7,10,15/07/2023,0,0,0,0,5,1,7,13,0,1,3,4,3,0,11,14,3,0,0,3
181268,2023,Poland,Germany,0,0,1,1,12/7/2023,0,0,2,2,2,2,2,6,1,0,0,1,0,0,1,1,0,1,1,2
181268,2023,Poland,Korea,0,1,14,15,2/7/2023,0,0,3,3,7,4,7,18,1,1,1,3,2,2,7,11,8,1,1,10
181268,2023,Bulgaria,Poland,1,1,5,7,30/06/2023,0,0,1,1,11,1,6,18,2,1,0,3,1,0,8,9,8,1,1,10
181268,2023,Poland,Germany,3,3,7,13,29/06/2023,0,0,2,2,6,5,13,24,1,1,1,3,7,1,14,22,7,1,6,14
181268,2023,USA,Poland,1,2,6,9,28/06/2023,0,0,3,3,9,3,9,21,0,2,0,2,2,0,2,4,8,2,0,10
181268,2023,Poland,China,0,0,1,1,17/06/2023,0,0,0,0,0,0,0,0,0,0,0,0,1,0,1,2,0,0,0,0
181268,2023,Poland,Netherlands,0,1,2,3,16/06/2023,0,0,1,1,4,0,5,9,1,0,1,2,0,0,3,3,3,1,0,4
181268,2023,Poland,Türkiye,0,0,0,0,15/06/2023,0,0,0,0,0,0,0,0,0,0,0,0,0,0,0,0,0,0,0,0
181268,2023,Dominican Republic,Poland,0,1,0,1,13/06/2023,0,0,0,0,0,0,0,0,0,0,0,0,0,0,0,0,0,0,0,0
181268,2023,Poland,Serbia,0,2,4,6,3/6/2023,0,0,0,0,0,0,4,4,1,1,0,2,4,0,5,9,3,1,1,5
181268,2023,Thailand,Poland,0,0,0,0,2/6/2023,0,0,0,0,0,0,0,0,0,0,0,0,0,0,0,0,0,0,0,0
181268,2023,Poland,Italy,1,3,12,16,1/6/2023,0,0,2,2,6,4,7,17,1,3,1,5,0,0,8,8,5,1,0,6
181268,2023,Poland,Canada,1,0,2,3,30/05/2023,0,0,0,0,4,1,5,10,0,0,0,0,1,0,2,3,2,1,0,3
181963,2023,Poland,USA,0,0,0,0,16/07/2023,0,0,0,0,0,0,0,0,0,0,0,0,0,0,0,0,0,0,0,0
181963,2023,Poland,China,0,0,0,0,15/07/2023,0,0,0,0,0,0,0,0,0,0,0,0,0,0,0,0,0,0,0,0
181963,2023,Poland,Germany,0,0,0,0,12/7/2023,0,0,0,0,0,0,0,0,0,0,0,0,0,0,0,0,0,0,0,0
181963,2023,Poland,Korea,0,0,0,0,2/7/2023,0,0,0,0,0,0,0,0,0,0,0,0,0,0,0,0,0,0,0,0
181963,2023,Bulgaria,Poland,0,0,0,0,30/06/2023,0,0,0,0,0,0,0,0,0,0,0,0,0,0,0,0,0,0,0,0
181963,2023,Poland,Germany,0,0,0,0,29/06/2023,0,0,0,0,0,0,0,0,0,0,0,0,0,0,0,0,0,0,0,0
181963,2023,USA,Poland,0,0,0,0,28/06/2023,0,0,0,0,0,0,0,0,0,0,0,0,0,0,0,0,0,0,0,0
181963,2023,Poland,China,0,0,0,0,17/06/2023,0,0,0,0,0,0,0,0,0,0,0,0,0,0,0,0,0,0,0,0
181963,2023,Poland,Netherlands,0,0,0,0,16/06/2023,0,0,0,0,0,0,0,0,0,0,0,0,0,0,0,0,0,0,0,0
181963,2023,Poland,Türkiye,0,0,0,0,15/06/2023,0,0,0,0,0,0,0,0,0,0,0,0,0,0,0,0,0,0,0,0
181963,2023,Dominican Republic,Poland,0,0,0,0,13/06/2023,0,0,0,0,0,0,0,0,0,0,0,0,0,0,0,0,0,0,0,0
181263,2023,Poland,USA,1,2,15,18,16/07/2023,9,1,78,88,1,0,0,1,1,3,4,8,0,0,0,0,10,3,0,13
181263,2023,Poland,China,0,0,10,10,15/07/2023,15,0,60,75,0,0,0,0,0,2,0,2,0,0,0,0,3,1,1,5
181263,2023,Poland,Germany,0,1,11,12,12/7/2023,18,1,87,106,1,0,2,3,2,4,3,9,0,0,0,0,10,2,0,12
181263,2023,Poland,Korea,1,0,4,5,2/7/2023,1,0,9,10,0,0,0,0,0,0,0,0,0,0,0,0,1,0,0,1
181263,2023,Bulgaria,Poland,0,3,14,17,30/06/2023,25,0,60,85,0,0,2,2,0,4,4,8,0,0,0,0,11,4,1,16
181263,2023,Poland,Germany,0,0,12,12,29/06/2023,25,0,83,108,0,0,1,1,0,2,3,5,0,0,0,0,6,3,2,11
181263,2023,USA,Poland,0,0,22,22,28/06/2023,22,1,101,124,0,0,2,2,2,8,4,14,0,0,0,0,12,4,2,18
181263,2023,Poland,China,0,1,12,13,17/06/2023,12,0,59,71,0,0,1,1,0,2,1,3,0,0,0,0,9,6,1,16
181263,2023,Poland,Netherlands,0,2,11,13,16/06/2023,11,0,46,57,0,0,1,1,0,2,1,3,0,0,0,0,4,1,0,5
181263,2023,Poland,Türkiye,0,1,12,13,15/06/2023,15,0,56,71,0,0,0,0,0,2,1,3,0,0,0,0,4,3,5,12
181263,2023,Dominican Republic,Poland,0,1,11,12,13/06/2023,27,2,73,102,1,0,0,1,0,1,4,5,0,0,1,1,7,5,1,13
181263,2023,Poland,Serbia,1,0,19,20,3/6/2023,2,1,80,83,1,0,0,1,2,2,1,5,0,0,0,0,6,4,4,14
181263,2023,Thailand,Poland,1,0,6,7,2/6/2023,8,0,56,64,0,0,0,0,1,1,1,3,0,0,0,0,6,3,1,10
181263,2023,Poland,Italy,2,0,22,24,1/6/2023,13,0,84,97,1,0,0,1,0,0,0,0,0,0,0,0,11,5,3,19
181263,2023,Poland,Canada,0,2,15,17,30/05/2023,27,1,103,131,1,0,3,4,1,5,5,11,0,0,0,0,13,3,0,16
143460,2023,Poland,USA,0,0,0,0,16/07/2023,0,0,0,0,0,0,0,0,0,0,0,0,0,0,0,0,0,0,0,0
143460,2023,Poland,China,0,0,0,0,15/07/2023,0,0,0,0,0,0,0,0,2,0,1,3,0,0,0,0,0,0,0,0
143460,2023,Poland,Germany,0,0,9,9,12/7/2023,0,1,0,1,3,0,4,7,6,2,5,13,0,0,1,1,1,2,0,3
143460,2023,Poland,Korea,0,0,2,2,2/7/2023,0,0,0,0,3,0,1,4,1,2,2,5,0,0,0,0,0,0,0,0
143460,2023,Bulgaria,Poland,0,0,0,0,30/06/2023,0,0,0,0,2,0,0,2,0,0,1,1,0,0,0,0,0,0,0,0
143460,2023,Poland,Germany,0,0,4,4,29/06/2023,0,0,0,0,2,0,1,3,0,0,0,0,0,0,1,1,1,0,0,1
143460,2023,USA,Poland,0,0,0,0,28/06/2023,0,0,0,0,0,0,0,0,0,0,0,0,0,0,0,0,0,0,0,0
143460,2023,Poland,China,0,0,0,0,17/06/2023,0,0,0,0,0,0,0,0,0,0,0,0,0,0,0,0,0,0,0,0
143460,2023,Poland,Netherlands,0,0,1,1,16/06/2023,0,0,1,1,1,1,0,2,0,1,0,1,0,0,0,0,0,1,0,1
143460,2023,Poland,Türkiye,0,0,0,0,15/06/2023,0,0,0,0,0,0,0,0,0,0,0,0,0,0,0,0,0,0,0,0
143460,2023,Dominican Republic,Poland,0,0,0,0,13/06/2023,0,0,0,0,0,0,0,0,0,0,0,0,0,0,0,0,0,0,0,0
143460,2023,Poland,Serbia,0,0,1,1,3/6/2023,0,0,0,0,1,0,1,2,0,2,1,3,0,0,0,0,0,0,0,0
143460,2023,Thailand,Poland,0,0,0,0,2/6/2023,0,0,0,0,2,0,0,2,0,1,1,2,0,0,0,0,0,0,1,1
143460,2023,Poland,Italy,0,0,0,0,1/6/2023,0,0,0,0,0,0,0,0,0,0,0,0,0,0,0,0,0,0,0,0
143460,2023,Poland,Canada,0,0,0,0,30/05/2023,0,0,0,0,0,0,0,0,0,0,0,0,0,0,0,0,0,0,0,0
151231,2023,Poland,USA,1,2,12,15,16/07/2023,0,0,3,3,10,3,15,28,3,4,5,12,3,3,30,36,10,3,0,13
151231,2023,Poland,China,0,1,1,2,15/07/2023,0,0,0,0,2,3,3,8,0,0,0,0,1,0,7,8,1,0,0,1
151231,2023,Poland,Germany,1,1,9,11,12/7/2023,0,0,3,3,16,1,18,35,1,0,1,2,2,1,15,18,8,3,0,11
151231,2023,Poland,Korea,0,1,9,10,2/7/2023,0,0,0,0,6,2,7,15,1,1,1,3,6,5,13,24,6,0,0,6
151231,2023,Bulgaria,Poland,1,4,10,15,30/06/2023,0,0,3,3,13,1,10,24,2,0,9,11,1,2,28,31,3,4,0,7
151231,2023,Poland,Germany,0,4,18,22,29/06/2023,0,0,3,3,11,1,18,30,1,6,3,10,5,1,23,29,8,5,0,13
151231,2023,USA,Poland,0,5,5,10,28/06/2023,0,0,3,3,8,3,14,25,0,3,5,8,2,2,14,18,3,1,1,5
151231,2023,Poland,China,1,2,13,16,17/06/2023,0,0,1,1,9,4,13,26,0,3,2,5,1,1,18,20,4,3,0,7
151231,2023,Poland,Netherlands,0,5,7,12,16/06/2023,0,0,1,1,14,0,16,30,0,4,4,8,4,0,27,31,6,3,1,10
151231,2023,Poland,Türkiye,1,2,7,10,15/06/2023,0,0,3,3,8,3,10,21,0,4,0,4,1,1,16,18,6,2,0,8
151231,2023,Dominican Republic,Poland,0,6,7,13,13/06/2023,0,0,2,2,17,4,14,35,2,4,2,8,5,1,14,20,5,3,0,8
151231,2023,Poland,Serbia,0,3,7,10,3/6/2023,0,0,2,2,3,2,11,16,1,1,2,4,3,1,17,21,6,3,2,11
151231,2023,Thailand,Poland,1,2,8,11,2/6/2023,0,0,0,0,6,3,7,16,0,1,1,2,1,0,20,21,11,2,1,14
151231,2023,Poland,Italy,0,0,3,3,1/6/2023,0,0,1,1,2,1,4,7,0,2,3,5,0,1,1,2,0,1,0,1
151231,2023,Poland,Canada,1,3,15,19,30/05/2023,0,0,1,1,16,6,24,46,1,2,4,7,3,1,41,45,9,2,1,12
152216,2023,Poland,USA,0,0,1,1,16/07/2023,3,0,27,30,0,0,0,0,0,0,1,1,0,0,0,0,3,1,1,5
152216,2023,Poland,China,0,0,1,1,15/07/2023,4,0,6,10,0,0,0,0,0,1,0,1,0,0,0,0,0,0,0,0
152216,2023,Poland,Germany,0,0,1,1,12/7/2023,0,0,1,1,0,0,0,0,0,0,0,0,0,0,0,0,0,0,0,0
152216,2023,Poland,Korea,1,1,12,14,2/7/2023,12,0,44,56,1,0,1,2,1,3,3,7,0,0,0,0,5,3,0,8
152216,2023,Bulgaria,Poland,0,0,4,4,30/06/2023,3,1,7,11,1,0,0,1,0,1,1,2,0,0,0,0,2,0,0,2
152216,2023,Poland,Germany,0,0,3,3,29/06/2023,2,0,17,19,0,0,0,0,0,0,0,0,0,0,0,0,1,1,0,2
152216,2023,USA,Poland,0,0,1,1,28/06/2023,3,0,7,10,0,0,0,0,0,0,0,0,0,0,0,0,0,0,0,0
152216,2023,Poland,China,0,0,3,3,17/06/2023,1,0,7,8,0,0,0,0,0,0,0,0,0,0,0,0,1,1,0,2
152216,2023,Poland,Netherlands,0,0,7,7,16/06/2023,5,0,29,34,0,1,0,1,0,0,1,1,0,0,0,0,2,2,2,6
152216,2023,Poland,Türkiye,1,0,2,3,15/06/2023,1,0,5,6,0,0,0,0,0,0,0,0,0,0,0,0,2,1,0,3
152216,2023,Dominican Republic,Poland,0,0,2,2,13/06/2023,5,0,5,10,0,0,0,0,0,0,0,0,0,0,0,0,0,1,1,2
152216,2023,Poland,Serbia,0,0,1,1,3/6/2023,0,1,2,3,0,0,0,0,0,0,0,0,0,0,0,0,0,1,0,1
152216,2023,Thailand,Poland,0,0,3,3,2/6/2023,0,0,13,13,0,0,0,0,0,0,0,0,0,0,0,0,0,0,0,0
152216,2023,Poland,Italy,0,0,1,1,1/6/2023,0,0,1,1,0,0,0,0,0,0,0,0,0,0,0,0,0,0,0,0
152216,2023,Poland,Canada,0,0,0,0,30/05/2023,0,0,3,3,0,0,0,0,0,0,0,0,0,0,0,0,0,0,0,0
185611,2023,Poland,USA,0,1,12,13,16/07/2023,0,0,8,8,8,3,3,14,2,2,3,7,0,0,0,0,3,0,0,3
185611,2023,Poland,China,0,1,6,7,15/07/2023,0,0,0,0,7,0,3,10,1,5,2,8,0,0,0,0,1,0,0,1
185611,2023,Poland,Germany,0,0,2,2,12/7/2023,0,0,1,1,2,0,4,6,0,2,2,4,0,0,0,0,3,0,0,3
185611,2023,Poland,Korea,0,0,8,8,2/7/2023,0,0,0,0,3,0,1,4,2,1,5,8,0,0,0,0,4,1,0,5
185611,2023,Bulgaria,Poland,2,0,14,16,30/06/2023,0,0,1,1,5,1,5,11,1,7,4,12,0,0,0,0,2,0,0,2
185611,2023,Poland,Germany,0,0,14,14,29/06/2023,0,0,5,5,10,2,4,16,1,5,2,8,0,0,0,0,4,2,0,6
185611,2023,USA,Poland,1,0,14,15,28/06/2023,0,0,2,2,6,1,2,9,1,6,9,16,0,0,0,0,3,1,0,4
185611,2023,Poland,China,0,0,10,10,17/06/2023,0,0,3,3,5,0,2,7,1,3,0,4,0,0,0,0,2,3,0,5
185611,2023,Poland,Netherlands,1,1,7,9,16/06/2023,0,0,0,0,5,0,0,5,0,5,1,6,0,0,0,0,0,2,1,3
185611,2023,Poland,Türkiye,0,0,11,11,15/06/2023,0,0,2,2,7,0,1,8,0,1,4,5,0,0,0,0,1,1,0,2
185611,2023,Dominican Republic,Poland,0,1,12,13,13/06/2023,0,0,2,2,4,1,5,10,2,3,6,11,0,0,1,1,2,0,0,2
185611,2023,Poland,Serbia,0,0,9,9,3/6/2023,0,0,2,2,4,0,1,5,2,2,3,7,0,0,0,0,0,1,0,1
185611,2023,Thailand,Poland,0,1,7,8,2/6/2023,0,0,0,0,7,1,4,12,2,3,4,9,0,0,0,0,2,0,2,4
185611,2023,Poland,Italy,1,0,10,11,1/6/2023,0,0,0,0,4,0,2,6,3,5,5,13,0,0,2,2,6,0,0,6
185611,2023,Poland,Canada,1,2,14,17,30/05/2023,0,0,2,2,5,0,6,11,1,4,7,12,0,0,0,0,6,2,0,8
136024,2023,Serbia,Bulgaria,2,0,4,6,2/7/2023,0,0,0,0,3,0,4,7,0,4,1,5,1,0,12,13,3,0,1,4
136024,2023,Serbia,Dominican Republic,0,1,8,9,1/7/2023,0,0,1,1,3,1,6,10,0,1,2,3,3,2,21,26,3,1,0,4
136024,2023,Germany,Serbia,0,4,13,17,30/06/2023,0,0,4,4,7,3,6,16,0,1,0,1,7,3,17,27,10,2,2,14
136024,2023,China,Serbia,2,2,14,18,28/06/2023,0,0,2,2,8,5,7,20,0,0,1,1,7,1,13,21,12,0,0,12
136024,2023,Serbia,Croatia,0,1,16,17,18/06/2023,0,0,2,2,13,5,15,33,1,1,3,5,4,1,19,24,16,5,0,21
136024,2023,Serbia,Thailand,1,3,12,16,17/06/2023,0,0,2,2,13,2,19,34,1,2,1,4,5,0,21,26,14,3,3,20
136024,2023,Brazil,Serbia,2,2,6,10,16/06/2023,0,1,3,4,5,3,4,12,0,1,1,2,7,0,23,30,7,5,0,12
136024,2023,Japan,Serbia,0,0,0,0,14/06/2023,0,0,0,0,0,0,0,0,0,0,0,0,0,0,0,0,0,0,0,0
136024,2023,Canada,Serbia,0,2,11,13,4/6/2023,0,0,1,1,3,5,9,17,0,1,0,1,10,2,18,30,6,1,3,10
136024,2023,Poland,Serbia,0,0,3,3,3/6/2023,0,0,3,3,0,5,1,6,0,1,1,2,2,0,3,5,0,0,1,1
136024,2023,Türkiye,Serbia,0,1,13,14,1/6/2023,0,0,2,2,5,3,11,19,0,2,0,2,1,0,12,13,3,4,1,8
136024,2023,Serbia,USA,1,1,15,17,31/05/2023,0,0,2,2,14,4,10,28,0,3,0,3,10,2,26,38,10,5,2,17
152168,2023,Serbia,Bulgaria,0,1,6,7,2/7/2023,0,0,2,2,2,4,6,12,2,1,1,4,4,1,8,13,12,2,1,15
152168,2023,Serbia,Dominican Republic,0,0,4,4,1/7/2023,0,0,0,0,2,1,5,8,0,1,0,1,1,0,5,6,1,1,0,2
152168,2023,Germany,Serbia,0,0,1,1,30/06/2023,0,0,0,0,0,0,0,0,0,0,0,0,0,0,0,0,0,0,0,0
152168,2023,China,Serbia,0,0,0,0,28/06/2023,0,0,0,0,0,0,0,0,0,0,0,0,0,0,0,0,0,0,0,0
152168,2023,Serbia,Croatia,0,0,0,0,18/06/2023,0,0,0,0,0,0,0,0,0,0,0,0,0,0,3,3,5,0,1,6
152168,2023,Serbia,Thailand,0,0,7,7,17/06/2023,0,0,2,2,1,0,3,4,0,0,0,0,2,1,10,13,0,2,0,2
152168,2023,Brazil,Serbia,0,1,9,10,16/06/2023,0,0,2,2,3,1,7,11,0,1,2,3,5,0,14,19,7,4,1,12
152168,2023,Japan,Serbia,0,2,19,21,14/06/2023,0,0,2,2,13,5,12,30,3,0,6,9,6,2,27,35,17,10,2,29
152168,2023,Canada,Serbia,0,0,8,8,4/6/2023,0,0,1,1,3,1,6,10,0,2,2,4,8,0,16,24,7,3,1,11
152168,2023,Poland,Serbia,0,1,3,4,3/6/2023,0,0,0,0,8,0,3,11,0,0,0,0,0,0,9,9,5,0,0,5
152168,2023,Türkiye,Serbia,0,0,0,0,1/6/2023,0,0,0,0,0,0,0,0,0,0,0,0,0,0,0,0,0,0,0,0
152168,2023,Serbia,USA,0,0,5,5,31/05/2023,0,0,0,0,0,0,0,0,0,0,0,0,0,0,0,0,0,0,0,0
120326,2023,Serbia,Bulgaria,2,2,12,16,2/7/2023,22,1,73,96,2,0,1,3,0,3,2,5,0,0,0,0,7,2,2,11
120326,2023,Serbia,Dominican Republic,0,1,7,8,1/7/2023,6,0,29,35,0,0,0,0,0,1,2,3,0,0,0,0,7,1,1,9
120326,2023,Germany,Serbia,0,0,1,1,30/06/2023,1,0,8,9,0,0,0,0,0,0,0,0,0,0,0,0,1,1,0,2
120326,2023,China,Serbia,0,0,0,0,28/06/2023,0,0,2,2,0,0,0,0,0,0,0,0,0,0,0,0,0,1,0,1
120326,2023,Canada,Serbia,0,0,17,17,4/6/2023,11,1,106,118,1,2,2,5,1,5,3,9,0,0,0,0,11,6,0,17
120326,2023,Poland,Serbia,0,3,7,10,3/6/2023,3,0,71,74,1,1,0,2,0,1,2,3,0,0,0,0,3,4,2,9
120326,2023,Türkiye,Serbia,0,2,9,11,1/6/2023,8,1,78,87,4,0,1,5,2,1,2,5,0,0,0,0,6,4,1,11
120326,2023,Serbia,USA,0,2,14,16,31/05/2023,21,0,97,118,3,1,2,6,0,1,2,3,0,0,0,0,11,7,2,20
136030,2023,Serbia,Bulgaria,0,0,2,2,2/7/2023,0,0,0,0,1,0,0,1,0,3,1,4,0,0,0,0,1,0,1,2
136030,2023,Serbia,Dominican Republic,0,2,8,10,1/7/2023,0,0,1,1,8,1,6,15,2,7,8,17,0,0,0,0,3,1,0,4
136030,2023,Germany,Serbia,2,1,15,18,30/06/2023,0,0,0,0,7,1,5,13,0,6,9,15,0,0,1,1,1,0,1,2
136030,2023,China,Serbia,2,1,6,9,28/06/2023,0,0,0,0,8,1,3,12,3,0,0,3,0,0,3,3,2,2,1,5
136030,2023,Canada,Serbia,1,1,16,18,4/6/2023,0,1,1,2,6,0,4,10,3,10,8,21,0,1,0,1,2,3,0,5
136030,2023,Poland,Serbia,1,0,8,9,3/6/2023,0,0,1,1,2,1,3,6,1,7,5,13,0,0,1,1,1,1,0,2
136030,2023,Türkiye,Serbia,0,1,10,11,1/6/2023,0,0,1,1,3,1,2,6,1,3,5,9,0,0,1,1,1,1,1,3
136030,2023,Serbia,USA,0,2,14,16,31/05/2023,0,0,2,2,5,1,5,11,3,5,3,11,1,0,1,2,0,0,1,1
181204,2023,Serbia,Bulgaria,0,0,0,0,2/7/2023,0,0,0,0,0,3,3,6,1,2,0,3,0,0,1,1,0,1,0,1
181204,2023,Serbia,Dominican Republic,0,1,10,11,1/7/2023,0,1,2,3,8,3,18,29,2,3,2,7,3,1,8,12,5,3,1,9
181204,2023,Germany,Serbia,0,1,5,6,30/06/2023,0,0,1,1,8,1,14,23,1,3,0,4,1,0,7,8,6,1,3,10
181204,2023,China,Serbia,0,0,0,0,28/06/2023,0,0,1,1,1,0,2,3,0,0,0,0,0,0,0,0,0,0,0,0
181204,2023,Serbia,Croatia,0,0,0,0,18/06/2023,0,0,0,0,0,0,0,0,0,0,0,0,0,0,0,0,0,0,0,0
181204,2023,Serbia,Thailand,0,1,2,3,17/06/2023,0,0,4,4,12,7,8,27,0,2,0,2,0,0,2,2,2,2,0,4
181204,2023,Brazil,Serbia,0,4,2,6,16/06/2023,0,1,4,5,16,7,17,40,1,0,0,1,1,0,5,6,4,2,0,6
181204,2023,Japan,Serbia,0,2,7,9,14/06/2023,0,0,1,1,21,4,21,46,2,0,3,5,4,2,6,12,9,4,0,13
181204,2023,Canada,Serbia,1,1,4,6,4/6/2023,0,0,1,1,16,4,17,37,1,0,2,3,1,0,5,6,4,0,1,5
181204,2023,Poland,Serbia,1,3,7,11,3/6/2023,0,0,1,1,9,8,13,30,1,1,0,2,3,0,10,13,5,2,1,8
181204,2023,Türkiye,Serbia,0,2,1,3,1/6/2023,0,0,2,2,12,2,8,22,1,1,0,2,3,1,14,18,2,1,2,5
181204,2023,Serbia,USA,0,1,2,3,31/05/2023,0,0,0,0,4,3,3,10,0,0,2,2,0,0,1,1,2,0,0,2
116216,2023,Serbia,Bulgaria,1,0,2,3,2/7/2023,8,0,17,25,0,0,0,0,0,0,1,1,0,0,0,0,2,0,1,3
116216,2023,Serbia,Dominican Republic,1,0,11,12,1/7/2023,29,1,68,98,0,0,1,1,2,7,4,13,0,0,0,0,8,0,0,8
116216,2023,Germany,Serbia,0,1,23,24,30/06/2023,20,1,82,103,2,0,1,3,0,3,0,3,0,0,0,0,5,2,1,8
116216,2023,China,Serbia,1,2,13,16,28/06/2023,25,2,76,103,2,0,2,4,0,7,4,11,0,0,0,0,6,3,1,10
123709,2023,Serbia,Bulgaria,0,0,0,0,2/7/2023,0,0,3,3,0,0,0,0,0,0,0,0,1,1,4,6,4,0,0,4
123709,2023,Serbia,Dominican Republic,0,0,0,0,1/7/2023,0,0,15,15,0,0,0,0,0,0,0,0,8,2,15,25,11,3,4,18
123709,2023,Germany,Serbia,0,0,0,0,30/06/2023,0,0,13,13,0,0,0,0,0,0,0,0,6,1,10,17,11,5,1,17
123709,2023,China,Serbia,0,0,0,0,28/06/2023,0,0,7,7,0,0,0,0,0,0,0,0,8,0,12,20,10,6,3,19
123709,2023,Serbia,Croatia,0,0,0,0,18/06/2023,0,1,13,14,0,0,0,0,0,0,0,0,6,0,13,19,22,6,1,29
123709,2023,Serbia,Thailand,0,0,0,0,17/06/2023,0,0,7,7,0,0,0,0,0,0,0,0,6,0,13,19,24,6,3,33
123709,2023,Brazil,Serbia,0,0,0,0,16/06/2023,0,0,6,6,0,0,0,0,0,0,0,0,1,0,12,13,13,8,2,23
123709,2023,Japan,Serbia,0,0,0,0,14/06/2023,0,0,0,0,0,0,0,0,0,0,0,0,0,0,0,0,0,0,0,0
123709,2023,Canada,Serbia,0,0,0,0,4/6/2023,0,1,23,24,0,0,0,0,0,0,0,0,6,0,9,15,14,4,5,23
123709,2023,Poland,Serbia,0,0,0,0,3/6/2023,0,0,9,9,0,0,0,0,0,0,0,0,5,0,15,20,11,2,3,16
123709,2023,Türkiye,Serbia,0,0,0,0,1/6/2023,0,1,12,13,0,0,0,0,0,0,0,0,4,3,18,25,10,4,3,17
123709,2023,Serbia,USA,0,0,0,0,31/05/2023,0,0,11,11,0,0,0,0,0,0,0,0,1,0,13,14,14,5,3,22
123694,2023,Serbia,Bulgaria,1,2,9,12,2/7/2023,0,0,1,1,9,3,10,22,0,2,6,8,0,0,0,0,10,0,1,11
123694,2023,Serbia,Dominican Republic,0,0,2,2,1/7/2023,0,0,0,0,2,1,5,8,0,1,1,2,0,0,0,0,3,0,0,3
123694,2023,Germany,Serbia,0,1,0,1,30/06/2023,0,0,0,0,3,0,1,4,0,0,1,1,0,0,0,0,1,0,0,1
123694,2023,China,Serbia,0,0,0,0,28/06/2023,0,0,0,0,0,0,1,1,0,1,0,1,0,0,0,0,0,0,0,0
123694,2023,Serbia,Croatia,5,1,24,30,18/06/2023,0,0,3,3,15,5,16,36,1,2,7,10,0,0,0,0,5,2,0,7
123694,2023,Serbia,Thailand,0,0,14,14,17/06/2023,0,0,6,6,16,6,19,41,2,4,4,10,0,0,0,0,16,0,2,18
123694,2023,Brazil,Serbia,0,3,6,9,16/06/2023,0,0,1,1,5,10,14,29,2,3,2,7,0,0,0,0,7,3,0,10
123694,2023,Japan,Serbia,0,2,16,18,14/06/2023,0,0,2,2,10,4,24,38,3,4,9,16,0,0,0,0,7,6,0,13
123694,2023,Canada,Serbia,3,2,15,20,4/6/2023,0,0,4,4,13,5,14,32,2,3,9,14,0,0,0,0,10,8,1,19
123694,2023,Poland,Serbia,0,2,4,6,3/6/2023,0,0,2,2,9,4,15,28,0,4,7,11,0,0,0,0,4,1,1,6
123694,2023,Türkiye,Serbia,0,2,11,13,1/6/2023,0,0,2,2,9,4,15,28,1,3,2,6,0,0,0,0,8,1,1,10
123694,2023,Serbia,USA,2,2,11,15,31/05/2023,0,0,1,1,17,5,21,43,0,5,1,6,0,0,0,0,5,2,1,8
143548,2023,Serbia,Bulgaria,1,1,15,17,2/7/2023,0,0,4,4,9,4,7,20,5,3,13,21,0,0,0,0,1,0,1,2
143548,2023,Serbia,Dominican Republic,0,0,1,1,1/7/2023,0,0,0,0,0,0,1,1,0,1,0,1,0,0,0,0,0,0,0,0
143548,2023,Germany,Serbia,0,0,0,0,30/06/2023,0,0,0,0,0,0,0,0,0,0,0,0,0,0,0,0,0,0,0,0
143548,2023,China,Serbia,0,0,3,3,28/06/2023,0,0,0,0,0,0,0,0,0,2,0,2,1,0,1,2,0,0,1,1
143548,2023,Serbia,Croatia,0,2,9,11,18/06/2023,0,0,4,4,2,1,4,7,0,2,1,3,0,0,0,0,4,1,1,6
143548,2023,Serbia,Thailand,0,1,13,14,17/06/2023,0,0,5,5,6,2,9,17,2,5,9,16,0,0,0,0,6,1,1,8
143548,2023,Brazil,Serbia,0,2,20,22,16/06/2023,0,0,3,3,6,2,4,12,6,4,4,14,0,0,0,0,3,0,1,4
143548,2023,Japan,Serbia,2,1,12,15,14/06/2023,0,0,4,4,2,3,4,9,4,8,10,22,0,0,0,0,5,2,1,8
143548,2023,Canada,Serbia,0,0,18,18,4/6/2023,0,0,2,2,10,4,3,17,2,3,18,23,0,0,0,0,2,2,0,4
143548,2023,Poland,Serbia,0,1,12,13,3/6/2023,0,0,2,2,3,0,6,9,0,5,5,10,0,0,0,0,2,0,2,4
143548,2023,Türkiye,Serbia,1,2,12,15,1/6/2023,0,0,3,3,3,2,7,12,4,8,2,14,0,0,0,0,1,1,0,2
143548,2023,Serbia,USA,2,2,11,15,31/05/2023,0,0,4,4,9,4,4,17,2,10,9,21,0,0,0,0,5,2,2,9
123700,2023,Serbia,Bulgaria,1,1,9,11,2/7/2023,0,0,0,0,6,5,3,14,1,3,5,9,0,0,0,0,2,1,1,4
123700,2023,Serbia,Dominican Republic,0,1,13,14,1/7/2023,0,0,0,0,3,2,3,8,2,4,6,12,0,0,0,0,2,4,0,6
123700,2023,Germany,Serbia,0,2,11,13,30/06/2023,0,0,1,1,7,3,5,15,2,6,6,14,0,0,1,1,4,2,2,8
123700,2023,China,Serbia,2,0,17,19,28/06/2023,0,0,3,3,10,0,6,16,1,2,0,3,0,0,0,0,3,1,0,4
123700,2023,Serbia,Croatia,0,0,7,7,18/06/2023,0,0,1,1,5,0,4,9,5,5,3,13,0,0,0,0,5,1,0,6
123700,2023,Serbia,Thailand,0,2,13,15,17/06/2023,0,0,2,2,4,1,8,13,5,4,6,15,0,0,0,0,11,2,2,15
123700,2023,Brazil,Serbia,2,1,9,12,16/06/2023,0,0,1,1,7,1,5,13,4,7,4,15,0,0,0,0,5,1,2,8
123700,2023,Japan,Serbia,1,1,14,16,14/06/2023,0,0,1,1,10,2,7,19,2,5,9,16,2,0,3,5,6,2,0,8
170965,2023,Serbia,Bulgaria,0,0,0,0,2/7/2023,0,0,5,5,0,0,0,0,0,0,0,0,4,3,16,23,10,1,2,13
170965,2023,Serbia,Dominican Republic,0,0,0,0,1/7/2023,0,0,0,0,0,0,0,0,0,0,0,0,0,0,0,0,0,0,0,0
170965,2023,Germany,Serbia,0,0,0,0,30/06/2023,0,0,0,0,0,0,0,0,0,0,0,0,0,0,0,0,0,0,0,0
170965,2023,China,Serbia,0,0,0,0,28/06/2023,0,0,0,0,0,0,0,0,0,0,0,0,0,0,0,0,0,0,0,0
170965,2023,Serbia,Croatia,0,0,0,0,18/06/2023,0,0,0,0,0,0,0,0,0,0,0,0,0,0,0,0,0,0,0,0
170965,2023,Serbia,Thailand,0,0,0,0,17/06/2023,0,0,0,0,0,0,0,0,0,0,0,0,0,0,0,0,0,0,0,0
170965,2023,Brazil,Serbia,0,0,0,0,16/06/2023,0,0,3,3,0,0,0,0,0,0,0,0,2,1,4,7,8,3,0,11
170965,2023,Japan,Serbia,0,0,0,0,14/06/2023,0,0,13,13,0,0,0,0,0,0,0,0,5,0,16,21,15,10,1,26
170965,2023,Canada,Serbia,0,0,0,0,4/6/2023,0,0,0,0,0,0,0,0,0,0,0,0,0,0,0,0,0,0,0,0
170965,2023,Poland,Serbia,0,0,0,0,3/6/2023,0,0,0,0,0,0,0,0,0,0,0,0,0,0,0,0,0,0,0,0
170965,2023,Türkiye,Serbia,0,0,0,0,1/6/2023,0,0,0,0,0,0,0,0,0,0,0,0,0,0,0,0,0,0,0,0
170965,2023,Serbia,USA,0,0,0,0,31/05/2023,0,0,0,0,0,0,0,0,0,0,0,0,0,0,0,0,0,0,0,0
137941,2023,Serbia,Bulgaria,1,0,9,10,2/7/2023,0,1,0,1,12,1,9,22,1,0,2,3,0,0,0,0,1,0,1,2
137941,2023,Serbia,Dominican Republic,1,1,12,14,1/7/2023,0,0,2,2,27,10,12,49,3,5,4,12,0,0,0,0,12,5,2,19
137941,2023,Germany,Serbia,1,1,14,16,30/06/2023,0,0,3,3,34,4,12,50,4,2,3,9,0,0,0,0,14,1,1,16
137941,2023,China,Serbia,1,1,7,9,28/06/2023,0,0,3,3,24,5,15,44,0,2,2,4,0,0,0,0,10,5,2,17
142478,2023,Serbia,Bulgaria,0,0,0,0,2/7/2023,0,0,0,0,0,0,0,0,0,0,0,0,0,1,3,4,1,0,1,2
142478,2023,Serbia,Dominican Republic,0,0,3,3,1/7/2023,0,1,0,1,2,1,4,7,1,0,1,2,3,0,11,14,5,2,1,8
142478,2023,Germany,Serbia,0,0,0,0,30/06/2023,0,0,1,1,0,0,0,0,0,0,0,0,0,0,9,9,3,0,0,3
142478,2023,China,Serbia,0,0,0,0,28/06/2023,0,0,0,0,0,0,0,0,0,0,0,0,1,1,4,6,0,0,0,0
142478,2023,Serbia,Croatia,0,0,0,0,18/06/2023,0,0,0,0,0,0,0,0,0,0,0,0,0,0,0,0,0,0,0,0
142478,2023,Serbia,Thailand,0,0,3,3,17/06/2023,0,0,0,0,0,0,0,0,0,1,0,1,0,0,2,2,1,1,0,2
142478,2023,Brazil,Serbia,0,0,1,1,16/06/2023,0,0,0,0,0,1,2,3,0,0,0,0,0,0,10,10,0,1,0,1
142478,2023,Japan,Serbia,0,0,0,0,14/06/2023,0,0,2,2,0,0,4,4,0,0,0,0,2,1,5,8,1,0,2,3
142478,2023,Canada,Serbia,0,0,2,2,4/6/2023,0,0,0,0,0,0,0,0,0,0,0,0,0,0,0,0,0,0,0,0
142478,2023,Poland,Serbia,0,0,1,1,3/6/2023,0,0,0,0,0,0,1,1,0,0,0,0,0,1,3,4,0,1,1,2
142478,2023,Türkiye,Serbia,0,1,1,2,1/6/2023,0,0,1,1,4,0,0,4,0,1,0,1,0,1,7,8,1,0,0,1
142478,2023,Serbia,USA,0,0,1,1,31/05/2023,0,0,0,0,0,0,0,0,0,0,0,0,0,0,4,4,1,0,0,1
142479,2023,Serbia,Bulgaria,0,1,16,17,2/7/2023,0,0,2,2,17,4,13,34,0,2,4,6,4,2,14,20,10,1,1,12
142479,2023,Serbia,Dominican Republic,0,0,6,6,1/7/2023,0,0,2,2,6,4,6,16,1,1,1,3,3,0,11,14,5,2,1,8
142479,2023,Germany,Serbia,0,2,3,5,30/06/2023,0,0,0,0,4,3,4,11,0,0,2,2,1,1,12,14,3,0,0,3
142479,2023,China,Serbia,1,1,15,17,28/06/2023,0,0,2,2,8,2,8,18,2,3,4,9,9,1,14,24,4,3,0,7
142479,2023,Serbia,Croatia,3,1,14,18,18/06/2023,0,0,4,4,21,1,16,38,2,2,4,8,3,0,12,15,7,3,0,10
142479,2023,Serbia,Thailand,1,2,15,18,17/06/2023,0,0,5,5,18,5,15,38,3,3,5,11,9,1,16,26,11,7,0,18
142479,2023,Brazil,Serbia,0,1,8,9,16/06/2023,0,0,3,3,13,8,11,32,0,0,0,0,7,1,7,15,3,1,1,5
142479,2023,Japan,Serbia,1,0,5,6,14/06/2023,0,0,0,0,1,0,6,7,0,0,0,0,0,1,6,7,0,0,0,0
142479,2023,Canada,Serbia,0,0,10,10,4/6/2023,0,0,2,2,16,5,11,32,0,1,3,4,0,1,13,14,12,2,0,14
142479,2023,Poland,Serbia,0,1,6,7,3/6/2023,0,0,0,0,5,4,5,14,1,3,1,5,0,1,17,18,0,0,0,0
142479,2023,Türkiye,Serbia,0,2,9,11,1/6/2023,0,0,4,4,12,3,10,25,0,2,0,2,1,3,18,22,5,1,0,6
142479,2023,Serbia,USA,1,0,14,15,31/05/2023,0,0,2,2,9,5,17,31,2,2,4,8,5,3,24,32,4,2,1,7
151120,2023,Thailand,Brazil,0,0,2,2,2/7/2023,0,0,2,2,1,0,0,1,0,1,0,1,0,1,4,5,1,0,0,1
151120,2023,Thailand,Japan,0,0,0,0,1/7/2023,0,0,0,0,0,0,0,0,0,0,0,0,0,0,0,0,0,0,0,0
151120,2023,Thailand,Türkiye,0,0,1,1,29/06/2023,0,0,0,0,0,0,0,0,0,0,0,0,1,1,6,8,0,0,0,0
151120,2023,Thailand,Netherlands,0,0,4,4,27/06/2023,0,1,2,3,7,5,7,19,0,1,2,3,1,2,8,11,3,2,2,7
151120,2023,Thailand,Croatia,0,1,3,4,18/06/2023,0,0,1,1,1,1,5,7,0,4,1,5,1,4,13,18,2,1,0,3
151120,2023,Serbia,Thailand,0,0,4,4,17/06/2023,0,0,1,1,0,0,0,0,0,0,0,0,0,0,0,0,1,0,0,1
151120,2023,Thailand,USA,0,0,5,5,15/06/2023,0,0,2,2,4,3,4,11,0,3,0,3,1,0,9,10,3,2,2,7
151120,2023,Germany,Thailand,1,3,10,14,14/06/2023,0,0,0,0,6,5,12,23,0,2,0,2,6,0,17,23,7,3,1,11
151120,2023,Thailand,Korea,0,0,6,6,4/6/2023,0,0,1,1,4,0,4,8,1,0,2,3,0,1,8,9,6,2,0,8
151120,2023,Thailand,Poland,0,1,3,4,2/6/2023,0,0,2,2,6,3,10,19,1,0,0,1,4,1,5,10,2,4,1,7
151120,2023,Canada,Thailand,1,1,11,13,1/6/2023,0,0,3,3,16,7,15,38,1,1,0,2,3,1,7,11,12,3,1,16
151120,2023,Italy,Thailand,0,0,4,4,30/05/2023,0,0,0,0,0,0,1,1,0,0,0,0,0,0,1,1,0,0,0,0
123019,2023,Thailand,Brazil,0,0,1,1,2/7/2023,3,1,9,13,0,0,1,1,0,0,1,1,0,0,0,0,0,0,0,0
123019,2023,Thailand,Japan,0,2,7,9,1/7/2023,17,0,53,70,0,0,2,2,0,2,3,5,0,0,1,1,6,1,0,7
123019,2023,Thailand,Türkiye,0,1,6,7,29/06/2023,8,0,69,77,0,0,1,1,0,2,0,2,0,0,0,0,4,0,2,6
123019,2023,Thailand,Netherlands,0,0,10,10,27/06/2023,22,2,62,86,1,0,0,1,0,1,1,2,0,0,0,0,9,5,3,17
123019,2023,Thailand,Croatia,0,0,9,9,18/06/2023,17,0,43,60,1,0,3,4,0,3,1,4,0,0,0,0,6,1,1,8
123019,2023,Serbia,Thailand,0,0,8,8,17/06/2023,14,2,65,81,0,0,1,1,0,4,6,10,0,0,0,0,5,3,0,8
123019,2023,Thailand,USA,0,0,10,10,15/06/2023,14,0,53,67,1,0,0,1,1,2,2,5,0,0,0,0,7,3,2,12
123019,2023,Germany,Thailand,0,0,13,13,14/06/2023,27,1,63,91,2,0,1,3,0,1,3,4,0,0,0,0,5,2,3,10
123019,2023,Thailand,Korea,0,0,10,10,4/6/2023,17,3,69,89,2,0,2,4,0,1,2,3,0,0,0,0,5,1,0,6
123019,2023,Thailand,Poland,0,1,7,8,2/6/2023,6,2,57,65,0,0,0,0,0,1,1,2,0,0,1,1,4,1,2,7
123019,2023,Canada,Thailand,0,0,7,7,1/6/2023,22,0,61,83,1,0,0,1,0,0,4,4,0,0,1,1,3,5,0,8
123019,2023,Italy,Thailand,0,0,14,14,30/05/2023,34,0,111,145,2,1,1,4,0,2,2,4,0,0,0,0,7,4,2,13
142172,2023,Thailand,Brazil,0,0,0,0,2/7/2023,0,0,0,0,0,0,0,0,0,0,0,0,0,0,0,0,0,0,0,0
142172,2023,Thailand,Japan,0,1,7,8,1/7/2023,0,0,3,3,5,0,6,11,2,2,7,11,0,0,0,0,4,0,0,4
142172,2023,Thailand,Türkiye,0,1,6,7,29/06/2023,0,0,1,1,7,3,6,16,2,1,2,5,0,0,1,1,1,2,1,4
142172,2023,Thailand,Netherlands,0,3,12,15,27/06/2023,0,0,1,1,7,1,3,11,0,1,5,6,0,0,0,0,2,0,2,4
142172,2023,Thailand,Croatia,0,2,4,6,18/06/2023,0,0,3,3,3,1,1,5,0,3,1,4,0,1,0,1,0,2,0,2
142172,2023,Serbia,Thailand,0,0,0,0,17/06/2023,0,0,0,0,0,0,0,0,0,0,0,0,0,0,0,0,0,0,0,0
142172,2023,Thailand,USA,1,1,8,10,15/06/2023,0,0,0,0,2,2,4,8,3,4,3,10,0,0,1,1,1,1,0,2
142172,2023,Germany,Thailand,0,0,12,12,14/06/2023,0,0,4,4,15,3,8,26,2,3,4,9,0,0,0,0,2,1,0,3
142172,2023,Thailand,Korea,0,1,12,13,4/6/2023,0,0,2,2,4,1,4,9,7,3,11,21,0,0,1,1,2,1,0,3
142172,2023,Thailand,Poland,0,1,7,8,2/6/2023,0,0,2,2,4,2,1,7,1,4,2,7,0,1,0,1,1,0,1,2
142172,2023,Canada,Thailand,1,3,12,16,1/6/2023,0,0,5,5,6,2,5,13,0,1,7,8,2,0,4,6,3,3,0,6
142172,2023,Italy,Thailand,1,0,24,25,30/05/2023,0,0,4,4,7,2,6,15,2,5,9,16,0,0,1,1,6,2,0,8
145244,2023,Thailand,Brazil,0,1,4,5,2/7/2023,0,0,2,2,0,0,4,4,0,1,2,3,0,0,0,0,0,0,0,0
145244,2023,Thailand,Japan,1,1,8,10,1/7/2023,0,0,1,1,2,2,6,10,2,4,8,14,0,0,0,0,2,1,1,4
145244,2023,Thailand,Türkiye,1,2,10,13,29/06/2023,0,0,1,1,5,1,6,12,0,2,1,3,0,0,0,0,0,0,0,0
145244,2023,Thailand,Netherlands,0,2,3,5,27/06/2023,0,0,1,1,3,2,2,7,0,3,0,3,0,0,0,0,0,0,0,0
145244,2023,Thailand,Croatia,0,1,7,8,18/06/2023,0,0,0,0,4,1,1,6,0,2,4,6,0,0,0,0,3,1,2,6
145244,2023,Serbia,Thailand,0,0,12,12,17/06/2023,0,0,1,1,3,3,13,19,5,8,6,19,1,0,1,2,4,3,0,7
145244,2023,Thailand,USA,0,0,5,5,15/06/2023,0,0,0,0,1,0,2,3,0,1,6,7,0,0,0,0,0,2,0,2
145244,2023,Germany,Thailand,0,0,5,5,14/06/2023,0,0,0,0,4,0,3,7,1,0,4,5,0,0,0,0,1,0,1,2
145244,2023,Thailand,Korea,1,2,10,13,4/6/2023,0,0,3,3,4,0,3,7,2,5,9,16,0,0,0,0,3,2,0,5
145244,2023,Thailand,Poland,0,0,5,5,2/6/2023,0,0,1,1,0,0,0,0,0,0,0,0,0,0,0,0,0,0,1,1
145244,2023,Canada,Thailand,1,0,12,13,1/6/2023,0,1,2,3,2,0,1,3,3,4,6,13,0,0,1,1,2,0,2,4
145244,2023,Italy,Thailand,0,2,10,12,30/05/2023,0,0,2,2,5,3,5,13,3,6,8,17,0,0,0,0,0,0,3,3
122866,2023,Thailand,Brazil,0,0,0,0,2/7/2023,0,1,7,8,0,0,0,0,0,0,0,0,0,0,8,8,2,2,2,6
122866,2023,Thailand,Japan,0,0,6,6,1/7/2023,0,0,4,4,3,3,13,19,0,0,4,4,3,0,9,12,4,1,2,7
122866,2023,Thailand,Türkiye,0,0,1,1,29/06/2023,0,0,0,0,0,0,0,0,0,0,0,0,0,0,0,0,0,2,0,2
122866,2023,Thailand,Netherlands,0,0,1,1,27/06/2023,0,0,1,1,0,0,0,0,0,0,0,0,0,0,0,0,0,0,0,0
147188,2023,Thailand,Brazil,1,1,3,5,2/7/2023,13,1,51,65,0,0,1,1,0,2,0,2,0,0,0,0,2,1,0,3
147188,2023,Thailand,Japan,0,0,1,1,1/7/2023,6,1,8,15,1,0,1,2,0,0,3,3,0,0,0,0,4,0,0,4
147188,2023,Thailand,Türkiye,0,0,0,0,29/06/2023,3,0,10,13,0,0,1,1,0,1,0,1,0,0,0,0,0,0,0,0
147188,2023,Thailand,Netherlands,0,0,0,0,27/06/2023,2,0,5,7,0,0,1,1,0,0,0,0,0,0,0,0,1,0,0,1
151121,2023,Thailand,Brazil,0,1,8,9,2/7/2023,0,0,3,3,7,3,7,17,0,2,0,2,0,0,0,0,11,1,2,14
151121,2023,Thailand,Japan,0,0,9,9,1/7/2023,0,0,3,3,5,4,10,19,0,1,1,2,0,0,2,2,8,0,2,10
151121,2023,Thailand,Türkiye,0,0,4,4,29/06/2023,0,0,0,0,5,5,8,18,1,0,2,3,0,0,0,0,6,1,1,8
151121,2023,Thailand,Netherlands,0,0,5,5,27/06/2023,0,0,0,0,3,2,12,17,0,0,3,3,0,0,0,0,3,0,0,3
151121,2023,Thailand,Croatia,0,0,6,6,18/06/2023,0,0,1,1,2,5,6,13,0,0,3,3,0,0,1,1,1,1,0,2
151121,2023,Serbia,Thailand,0,2,12,14,17/06/2023,0,0,1,1,20,9,30,59,0,2,3,5,0,0,0,0,12,7,1,20
151121,2023,Thailand,USA,0,0,2,2,15/06/2023,0,0,2,2,3,3,9,15,1,0,1,2,0,0,2,2,2,0,0,2
151121,2023,Germany,Thailand,0,2,9,11,14/06/2023,0,0,1,1,9,5,9,23,1,0,1,2,0,0,1,1,3,2,1,6
151121,2023,Thailand,Korea,0,0,12,12,4/6/2023,0,0,1,1,12,4,12,28,1,2,4,7,0,0,0,0,10,3,0,13
151121,2023,Thailand,Poland,0,1,6,7,2/6/2023,0,0,1,1,5,2,8,15,0,3,4,7,0,0,0,0,2,3,2,7
151121,2023,Canada,Thailand,2,0,10,12,1/6/2023,1,0,3,4,6,4,14,24,0,2,2,4,0,0,0,0,6,7,0,13
151121,2023,Italy,Thailand,1,3,16,20,30/05/2023,0,0,3,3,21,8,19,48,0,1,3,4,1,0,0,1,11,1,3,15
133511,2023,Thailand,Brazil,1,0,8,9,2/7/2023,0,0,3,3,4,4,6,14,0,0,2,2,10,0,18,28,4,6,1,11
133511,2023,Thailand,Japan,0,0,5,5,1/7/2023,0,0,0,0,6,1,7,14,0,2,0,2,3,4,7,14,4,2,3,9
133511,2023,Thailand,Türkiye,0,1,3,4,29/06/2023,0,0,1,1,5,5,13,23,1,0,0,1,6,0,10,16,1,1,0,2
133511,2023,Thailand,Netherlands,0,0,4,4,27/06/2023,0,0,0,0,8,1,5,14,0,2,1,3,1,2,8,11,1,1,1,3
133511,2023,Thailand,Croatia,1,2,7,10,18/06/2023,0,0,1,1,13,1,17,31,0,3,2,5,6,1,14,21,11,1,2,14
133511,2023,Serbia,Thailand,1,0,14,15,17/06/2023,0,0,3,3,13,3,19,35,3,2,3,8,9,3,24,36,14,7,1,22
133511,2023,Thailand,USA,0,0,9,9,15/06/2023,0,0,3,3,8,4,13,25,2,3,1,6,0,0,3,3,6,3,1,10
133511,2023,Germany,Thailand,0,0,3,3,14/06/2023,0,0,2,2,2,1,4,7,1,0,1,2,0,1,9,10,6,0,0,6
133511,2023,Thailand,Korea,0,0,6,6,4/6/2023,0,0,0,0,6,1,8,15,0,1,1,2,4,0,19,23,6,3,0,9
133511,2023,Thailand,Poland,0,1,5,6,2/6/2023,0,0,4,4,4,1,7,12,0,0,0,0,3,1,12,16,7,2,1,10
133511,2023,Canada,Thailand,0,0,0,0,1/6/2023,0,0,0,0,0,0,0,0,0,0,0,0,0,0,0,0,0,0,0,0
133511,2023,Italy,Thailand,0,1,14,15,30/05/2023,0,0,4,4,11,3,17,31,2,2,0,4,6,0,16,22,7,3,3,13
147213,2023,Thailand,Brazil,1,2,8,11,2/7/2023,0,0,0,0,18,6,18,42,1,0,2,3,6,1,18,25,6,1,2,9
147213,2023,Thailand,Japan,0,1,8,9,1/7/2023,0,0,2,2,8,5,20,33,0,3,1,4,5,1,17,23,5,0,0,5
147213,2023,Thailand,Türkiye,1,3,6,10,29/06/2023,0,0,3,3,5,8,11,24,0,1,1,2,13,2,15,30,6,1,2,9
147213,2023,Thailand,Netherlands,0,2,8,10,27/06/2023,0,0,3,3,13,5,10,28,0,5,2,7,3,2,25,30,7,2,1,10
147213,2023,Thailand,Croatia,0,0,9,9,18/06/2023,0,0,0,0,16,4,11,31,3,3,6,12,4,0,13,17,5,3,3,11
147213,2023,Serbia,Thailand,1,2,16,19,17/06/2023,0,1,8,9,18,8,24,50,2,1,6,9,10,0,18,28,18,10,2,30
147213,2023,Thailand,USA,1,1,8,10,15/06/2023,0,0,3,3,10,3,12,25,2,3,3,8,8,2,29,39,6,3,1,10
147213,2023,Germany,Thailand,0,1,12,13,14/06/2023,0,1,2,3,8,4,14,26,2,4,5,11,12,2,19,33,9,2,4,15
147213,2023,Thailand,Korea,2,2,11,15,4/6/2023,0,0,3,3,16,5,19,40,2,2,4,8,1,2,10,13,11,5,1,17
147213,2023,Thailand,Poland,0,1,6,7,2/6/2023,0,0,1,1,7,5,10,22,3,1,0,4,2,0,12,14,1,0,2,3
147213,2023,Canada,Thailand,1,1,12,14,1/6/2023,0,0,6,6,14,6,20,40,2,1,3,6,11,0,18,29,16,3,0,19
147213,2023,Italy,Thailand,0,3,11,14,30/05/2023,0,0,3,3,15,9,15,39,0,1,1,2,7,6,31,44,16,5,4,25
162681,2023,Thailand,Brazil,0,0,0,0,2/7/2023,0,0,0,0,0,0,0,0,0,0,0,0,0,0,0,0,1,1,1,3
162681,2023,Thailand,Japan,0,0,0,0,1/7/2023,0,0,4,4,0,0,0,0,0,0,0,0,0,0,0,0,4,1,0,5
162681,2023,Thailand,Türkiye,0,0,0,0,29/06/2023,0,0,1,1,0,0,0,0,0,0,0,0,0,0,0,0,3,3,1,7
162681,2023,Thailand,Netherlands,0,0,0,0,27/06/2023,0,0,2,2,0,0,0,0,0,0,0,0,0,0,0,0,8,2,0,10
162681,2023,Thailand,Croatia,0,0,0,0,18/06/2023,0,0,2,2,0,0,0,0,0,0,0,0,0,0,0,0,4,3,2,9
162681,2023,Serbia,Thailand,0,0,0,0,17/06/2023,0,0,5,5,0,0,0,0,0,0,0,0,0,0,0,0,11,6,3,20
162681,2023,Thailand,USA,0,0,0,0,15/06/2023,0,0,2,2,0,0,0,0,0,0,0,0,0,0,0,0,0,4,0,4
162681,2023,Germany,Thailand,0,0,0,0,14/06/2023,0,0,6,6,0,0,0,0,0,0,0,0,0,0,0,0,1,2,1,4
162681,2023,Thailand,Korea,0,0,0,0,4/6/2023,0,0,5,5,0,0,0,0,0,0,0,0,0,0,0,0,7,1,1,9
162681,2023,Thailand,Poland,0,0,0,0,2/6/2023,0,0,2,2,0,0,0,0,0,0,0,0,1,0,3,4,4,4,2,10
162681,2023,Canada,Thailand,0,0,0,0,1/6/2023,0,0,2,2,0,0,0,0,0,0,0,0,0,0,1,1,13,4,2,19
162681,2023,Italy,Thailand,0,0,0,0,30/05/2023,0,0,1,1,0,0,0,0,0,0,0,0,0,0,1,1,14,1,2,17
152205,2023,Thailand,Brazil,0,0,7,7,2/7/2023,0,0,3,3,1,0,3,4,0,1,1,2,0,0,0,0,2,0,0,2
152205,2023,Thailand,Japan,0,1,2,3,1/7/2023,0,0,0,0,0,0,6,6,0,2,0,2,0,0,0,0,3,0,0,3
152205,2023,Thailand,Türkiye,0,0,4,4,29/06/2023,0,0,0,0,5,2,5,12,1,0,0,1,0,0,0,0,0,2,0,2
152205,2023,Thailand,Netherlands,0,0,8,8,27/06/2023,0,0,0,0,5,1,9,15,0,2,2,4,0,0,0,0,5,0,1,6
152205,2023,Thailand,Croatia,0,1,2,3,18/06/2023,0,0,1,1,3,1,2,6,0,1,0,1,0,0,0,0,1,0,0,1
152205,2023,Serbia,Thailand,0,1,1,2,17/06/2023,0,0,0,0,1,1,1,3,0,0,0,0,0,0,0,0,1,1,1,3
152205,2023,Thailand,USA,0,0,1,1,15/06/2023,0,0,0,0,0,1,1,2,0,0,0,0,1,0,0,1,1,0,0,1
152205,2023,Germany,Thailand,0,0,5,5,14/06/2023,0,0,1,1,4,2,2,8,0,0,0,0,0,0,0,0,3,2,0,5
152205,2023,Thailand,Korea,0,1,0,1,4/6/2023,0,0,0,0,0,0,2,2,0,0,2,2,0,0,0,0,2,0,0,2
152205,2023,Thailand,Poland,0,0,3,3,2/6/2023,0,0,2,2,4,2,4,10,0,2,0,2,0,0,0,0,0,0,0,0
152205,2023,Canada,Thailand,0,0,0,0,1/6/2023,0,0,0,0,0,1,0,1,0,0,0,0,0,0,0,0,0,0,0,0
152205,2023,Italy,Thailand,0,0,2,2,30/05/2023,0,0,0,0,5,1,4,10,0,2,1,3,0,0,0,0,0,1,0,1
163495,2023,Thailand,Brazil,0,1,2,3,2/7/2023,0,0,0,0,0,1,2,3,0,1,3,4,0,0,0,0,0,0,0,0
163495,2023,Thailand,Japan,0,0,0,0,1/7/2023,0,0,0,0,0,0,0,0,0,0,0,0,0,0,0,0,0,0,0,0
163495,2023,Thailand,Türkiye,0,0,0,0,29/06/2023,0,0,0,0,0,0,0,0,0,0,0,0,0,0,0,0,0,0,0,0
163495,2023,Thailand,Netherlands,0,2,1,3,27/06/2023,0,0,1,1,0,0,3,3,0,3,1,4,0,0,0,0,1,0,1,2
143002,2023,Thailand,Brazil,0,0,8,8,2/7/2023,0,0,0,0,2,0,6,8,3,0,3,6,0,0,0,0,0,4,0,4
143002,2023,Thailand,Japan,0,0,2,2,1/7/2023,0,0,0,0,1,0,1,2,0,0,1,1,0,0,0,0,0,0,0,0
143002,2023,Thailand,Türkiye,0,0,0,0,29/06/2023,0,0,0,0,0,0,0,0,0,0,0,0,0,0,0,0,0,0,0,0
143002,2023,Thailand,Netherlands,0,0,0,0,27/06/2023,0,0,0,0,0,0,0,0,0,0,0,0,0,0,0,0,0,0,0,0
143002,2023,Thailand,Croatia,0,0,1,1,18/06/2023,0,0,0,0,1,1,1,3,0,3,0,3,0,0,0,0,0,0,0,0
143002,2023,Serbia,Thailand,0,0,15,15,17/06/2023,0,0,2,2,3,1,4,8,2,7,6,15,0,0,1,1,3,2,1,6
143002,2023,Thailand,USA,0,0,5,5,15/06/2023,0,0,0,0,0,0,2,2,0,1,0,1,1,0,0,1,1,0,0,1
143002,2023,Germany,Thailand,0,1,5,6,14/06/2023,0,0,0,0,4,0,4,8,0,0,2,2,0,0,0,0,2,0,0,2
143002,2023,Thailand,Korea,0,0,0,0,4/6/2023,0,0,0,0,0,0,0,0,0,0,0,0,0,0,0,0,0,0,0,0
143002,2023,Thailand,Poland,0,0,3,3,2/6/2023,0,1,1,2,1,1,0,2,0,2,1,3,0,0,0,0,1,0,0,1
143002,2023,Canada,Thailand,0,0,0,0,1/6/2023,0,0,0,0,0,0,0,0,0,0,0,0,0,0,0,0,0,0,0,0
143002,2023,Italy,Thailand,0,1,0,1,30/05/2023,0,0,0,0,0,0,0,0,0,0,0,0,0,0,1,1,0,0,0,0
138773,2023,China,Türkiye,0,0,0,0,16/07/2023,0,1,4,5,0,0,0,0,0,0,0,0,5,1,10,16,20,5,2,27
138773,2023,USA,Türkiye,0,0,0,0,16/07/2023,0,0,9,9,0,0,0,0,0,0,0,0,4,0,13,17,16,6,2,24
138773,2023,Türkiye,Italy,0,0,0,0,13/07/2023,0,0,6,6,0,0,0,0,0,0,0,0,3,1,6,10,10,3,2,15
138773,2023,Croatia,Türkiye,0,0,0,0,2/7/2023,0,0,0,0,0,0,0,0,0,0,0,0,0,0,0,0,0,0,0,0
138773,2023,Brazil,Türkiye,0,0,0,0,30/06/2023,0,1,11,12,0,0,0,0,0,0,0,0,4,0,6,10,6,3,1,10
138773,2023,Thailand,Türkiye,0,0,0,0,29/06/2023,0,0,0,0,0,0,0,0,0,0,0,0,0,0,0,0,0,0,0,0
138773,2023,Japan,Türkiye,0,0,0,0,28/06/2023,0,0,14,14,0,0,0,0,0,0,0,0,7,2,13,22,22,7,2,31
138773,2023,USA,Türkiye,0,0,1,1,4/6/2023,0,1,7,8,0,0,0,0,0,0,0,0,7,0,8,15,18,11,1,30
138773,2023,Türkiye,Italy,0,0,0,0,3/6/2023,0,0,0,0,0,0,0,0,0,0,0,0,1,0,1,2,0,0,0,0
138773,2023,Türkiye,Serbia,0,0,0,0,1/6/2023,0,0,7,7,0,0,0,0,0,0,0,0,7,0,5,12,12,6,1,19
138773,2023,Korea,Türkiye,0,0,0,0,31/05/2023,0,0,0,0,0,0,0,0,0,0,0,0,0,0,0,0,0,0,0,0
158840,2023,China,Türkiye,0,0,0,0,16/07/2023,0,0,0,0,0,0,0,0,0,0,0,0,0,0,0,0,0,0,1,1
158840,2023,USA,Türkiye,0,0,0,0,16/07/2023,0,0,0,0,0,0,0,0,0,0,0,0,0,0,0,0,0,0,0,0
158840,2023,Türkiye,Italy,0,0,0,0,13/07/2023,0,0,0,0,0,0,0,0,0,0,0,0,0,0,0,0,0,0,0,0
158840,2023,Dominican Republic,Türkiye,0,0,0,0,18/06/2023,0,0,3,3,0,0,0,0,0,0,0,0,16,2,13,31,12,3,1,16
158840,2023,Türkiye,Canada,0,0,0,0,16/06/2023,0,0,4,4,0,0,0,0,0,0,0,0,6,0,10,16,9,0,1,10
158840,2023,Poland,Türkiye,0,0,0,0,15/06/2023,0,0,0,0,0,0,0,0,0,0,0,0,0,0,0,0,0,0,0,0
158840,2023,Netherlands,Türkiye,0,0,0,0,14/06/2023,0,0,4,4,0,0,0,0,0,0,0,0,8,0,13,21,11,6,0,17
158840,2023,USA,Türkiye,0,0,0,0,4/6/2023,0,0,0,0,0,0,0,0,0,0,0,0,2,0,3,5,1,0,0,1
158840,2023,Türkiye,Italy,0,0,0,0,3/6/2023,0,0,6,6,0,0,0,0,0,0,0,0,6,1,16,23,7,1,2,10
158840,2023,Türkiye,Serbia,0,0,0,0,1/6/2023,0,0,0,0,0,0,0,0,0,0,0,0,0,0,0,0,0,0,0,0
158840,2023,Korea,Türkiye,0,0,0,0,31/05/2023,0,0,8,8,0,0,0,0,0,0,0,0,3,0,10,13,14,2,1,17
143590,2023,China,Türkiye,0,0,0,0,16/07/2023,1,0,5,6,0,0,0,0,0,0,1,1,0,0,0,0,1,0,0,1
143590,2023,USA,Türkiye,0,0,6,6,16/07/2023,4,0,22,26,0,0,0,0,1,1,2,4,0,0,0,0,1,0,1,2
143590,2023,Türkiye,Italy,0,0,0,0,13/07/2023,1,0,1,2,0,0,0,0,0,0,0,0,0,0,0,0,0,0,0,0
143590,2023,Croatia,Türkiye,0,1,5,6,2/7/2023,16,0,60,76,0,0,0,0,0,3,2,5,0,0,0,0,3,1,0,4
143590,2023,Brazil,Türkiye,0,0,0,0,30/06/2023,1,0,4,5,0,0,0,0,0,0,0,0,0,0,0,0,0,0,0,0
143590,2023,Thailand,Türkiye,0,0,1,1,29/06/2023,0,0,4,4,0,0,0,0,0,0,0,0,0,0,0,0,0,0,0,0
143590,2023,Japan,Türkiye,0,1,12,13,28/06/2023,22,1,59,82,1,0,0,1,0,1,4,5,0,0,0,0,6,2,1,9
143590,2023,Dominican Republic,Türkiye,0,0,1,1,18/06/2023,1,0,12,13,0,0,0,0,0,1,1,2,0,0,0,0,2,0,0,2
143590,2023,Türkiye,Canada,0,0,0,0,16/06/2023,1,0,4,5,0,0,0,0,0,0,0,0,0,0,0,0,0,0,0,0
143590,2023,Poland,Türkiye,0,1,8,9,15/06/2023,15,2,54,71,1,0,2,3,0,1,3,4,0,0,0,0,7,1,0,8
143590,2023,Netherlands,Türkiye,0,1,8,9,14/06/2023,13,0,46,59,1,0,2,3,0,3,3,6,0,0,0,0,6,1,0,7
143590,2023,USA,Türkiye,0,2,10,12,4/6/2023,6,0,96,102,0,0,0,0,0,6,6,12,0,0,0,0,2,2,0,4
143590,2023,Türkiye,Italy,0,0,6,6,3/6/2023,7,0,53,60,0,1,2,3,1,2,0,3,0,0,0,0,3,5,1,9
143590,2023,Türkiye,Serbia,0,1,10,11,1/6/2023,12,1,60,73,2,0,1,3,0,3,5,8,0,0,0,0,2,2,1,5
143590,2023,Korea,Türkiye,0,1,6,7,31/05/2023,18,0,29,47,0,0,0,0,0,3,3,6,0,0,0,0,4,1,1,6
143339,2023,China,Türkiye,3,1,15,19,16/07/2023,0,0,1,1,21,4,14,39,2,1,1,4,0,0,0,0,11,2,3,16
143339,2023,USA,Türkiye,1,1,13,15,16/07/2023,0,0,5,5,20,5,18,43,2,2,5,9,0,0,0,0,5,0,2,7
143339,2023,Türkiye,Italy,1,2,11,14,13/07/2023,0,0,1,1,14,3,10,27,1,3,1,5,0,0,0,0,5,3,1,9
143339,2023,Dominican Republic,Türkiye,2,2,13,17,18/06/2023,0,0,4,4,26,4,8,38,1,1,1,3,0,0,0,0,9,3,4,16
143339,2023,Türkiye,Canada,2,0,12,14,16/06/2023,0,0,1,1,14,3,10,27,1,6,3,10,0,0,0,0,8,0,0,8
143339,2023,Poland,Türkiye,2,3,9,14,15/06/2023,0,0,0,0,21,3,19,43,1,3,1,5,1,0,2,3,11,5,0,16
143339,2023,Netherlands,Türkiye,1,2,3,6,14/06/2023,0,0,1,1,7,2,4,13,1,2,1,4,0,0,0,0,6,1,0,7
143339,2023,USA,Türkiye,3,1,6,10,4/6/2023,0,0,1,1,21,6,18,45,1,1,1,3,0,0,0,0,6,3,0,9
143339,2023,Türkiye,Italy,0,1,10,11,3/6/2023,0,0,0,0,20,5,6,31,2,1,1,4,0,0,1,1,4,3,2,9
143339,2023,Türkiye,Serbia,3,2,9,14,1/6/2023,0,0,1,1,17,5,8,30,1,1,1,3,0,0,0,0,12,1,0,13
143339,2023,Korea,Türkiye,1,1,9,11,31/05/2023,0,0,0,0,13,2,6,21,1,1,0,2,0,0,0,0,5,2,2,9
143592,2023,China,Türkiye,0,0,0,0,16/07/2023,0,0,2,2,0,0,0,0,0,0,0,0,3,0,4,7,2,0,0,2
143592,2023,USA,Türkiye,0,0,0,0,16/07/2023,0,0,1,1,0,0,0,0,0,0,0,0,1,0,5,6,4,0,0,4
143592,2023,Türkiye,Italy,0,0,0,0,13/07/2023,0,0,0,0,0,0,0,0,0,0,0,0,1,0,2,3,1,0,0,1
143592,2023,Croatia,Türkiye,0,0,0,0,2/7/2023,0,0,8,8,0,0,0,0,0,0,0,0,2,0,3,5,11,3,0,14
143592,2023,Brazil,Türkiye,0,0,0,0,30/06/2023,0,0,0,0,0,0,0,0,0,0,0,0,0,0,0,0,0,0,0,0
143592,2023,Thailand,Türkiye,0,0,0,0,29/06/2023,0,0,6,6,0,0,0,0,0,0,0,0,4,1,6,11,8,5,5,18
143592,2023,Japan,Türkiye,0,0,0,0,28/06/2023,0,0,0,0,0,0,0,0,0,0,0,0,0,0,0,0,0,0,0,0
143592,2023,Dominican Republic,Türkiye,0,0,0,0,18/06/2023,0,0,0,0,0,0,0,0,0,0,0,0,2,0,1,3,0,2,1,3
143592,2023,Türkiye,Canada,0,0,0,0,16/06/2023,0,0,0,0,0,0,0,0,0,0,0,0,1,0,0,1,0,0,0,0
143592,2023,Poland,Türkiye,0,0,0,0,15/06/2023,0,0,12,12,0,0,0,0,0,0,0,0,4,0,8,12,12,6,0,18
143592,2023,Netherlands,Türkiye,0,0,0,0,14/06/2023,0,0,0,0,0,0,0,0,0,0,0,0,0,0,0,0,0,0,0,0
143585,2023,China,Türkiye,0,0,0,0,16/07/2023,0,0,0,0,0,0,0,0,0,0,0,0,0,0,0,0,0,0,0,0
143585,2023,USA,Türkiye,0,0,0,0,16/07/2023,0,0,0,0,0,0,0,0,0,0,0,0,0,0,0,0,0,0,0,0
143585,2023,Türkiye,Italy,0,0,0,0,13/07/2023,0,0,0,0,0,0,0,0,0,0,0,0,0,0,0,0,0,0,0,0
143585,2023,Croatia,Türkiye,0,1,12,13,2/7/2023,0,0,0,0,10,0,6,16,2,0,3,5,13,0,14,27,8,1,0,9
143585,2023,Brazil,Türkiye,0,0,0,0,30/06/2023,0,0,0,0,0,2,0,2,0,0,0,0,0,0,0,0,1,0,0,1
143585,2023,Thailand,Türkiye,0,0,0,0,29/06/2023,0,0,0,0,1,2,2,5,0,0,0,0,0,0,0,0,1,1,0,2
143585,2023,Japan,Türkiye,1,1,7,9,28/06/2023,0,0,2,2,6,4,11,21,0,2,2,4,4,0,17,21,6,1,0,7
143585,2023,Dominican Republic,Türkiye,1,1,12,14,18/06/2023,0,0,1,1,9,2,11,22,3,3,3,9,10,1,11,22,3,0,0,3
143585,2023,Türkiye,Canada,0,0,5,5,16/06/2023,0,0,1,1,0,2,3,5,0,0,2,2,2,0,3,5,3,0,1,4
143585,2023,Poland,Türkiye,0,1,2,3,15/06/2023,0,0,0,0,4,5,4,13,1,1,0,2,2,0,3,5,3,0,0,3
143585,2023,Netherlands,Türkiye,0,3,7,10,14/06/2023,0,0,1,1,10,1,9,20,2,2,4,8,3,1,21,25,6,3,0,9
143585,2023,USA,Türkiye,0,1,8,9,4/6/2023,0,0,0,0,3,3,10,16,0,0,3,3,4,0,19,23,2,2,0,4
143585,2023,Türkiye,Italy,0,0,0,0,3/6/2023,0,0,0,0,0,0,0,0,0,0,0,0,0,0,0,0,0,0,0,0
143585,2023,Türkiye,Serbia,0,1,13,14,1/6/2023,0,1,2,3,11,5,9,25,2,1,3,6,8,1,22,31,4,4,0,8
143585,2023,Korea,Türkiye,0,3,2,5,31/05/2023,0,0,0,0,7,2,7,16,0,0,1,1,1,1,7,9,4,1,0,5
163094,2023,China,Türkiye,1,1,18,20,16/07/2023,0,0,2,2,8,6,4,18,1,2,2,5,1,2,11,14,3,2,1,6
163094,2023,USA,Türkiye,0,0,13,13,16/07/2023,0,0,2,2,6,4,9,19,2,1,0,3,3,2,22,27,5,2,0,7
163094,2023,Türkiye,Italy,0,0,0,0,13/07/2023,0,0,0,0,1,0,0,1,0,0,0,0,0,0,0,0,0,0,0,0
163094,2023,Croatia,Türkiye,0,0,1,1,2/7/2023,0,1,0,1,3,1,3,7,0,0,1,1,0,0,0,0,1,0,0,1
163094,2023,Brazil,Türkiye,0,0,8,8,30/06/2023,0,0,2,2,5,3,6,14,0,3,1,4,7,0,13,20,10,2,0,12
163094,2023,Thailand,Türkiye,0,0,10,10,29/06/2023,0,0,3,3,12,1,8,21,0,2,3,5,3,1,10,14,9,5,0,14
163094,2023,Japan,Türkiye,0,0,16,16,28/06/2023,0,0,1,1,8,2,10,20,1,3,7,11,3,0,13,16,11,2,0,13
163094,2023,Dominican Republic,Türkiye,0,0,0,0,18/06/2023,0,0,0,0,0,0,0,0,0,0,0,0,0,0,0,0,0,0,0,0
163094,2023,Poland,Türkiye,0,0,0,0,15/06/2023,0,0,0,0,0,0,0,0,0,0,0,0,0,0,0,0,0,0,0,0
163094,2023,Netherlands,Türkiye,0,0,0,0,14/06/2023,0,0,0,0,0,0,0,0,0,0,0,0,0,0,0,0,0,0,0,0
163094,2023,USA,Türkiye,0,0,1,1,4/6/2023,0,0,0,0,0,0,1,1,0,1,0,1,0,2,2,4,1,0,0,1
163094,2023,Türkiye,Italy,0,2,14,16,3/6/2023,0,0,3,3,5,1,5,11,0,2,1,3,1,1,16,18,5,1,1,7
163094,2023,Türkiye,Serbia,0,0,1,1,1/6/2023,0,0,0,0,0,0,0,0,0,0,0,0,0,0,0,0,0,0,0,0
163094,2023,Korea,Türkiye,0,0,6,6,31/05/2023,0,0,0,0,2,2,3,7,0,1,0,1,0,0,5,5,3,2,0,5
163975,2023,China,Türkiye,2,1,8,11,16/07/2023,19,0,71,90,1,0,2,3,2,3,3,8,0,0,0,0,4,2,1,7
163975,2023,USA,Türkiye,0,1,13,14,16/07/2023,8,0,63,71,1,1,3,5,2,3,6,11,0,0,0,0,4,0,1,5
163975,2023,Türkiye,Italy,0,1,7,8,13/07/2023,6,0,56,62,2,0,2,4,1,1,1,3,0,1,1,2,2,0,0,2
163975,2023,Croatia,Türkiye,0,0,2,2,2/7/2023,1,0,6,7,0,1,0,1,0,0,0,0,0,0,0,0,1,1,0,2
163975,2023,Brazil,Türkiye,0,0,8,8,30/06/2023,12,1,63,76,4,1,1,6,1,2,1,4,0,0,0,0,8,2,3,13
163975,2023,Thailand,Türkiye,1,0,16,17,29/06/2023,8,1,53,62,1,0,3,4,2,0,4,6,0,0,0,0,5,2,1,8
163975,2023,Japan,Türkiye,0,0,4,4,28/06/2023,16,0,36,52,3,0,2,5,0,3,2,5,0,0,0,0,3,2,0,5
163975,2023,Dominican Republic,Türkiye,0,0,22,22,18/06/2023,32,3,56,91,1,0,2,3,3,0,1,4,0,0,0,0,3,5,0,8
163975,2023,Türkiye,Canada,1,0,10,11,16/06/2023,13,0,60,73,2,0,1,3,1,2,1,4,0,1,0,1,4,1,0,5
163975,2023,Poland,Türkiye,0,0,2,2,15/06/2023,1,1,18,20,2,0,0,2,1,1,0,2,0,0,0,0,4,0,1,5
163975,2023,Netherlands,Türkiye,0,0,3,3,14/06/2023,5,0,25,30,0,1,0,1,0,0,0,0,0,0,0,0,1,0,0,1
163975,2023,USA,Türkiye,0,0,0,0,4/6/2023,2,0,18,20,0,0,1,1,0,0,0,0,0,0,0,0,0,2,0,2
163975,2023,Türkiye,Italy,0,0,0,0,3/6/2023,0,0,6,6,0,0,0,0,0,0,0,0,0,0,0,0,1,0,0,1
163975,2023,Türkiye,Serbia,0,0,0,0,1/6/2023,7,0,14,21,0,0,0,0,0,0,0,0,0,0,0,0,1,1,0,2
163975,2023,Korea,Türkiye,0,0,1,1,31/05/2023,6,0,27,33,2,0,0,2,1,0,0,1,0,0,0,0,1,2,1,4
138782,2023,China,Türkiye,0,3,12,15,16/07/2023,0,0,1,1,8,2,5,15,4,8,7,19,1,0,0,1,5,0,0,5
138782,2023,USA,Türkiye,0,2,16,18,16/07/2023,0,0,4,4,4,0,3,7,3,5,9,17,0,0,0,0,3,0,0,3
138782,2023,Türkiye,Italy,0,0,10,10,13/07/2023,0,0,2,2,6,1,3,10,5,4,5,14,1,1,0,2,2,0,0,2
138782,2023,Croatia,Türkiye,0,1,3,4,2/7/2023,0,0,0,0,2,0,2,4,1,0,3,4,0,0,0,0,2,0,0,2
138782,2023,Brazil,Türkiye,0,1,13,14,30/06/2023,0,0,6,6,5,3,6,14,7,6,10,23,0,0,0,0,7,1,1,9
138782,2023,Thailand,Türkiye,0,0,8,8,29/06/2023,0,0,3,3,8,0,1,9,4,1,4,9,0,0,0,0,1,0,0,1
138782,2023,Japan,Türkiye,0,1,10,11,28/06/2023,0,0,3,3,8,2,10,20,6,9,12,27,0,0,0,0,6,1,0,7
138782,2023,Dominican Republic,Türkiye,0,1,15,16,18/06/2023,0,1,4,5,5,3,2,10,1,6,4,11,0,0,0,0,3,3,0,6
138782,2023,Türkiye,Canada,2,2,8,12,16/06/2023,0,0,1,1,6,0,3,9,3,2,5,10,0,0,0,0,4,1,1,6
138782,2023,Poland,Türkiye,1,0,9,10,15/06/2023,0,0,3,3,4,1,5,10,1,4,4,9,0,0,0,0,1,1,1,3
138782,2023,Netherlands,Türkiye,1,1,10,12,14/06/2023,0,0,3,3,8,1,0,9,3,5,11,19,0,0,0,0,1,1,1,3
138782,2023,USA,Türkiye,0,0,5,5,4/6/2023,0,0,3,3,3,1,2,6,1,3,6,10,0,0,1,1,5,0,0,5
138782,2023,Türkiye,Italy,0,0,0,0,3/6/2023,0,0,0,0,0,0,0,0,0,0,0,0,0,0,0,0,0,0,0,0
138782,2023,Türkiye,Serbia,1,4,15,20,1/6/2023,0,0,6,6,8,0,4,12,3,9,9,21,0,0,0,0,6,0,1,7
138782,2023,Korea,Türkiye,1,1,10,12,31/05/2023,0,0,4,4,4,1,6,11,0,3,7,10,0,0,0,0,6,1,1,8
152312,2023,China,Türkiye,0,0,2,2,16/07/2023,0,0,0,0,0,0,0,0,0,0,0,0,0,0,0,0,0,1,0,1
152312,2023,USA,Türkiye,0,0,0,0,16/07/2023,0,0,0,0,0,0,0,0,0,0,0,0,0,0,0,0,0,0,0,0
152312,2023,Türkiye,Italy,0,0,0,0,13/07/2023,0,0,0,0,0,0,0,0,0,0,0,0,0,0,0,0,0,0,0,0
152312,2023,Croatia,Türkiye,0,2,16,18,2/7/2023,0,0,0,0,9,5,7,21,0,2,5,7,4,1,10,15,8,2,2,12
152312,2023,Brazil,Türkiye,0,0,1,1,30/06/2023,0,0,0,0,0,0,0,0,0,0,0,0,0,0,0,0,0,0,0,0
152312,2023,Thailand,Türkiye,0,0,0,0,29/06/2023,0,0,0,0,0,0,0,0,0,0,0,0,0,0,0,0,0,0,0,0
152312,2023,Japan,Türkiye,0,1,11,12,28/06/2023,0,0,0,0,1,2,5,8,0,0,1,1,2,2,8,12,4,2,1,7
152312,2023,Dominican Republic,Türkiye,0,1,2,3,18/06/2023,0,0,0,0,1,1,0,2,0,0,0,0,1,0,3,4,2,3,0,5
152312,2023,Türkiye,Canada,0,0,1,1,16/06/2023,0,0,0,0,1,1,1,3,0,1,0,1,1,0,1,2,1,0,0,1
152312,2023,Poland,Türkiye,0,0,0,0,15/06/2023,0,0,0,0,0,0,0,0,0,0,0,0,2,1,0,3,0,0,0,0
152312,2023,Netherlands,Türkiye,0,0,5,5,14/06/2023,0,0,0,0,1,1,2,4,0,1,0,1,0,0,4,4,1,0,0,1
152312,2023,USA,Türkiye,0,0,0,0,4/6/2023,0,0,0,0,0,0,0,0,0,0,0,0,0,0,0,0,0,0,0,0
152312,2023,Türkiye,Italy,0,0,0,0,3/6/2023,0,0,0,0,0,0,0,0,0,0,0,0,0,0,0,0,0,0,0,0
152312,2023,Türkiye,Serbia,0,0,0,0,1/6/2023,0,0,0,0,0,0,0,0,0,0,0,0,0,0,0,0,0,0,0,0
152312,2023,Korea,Türkiye,0,2,1,3,31/05/2023,0,0,1,1,0,0,2,2,1,0,0,1,0,0,3,3,0,0,0,0
152263,2023,China,Türkiye,0,1,10,11,16/07/2023,0,0,2,2,7,0,6,13,2,3,5,10,0,0,0,0,1,2,0,3
152263,2023,USA,Türkiye,0,3,10,13,16/07/2023,0,0,3,3,7,1,2,10,7,5,9,21,0,0,0,0,1,1,2,4
152263,2023,Türkiye,Italy,2,2,12,16,13/07/2023,0,0,1,1,2,0,3,5,5,4,4,13,0,0,1,1,1,1,1,3
152263,2023,Croatia,Türkiye,0,0,0,0,2/7/2023,0,0,0,0,0,0,0,0,0,0,0,0,0,0,0,0,0,0,0,0
152263,2023,Brazil,Türkiye,0,2,10,12,30/06/2023,0,0,3,3,3,2,2,7,4,2,1,7,0,0,0,0,2,0,0,2
152263,2023,Thailand,Türkiye,1,3,9,13,29/06/2023,0,0,1,1,5,3,3,11,4,0,4,8,0,0,0,0,1,2,0,3
152263,2023,Japan,Türkiye,0,2,15,17,28/06/2023,0,0,3,3,8,0,5,13,7,7,8,22,0,0,0,0,4,3,2,9
152263,2023,Dominican Republic,Türkiye,0,1,13,14,18/06/2023,0,0,1,1,5,0,3,8,8,2,7,17,0,0,1,1,5,0,1,6
152263,2023,Türkiye,Canada,0,0,0,0,16/06/2023,0,0,0,0,0,0,0,0,0,0,0,0,0,0,0,0,0,0,0,0
152263,2023,Poland,Türkiye,0,2,13,15,15/06/2023,0,0,2,2,3,0,1,4,2,8,4,14,0,0,0,0,2,2,2,6
152263,2023,Netherlands,Türkiye,0,0,9,9,14/06/2023,0,0,5,5,4,0,2,6,1,3,0,4,0,0,0,0,1,0,0,1
152263,2023,USA,Türkiye,0,0,8,8,4/6/2023,0,0,2,2,0,0,2,2,1,2,1,4,0,0,0,0,1,0,1,2
152263,2023,Türkiye,Italy,0,2,11,13,3/6/2023,0,0,1,1,4,0,3,7,4,5,7,16,0,0,0,0,1,1,0,2
152263,2023,Türkiye,Serbia,0,0,0,0,1/6/2023,0,0,0,0,0,0,0,0,0,0,0,0,0,0,0,0,0,0,0,0
152263,2023,Korea,Türkiye,0,0,6,6,31/05/2023,0,0,0,0,3,0,4,7,0,2,4,6,0,0,0,0,2,0,2,4
137087,2023,China,Türkiye,0,0,0,0,16/07/2023,0,0,0,0,0,0,0,0,0,0,0,0,0,0,0,0,0,0,0,0
137087,2023,USA,Türkiye,0,0,0,0,16/07/2023,0,0,0,0,0,0,0,0,0,0,0,0,0,0,0,0,0,0,0,0
137087,2023,Türkiye,Italy,0,0,0,0,13/07/2023,0,0,0,0,0,0,0,0,0,0,0,0,0,0,0,0,0,0,0,0
137087,2023,Croatia,Türkiye,1,2,10,13,2/7/2023,0,0,0,0,6,2,2,10,2,1,3,6,0,0,2,2,4,0,1,5
137087,2023,Brazil,Türkiye,0,0,2,2,30/06/2023,0,0,0,0,0,0,0,0,0,0,0,0,0,0,0,0,3,0,0,3
137087,2023,Thailand,Türkiye,0,0,0,0,29/06/2023,0,0,0,0,0,0,0,0,0,0,0,0,0,0,0,0,0,0,0,0
137087,2023,Japan,Türkiye,0,0,0,0,28/06/2023,0,0,0,0,0,0,0,0,0,0,0,0,0,0,0,0,0,0,0,0
137087,2023,Dominican Republic,Türkiye,0,0,0,0,18/06/2023,0,0,0,0,0,0,0,0,0,0,0,0,0,0,0,0,0,0,0,0
137087,2023,Türkiye,Canada,0,1,11,12,16/06/2023,0,0,1,1,1,0,6,7,1,4,3,8,0,0,0,0,2,2,0,4
137087,2023,Poland,Türkiye,0,0,0,0,15/06/2023,0,0,0,0,0,0,0,0,0,1,0,1,0,0,0,0,0,0,0,0
137087,2023,Netherlands,Türkiye,1,0,4,5,14/06/2023,0,0,0,0,1,1,1,3,0,3,2,5,0,0,0,0,1,1,0,2
137087,2023,USA,Türkiye,0,1,5,6,4/6/2023,0,0,1,1,5,0,0,5,3,2,7,12,0,0,0,0,3,1,0,4
137087,2023,Türkiye,Italy,0,0,0,0,3/6/2023,0,0,0,0,0,0,0,0,0,0,0,0,0,0,0,0,0,0,0,0
137087,2023,Türkiye,Serbia,0,2,13,15,1/6/2023,0,0,1,1,3,0,6,9,3,5,8,16,0,0,1,1,4,0,0,4
137087,2023,Korea,Türkiye,0,2,4,6,31/05/2023,0,0,0,0,0,1,0,1,1,0,1,2,0,0,0,0,1,0,0,1
163089,2023,China,Türkiye,0,0,1,1,16/07/2023,0,0,0,0,0,0,1,1,0,0,0,0,1,0,2,3,0,0,0,0
163089,2023,USA,Türkiye,0,1,1,2,16/07/2023,0,0,0,0,0,1,3,4,0,2,0,2,2,1,4,7,3,1,0,4
163089,2023,Türkiye,Italy,0,0,14,14,13/07/2023,0,0,1,1,5,3,3,11,2,1,3,6,4,1,8,13,5,6,1,12
163089,2023,Croatia,Türkiye,0,0,0,0,2/7/2023,0,0,0,0,0,0,0,0,0,0,0,0,0,0,0,0,0,0,0,0
163089,2023,Brazil,Türkiye,0,2,14,16,30/06/2023,0,0,0,0,11,1,9,21,1,2,3,6,5,1,18,24,4,2,1,7
163089,2023,Thailand,Türkiye,2,0,17,19,29/06/2023,0,0,1,1,6,3,3,12,1,2,2,5,9,0,9,18,13,5,0,18
163089,2023,Japan,Türkiye,0,1,7,8,28/06/2023,0,0,4,4,9,5,6,20,1,1,0,2,3,0,12,15,4,1,0,5
163089,2023,Dominican Republic,Türkiye,0,0,0,0,18/06/2023,0,0,0,0,0,0,0,0,0,0,0,0,0,0,0,0,0,0,0,0
163089,2023,Türkiye,Canada,0,1,6,7,16/06/2023,0,0,0,0,3,2,8,13,0,0,2,2,6,0,2,8,1,1,0,2
163089,2023,Poland,Türkiye,0,1,6,7,15/06/2023,0,0,1,1,4,1,5,10,1,1,0,2,4,0,12,16,2,2,0,4
163089,2023,Netherlands,Türkiye,0,1,9,10,14/06/2023,0,0,1,1,9,4,7,20,0,1,2,3,2,1,8,11,10,0,0,10
163089,2023,USA,Türkiye,1,0,15,16,4/6/2023,0,0,2,2,8,5,13,26,2,3,5,10,1,0,16,17,12,2,2,16
163089,2023,Türkiye,Italy,1,4,5,10,3/6/2023,0,0,1,1,7,2,2,11,0,4,4,8,1,0,9,10,4,1,2,7
163089,2023,Türkiye,Serbia,1,2,17,20,1/6/2023,0,0,0,0,11,2,8,21,0,1,3,4,5,0,17,22,6,3,1,10
163089,2023,Korea,Türkiye,2,3,9,14,31/05/2023,0,0,2,2,11,0,4,15,1,2,3,6,3,0,16,19,6,0,2,8
163982,2023,China,Türkiye,2,2,13,17,16/07/2023,0,0,4,4,7,2,16,25,3,2,1,6,7,1,20,28,4,2,2,8
163982,2023,USA,Türkiye,1,1,17,19,16/07/2023,0,0,2,2,11,12,17,40,2,4,1,7,2,0,14,16,8,3,2,13
163982,2023,Türkiye,Italy,0,0,11,11,13/07/2023,0,0,2,2,7,3,9,19,2,2,2,6,2,0,12,14,7,0,0,7
163982,2023,Croatia,Türkiye,1,1,8,10,2/7/2023,0,0,0,0,14,4,8,26,0,1,0,1,0,0,0,0,4,1,2,7
163982,2023,Brazil,Türkiye,1,0,13,14,30/06/2023,0,0,1,1,18,5,21,44,0,1,4,5,0,0,0,0,4,1,1,6
163982,2023,Thailand,Türkiye,0,1,5,6,29/06/2023,0,0,0,0,5,2,12,19,3,0,0,3,0,0,0,0,1,0,1,2
163982,2023,Japan,Türkiye,0,1,14,15,28/06/2023,0,1,0,1,17,6,27,50,2,5,7,14,0,0,0,0,8,2,1,11
163982,2023,Dominican Republic,Türkiye,0,2,9,11,18/06/2023,0,0,0,0,8,6,12,26,0,3,3,6,3,2,11,16,2,1,0,3
163982,2023,Türkiye,Canada,0,3,7,10,16/06/2023,0,0,0,0,12,5,2,19,2,0,0,2,3,1,10,14,5,0,1,6
163982,2023,Poland,Türkiye,1,0,11,12,15/06/2023,0,0,0,0,8,3,10,21,0,1,3,4,4,3,24,31,3,5,1,9
163982,2023,Netherlands,Türkiye,1,0,10,11,14/06/2023,0,0,1,1,12,2,11,25,0,2,1,3,0,0,0,0,1,0,1,2
163982,2023,USA,Türkiye,4,4,23,31,4/6/2023,0,1,0,1,20,4,18,42,2,4,2,8,3,1,17,21,6,3,0,9
163982,2023,Türkiye,Italy,0,1,4,5,3/6/2023,0,0,0,0,4,1,4,9,1,1,0,2,0,0,2,2,0,0,0,0
163982,2023,Türkiye,Serbia,3,0,1,4,1/6/2023,0,0,0,0,9,0,7,16,1,2,0,3,0,0,0,0,0,0,0,0
163982,2023,Korea,Türkiye,0,1,2,3,31/05/2023,0,0,0,0,9,4,5,18,0,0,0,0,0,0,0,0,0,0,0,0
132835,2023,Poland,USA,2,0,3,5,16/07/2023,3,0,17,20,0,0,1,1,0,1,2,3,0,0,0,0,0,2,1,3
132835,2023,USA,Türkiye,1,2,15,18,16/07/2023,8,3,109,120,4,1,2,7,2,0,7,9,0,0,0,0,8,2,0,10
132835,2023,USA,Japan,0,2,16,18,13/07/2023,26,2,105,133,4,1,0,5,0,3,7,10,0,0,0,0,11,4,2,17
132835,2023,China,USA,0,2,3,5,2/7/2023,0,0,1,1,0,0,0,0,0,0,0,0,0,0,0,0,0,1,0,1
132835,2023,Germany,USA,1,0,13,14,1/7/2023,10,0,43,53,0,0,0,0,1,1,2,4,0,0,0,0,6,1,1,8
132835,2023,USA,Bulgaria,0,0,0,0,29/06/2023,0,0,0,0,0,0,0,0,0,0,0,0,0,0,0,0,0,0,0,0
132835,2023,USA,Poland,2,2,19,23,28/06/2023,25,0,115,140,4,1,1,6,1,3,13,17,0,0,3,3,5,4,2,11
132835,2023,Brazil,USA,2,1,15,18,18/06/2023,9,0,59,68,1,1,0,2,0,5,3,8,0,0,0,0,3,0,0,3
132835,2023,Japan,USA,0,0,6,6,17/06/2023,1,1,15,17,0,0,0,0,0,0,0,0,0,1,1,2,1,0,0,1
132835,2023,Thailand,USA,3,2,15,20,15/06/2023,20,0,63,83,2,0,2,4,0,1,3,4,0,0,1,1,12,4,2,18
132835,2023,Croatia,USA,0,0,9,9,13/06/2023,10,1,54,65,2,0,0,2,1,2,3,6,0,0,0,0,8,2,0,10
132835,2023,USA,Türkiye,1,1,22,24,4/6/2023,8,1,98,107,3,1,1,5,0,7,4,11,0,1,0,1,13,7,3,23
132835,2023,USA,Korea,0,0,0,0,3/6/2023,0,0,0,0,0,0,0,0,0,0,0,0,0,0,0,0,0,0,0,0
132835,2023,USA,Italy,0,2,10,12,2/6/2023,15,0,99,114,1,0,3,4,1,1,6,8,0,0,0,0,10,6,3,19
132835,2023,Serbia,USA,0,0,13,13,31/05/2023,12,0,110,122,3,2,1,6,0,3,9,12,0,0,0,0,6,4,2,12
135564,2023,Poland,USA,0,0,0,0,16/07/2023,0,0,13,13,0,0,0,0,0,0,0,0,2,2,10,14,12,8,2,22
135564,2023,USA,Türkiye,0,0,0,0,16/07/2023,0,0,15,15,0,0,0,0,0,0,0,0,2,1,14,17,10,8,1,19
135564,2023,USA,Japan,0,0,0,0,13/07/2023,0,0,12,12,0,0,0,0,0,0,0,0,4,0,10,14,17,3,1,21
135564,2023,China,USA,0,0,0,0,2/7/2023,0,0,8,8,0,0,0,0,0,0,0,0,3,0,11,14,17,4,0,21
135564,2023,Germany,USA,0,0,0,0,1/7/2023,0,0,19,19,0,0,0,0,0,0,0,0,3,1,5,9,17,7,1,25
135564,2023,USA,Bulgaria,0,0,0,0,29/06/2023,0,0,0,0,0,0,0,0,0,0,0,0,0,0,0,0,0,0,0,0
135564,2023,USA,Poland,0,0,0,0,28/06/2023,0,0,15,15,0,0,0,0,0,0,0,0,6,2,8,16,23,5,4,32
135564,2023,USA,Türkiye,0,0,0,0,4/6/2023,0,0,20,20,0,0,0,0,0,0,0,0,4,1,13,18,12,7,3,22
135564,2023,USA,Korea,0,0,0,0,3/6/2023,0,0,0,0,0,0,0,0,0,0,0,0,0,0,0,0,0,0,0,0
135564,2023,USA,Italy,0,0,0,0,2/6/2023,0,0,0,0,0,0,0,0,0,0,0,0,0,0,0,0,0,0,0,0
135564,2023,Serbia,USA,0,0,0,0,31/05/2023,0,1,8,9,0,0,0,0,0,0,0,0,4,0,7,11,11,6,3,20
139848,2023,Poland,USA,1,0,2,3,16/07/2023,0,0,1,1,2,3,2,7,0,0,1,1,0,1,6,7,4,1,0,5
139848,2023,USA,Türkiye,0,2,7,9,16/07/2023,0,0,0,0,12,3,12,27,0,2,1,3,4,0,19,23,6,0,2,8
139848,2023,USA,Japan,0,0,6,6,13/07/2023,0,0,1,1,3,1,2,6,0,1,0,1,0,0,5,5,2,0,1,3
139848,2023,China,USA,0,0,0,0,2/7/2023,0,0,0,0,0,0,0,0,0,0,0,0,1,0,6,7,0,1,0,1
139848,2023,Germany,USA,1,1,18,20,1/7/2023,0,0,3,3,15,8,21,44,1,2,4,7,10,0,12,22,8,1,2,11
139848,2023,USA,Bulgaria,0,0,0,0,29/06/2023,0,0,0,0,0,0,0,0,0,0,0,0,0,0,0,0,0,0,0,0
139848,2023,USA,Poland,0,1,18,19,28/06/2023,0,0,2,2,12,2,11,25,0,5,3,8,8,1,24,33,10,2,2,14
139848,2023,Brazil,USA,0,0,0,0,18/06/2023,0,0,0,0,0,0,0,0,0,0,0,0,0,0,0,0,0,0,0,0
139848,2023,Japan,USA,0,0,0,0,17/06/2023,0,0,0,0,0,0,0,0,0,0,0,0,0,0,0,0,0,0,0,0
139848,2023,Thailand,USA,0,0,0,0,15/06/2023,0,0,0,0,0,0,0,0,0,0,0,0,0,0,0,0,0,0,0,0
139848,2023,Croatia,USA,1,1,16,18,13/06/2023,0,0,3,3,15,2,14,31,1,4,2,7,3,1,26,30,8,2,1,11
152187,2023,Poland,USA,0,0,0,0,16/07/2023,0,0,3,3,0,0,0,0,0,0,0,0,1,0,2,3,4,0,0,4
152187,2023,USA,Türkiye,0,0,0,0,16/07/2023,0,0,0,0,0,0,0,0,0,0,0,0,0,0,0,0,0,0,0,0
152187,2023,USA,Japan,0,0,0,0,13/07/2023,0,0,0,0,0,0,0,0,0,0,0,0,0,0,0,0,0,0,0,0
152187,2023,China,USA,0,0,0,0,2/7/2023,0,0,0,0,0,0,0,0,0,0,0,0,0,0,0,0,0,0,0,0
152187,2023,Germany,USA,0,0,0,0,1/7/2023,0,0,0,0,0,0,0,0,0,0,0,0,0,0,0,0,0,0,0,0
152187,2023,USA,Bulgaria,0,0,0,0,29/06/2023,0,0,10,10,0,0,0,0,0,0,0,0,1,0,3,4,3,4,2,9
152187,2023,USA,Poland,0,0,0,0,28/06/2023,0,0,0,0,0,0,0,0,0,0,0,0,0,0,0,0,0,0,0,0
152187,2023,Brazil,USA,0,0,0,0,18/06/2023,0,0,7,7,0,0,0,0,0,0,0,0,2,0,4,6,9,3,3,15
152187,2023,Japan,USA,0,0,0,0,17/06/2023,0,0,0,0,0,0,0,0,0,0,0,0,0,0,0,0,0,0,0,0
152187,2023,Thailand,USA,0,0,0,0,15/06/2023,0,0,17,17,0,0,0,0,0,0,0,0,2,0,10,12,7,2,0,9
152187,2023,Croatia,USA,0,0,0,0,13/06/2023,0,0,0,0,0,0,0,0,0,0,0,0,0,0,0,0,0,0,0,0
152187,2023,USA,Türkiye,0,0,0,0,4/6/2023,0,0,0,0,0,0,0,0,0,0,0,0,0,0,0,0,0,0,0,0
152187,2023,USA,Korea,0,0,0,0,3/6/2023,0,1,3,4,0,0,0,0,0,0,0,0,0,0,5,5,9,5,2,16
152187,2023,USA,Italy,0,0,0,0,2/6/2023,0,0,8,8,0,0,0,0,0,0,0,0,3,1,8,12,16,3,0,19
152187,2023,Serbia,USA,0,0,0,0,31/05/2023,0,0,0,0,0,0,0,0,0,0,0,0,0,0,0,0,0,0,0,0
132500,2023,Poland,USA,0,0,8,8,16/07/2023,17,0,74,91,2,0,1,3,1,4,7,12,0,0,0,0,7,2,0,9
132500,2023,USA,Türkiye,0,0,0,0,16/07/2023,0,0,0,0,0,0,0,0,0,0,0,0,0,0,0,0,0,0,0,0
132500,2023,USA,Japan,0,0,0,0,13/07/2023,0,0,0,0,0,0,0,0,0,0,0,0,0,0,0,0,0,0,0,0
132500,2023,China,USA,0,0,15,15,2/7/2023,37,1,90,128,4,0,3,7,0,4,5,9,0,0,0,0,4,6,2,12
132500,2023,Germany,USA,0,0,3,3,1/7/2023,10,2,44,56,2,0,0,2,0,1,1,2,0,1,0,1,10,2,0,12
132500,2023,USA,Bulgaria,0,2,2,4,29/06/2023,12,2,37,51,1,1,1,3,2,3,2,7,0,0,1,1,10,2,0,12
132500,2023,USA,Poland,0,0,0,0,28/06/2023,0,0,0,0,0,0,0,0,0,0,0,0,0,0,0,0,0,0,0,0
155307,2023,Poland,USA,0,1,13,14,16/07/2023,0,0,0,0,9,4,11,24,1,2,1,4,0,0,0,0,3,0,0,3
155307,2023,USA,Türkiye,0,3,10,13,16/07/2023,0,0,3,3,12,11,14,37,2,3,4,9,0,0,0,0,5,7,2,14
155307,2023,USA,Japan,2,2,9,13,13/07/2023,0,0,2,2,11,7,13,31,0,6,10,16,0,0,0,0,6,3,1,10
155307,2023,China,USA,0,3,5,8,2/7/2023,0,0,4,4,15,4,19,38,1,10,3,14,0,0,0,0,7,2,1,10
155307,2023,Germany,USA,0,0,0,0,1/7/2023,0,0,0,0,0,0,0,0,0,0,0,0,0,0,0,0,0,0,0,0
155307,2023,USA,Bulgaria,0,0,0,0,29/06/2023,0,0,0,0,0,0,0,0,0,0,0,0,0,0,0,0,0,0,0,0
155307,2023,USA,Poland,1,1,12,14,28/06/2023,0,0,1,1,18,9,21,48,1,3,4,8,0,0,0,0,7,1,1,9
155307,2023,USA,Türkiye,2,2,13,17,4/6/2023,0,0,3,3,17,6,20,43,0,3,8,11,0,0,0,0,7,8,3,18
155307,2023,USA,Korea,0,0,0,0,3/6/2023,0,0,0,0,0,0,0,0,0,0,0,0,0,0,0,0,0,0,0,0
155307,2023,USA,Italy,0,3,15,18,2/6/2023,0,0,0,0,12,5,18,35,0,3,3,6,0,0,0,0,10,7,1,18
155307,2023,Serbia,USA,2,4,12,18,31/05/2023,0,0,2,2,22,6,15,43,1,3,2,6,0,0,0,0,14,7,3,24
172978,2023,Poland,USA,0,2,4,6,16/07/2023,0,0,2,2,5,3,12,20,0,2,3,5,0,0,0,0,6,5,3,14
172978,2023,USA,Türkiye,0,0,1,1,16/07/2023,0,0,0,0,0,1,0,1,1,0,0,1,0,0,0,0,0,0,0,0
172978,2023,USA,Japan,0,1,0,1,13/07/2023,0,0,1,1,2,1,5,8,0,1,3,4,0,0,0,0,0,0,0,0
172978,2023,China,USA,0,0,0,0,2/7/2023,0,0,0,0,0,0,0,0,0,0,0,0,0,0,0,0,0,0,0,0
172978,2023,Germany,USA,2,0,15,17,1/7/2023,0,0,6,6,14,6,24,44,1,1,7,9,0,0,0,0,10,2,0,12
172978,2023,USA,Bulgaria,1,1,7,9,29/06/2023,0,0,4,4,11,2,9,22,4,2,5,11,0,0,0,0,8,0,0,8
172978,2023,USA,Poland,0,0,2,2,28/06/2023,0,0,0,0,5,3,6,14,0,0,2,2,0,0,1,1,0,0,0,0
172978,2023,Brazil,USA,2,1,11,14,18/06/2023,0,0,2,2,13,4,8,25,0,1,0,1,0,0,0,0,6,2,0,8
172978,2023,Japan,USA,0,0,1,1,17/06/2023,0,0,0,0,3,2,5,10,2,1,1,4,0,0,0,0,0,0,0,0
172978,2023,Thailand,USA,0,1,9,10,15/06/2023,0,0,2,2,14,6,16,36,1,1,2,4,0,0,0,0,9,2,0,11
172978,2023,Croatia,USA,1,0,11,12,13/06/2023,0,0,2,2,14,1,9,24,2,2,3,7,0,0,0,0,4,2,2,8
140052,2023,Poland,USA,0,0,3,3,16/07/2023,0,0,0,0,0,0,2,2,1,1,0,2,0,0,0,0,1,0,0,1
140052,2023,USA,Türkiye,0,0,6,6,16/07/2023,0,0,0,0,0,3,1,4,0,0,0,0,0,0,1,1,0,1,0,1
140052,2023,USA,Japan,0,0,11,11,13/07/2023,0,0,1,1,6,0,6,12,1,4,6,11,0,0,1,1,3,2,2,7
140052,2023,China,USA,0,3,13,16,2/7/2023,0,0,1,1,7,0,7,14,0,1,4,5,0,0,0,0,3,0,2,5
140052,2023,Germany,USA,0,0,0,0,1/7/2023,0,0,0,0,0,0,0,0,0,0,0,0,0,0,0,0,0,0,0,0
140052,2023,USA,Bulgaria,0,0,0,0,29/06/2023,0,0,0,0,0,0,0,0,0,0,0,0,0,0,0,0,0,0,0,0
140052,2023,USA,Poland,1,1,15,17,28/06/2023,0,0,2,2,5,2,3,10,5,11,5,21,0,0,1,1,4,2,1,7
140052,2023,Brazil,USA,0,0,10,10,18/06/2023,0,0,1,1,5,0,1,6,3,4,2,9,0,0,0,0,0,0,0,0
140052,2023,Japan,USA,0,0,0,0,17/06/2023,0,0,0,0,0,0,0,0,0,0,0,0,0,0,0,0,0,0,0,0
140052,2023,Thailand,USA,0,0,10,10,15/06/2023,0,0,0,0,7,3,2,12,3,4,3,10,0,0,0,0,0,0,0,0
140052,2023,Croatia,USA,0,0,0,0,13/06/2023,0,0,0,0,0,0,0,0,0,0,0,0,0,0,0,0,0,0,0,0
172977,2023,Poland,USA,0,2,5,7,16/07/2023,0,0,0,0,0,0,1,1,0,1,1,2,0,1,1,2,1,0,0,1
172977,2023,USA,Türkiye,0,2,11,13,16/07/2023,0,0,2,2,0,0,6,6,2,0,3,5,0,0,1,1,1,0,0,1
172977,2023,USA,Japan,0,1,10,11,13/07/2023,0,0,0,0,3,0,1,4,2,0,7,9,0,0,1,1,0,1,0,1
172977,2023,China,USA,1,3,9,13,2/7/2023,0,0,3,3,7,1,4,12,2,3,7,12,0,0,3,3,1,1,1,3
172977,2023,Germany,USA,0,0,1,1,1/7/2023,0,0,0,0,0,0,0,0,0,0,0,0,0,0,0,0,0,1,0,1
172977,2023,USA,Bulgaria,0,0,0,0,29/06/2023,0,0,0,0,0,0,0,0,0,0,0,0,0,0,0,0,0,0,0,0
172977,2023,USA,Poland,0,1,16,17,28/06/2023,0,0,3,3,10,0,7,17,3,3,9,15,1,0,4,5,5,2,1,8
172977,2023,USA,Türkiye,0,2,12,14,4/6/2023,0,0,2,2,8,1,5,14,1,1,3,5,0,0,0,0,1,1,0,2
172977,2023,USA,Korea,0,0,0,0,3/6/2023,0,0,0,0,0,0,0,0,0,0,0,0,0,0,0,0,0,0,0,0
172977,2023,USA,Italy,1,1,16,18,2/6/2023,0,0,1,1,11,1,8,20,2,3,10,15,1,0,1,2,4,1,1,6
172977,2023,Serbia,USA,0,1,4,5,31/05/2023,0,0,2,2,3,2,3,8,1,1,3,5,0,1,0,1,1,0,0,1
141933,2023,Poland,USA,0,1,18,19,16/07/2023,0,0,3,3,6,4,18,28,0,3,3,6,8,1,12,21,7,2,0,9
141933,2023,USA,Türkiye,0,0,5,5,16/07/2023,0,0,1,1,1,3,8,12,0,0,1,1,0,0,4,4,0,0,0,0
141933,2023,USA,Japan,0,3,8,11,13/07/2023,0,0,5,5,10,4,28,42,1,0,2,3,6,0,17,23,14,0,2,16
141933,2023,China,USA,0,2,17,19,2/7/2023,0,0,5,5,17,6,24,47,0,7,3,10,5,1,19,25,10,1,1,12
141933,2023,Germany,USA,0,0,0,0,1/7/2023,0,0,0,0,0,0,0,0,0,0,0,0,0,0,1,1,1,0,0,1
141933,2023,USA,Bulgaria,0,0,0,0,29/06/2023,0,0,0,0,0,0,0,0,0,0,0,0,0,0,0,0,0,0,0,0
141933,2023,USA,Poland,0,0,16,16,28/06/2023,0,0,8,8,17,8,21,46,3,6,6,15,8,0,19,27,10,2,0,12
166638,2023,Poland,USA,1,1,7,9,16/07/2023,0,0,2,2,4,0,2,6,4,6,8,18,0,0,0,0,0,1,0,1
166638,2023,USA,Türkiye,1,2,4,7,16/07/2023,0,0,1,1,2,2,0,4,3,2,4,9,0,0,0,0,3,1,0,4
166638,2023,USA,Japan,0,1,7,8,13/07/2023,0,0,1,1,8,1,2,11,1,2,7,10,0,0,0,0,2,2,0,4
200701,2023,Poland,USA,1,1,11,13,16/07/2023,0,0,1,1,4,2,5,11,4,4,8,16,0,1,0,1,2,2,1,5
200701,2023,USA,Türkiye,0,1,1,2,16/07/2023,0,0,0,0,0,0,1,1,3,2,3,8,0,0,0,0,0,0,0,0
200701,2023,USA,Japan,0,0,0,0,13/07/2023,0,0,0,0,0,0,0,0,0,0,0,0,0,0,0,0,0,0,0,0
200701,2023,Brazil,USA,0,1,9,10,18/06/2023,0,0,0,0,3,2,2,7,1,5,3,9,0,0,1,1,2,1,0,3
200701,2023,Japan,USA,0,0,0,0,17/06/2023,0,0,0,0,0,0,0,0,0,0,0,0,0,0,0,0,0,0,0,0
200701,2023,Thailand,USA,0,1,10,11,15/06/2023,0,0,0,0,8,0,4,12,5,2,7,14,0,0,2,2,3,0,0,3
200701,2023,Croatia,USA,0,0,7,7,13/06/2023,0,0,1,1,3,0,1,4,2,3,6,11,0,0,0,0,1,1,0,2
200701,2023,USA,Türkiye,0,1,9,10,4/6/2023,0,0,0,0,4,0,6,10,1,0,6,7,0,0,0,0,0,1,2,3
200701,2023,USA,Korea,0,1,6,7,3/6/2023,0,0,2,2,4,1,4,9,1,3,1,5,0,0,0,0,1,0,0,1
200701,2023,USA,Italy,1,3,19,23,2/6/2023,0,1,3,4,7,1,3,11,3,3,5,11,0,0,1,1,1,1,2,4
200701,2023,Serbia,USA,0,1,10,11,31/05/2023,0,0,1,1,4,0,4,8,1,1,7,9,0,0,0,0,1,1,0,2
192906,2023,Poland,USA,0,2,9,11,16/07/2023,0,0,2,2,15,2,12,29,3,1,3,7,1,0,26,27,5,1,0,6
192906,2023,USA,Türkiye,0,0,2,2,16/07/2023,0,0,1,1,3,3,5,11,0,1,2,3,1,1,4,6,0,2,0,2
192906,2023,USA,Japan,0,1,3,4,13/07/2023,0,0,0,0,9,0,6,15,2,2,2,6,2,1,10,13,4,1,0,5
192906,2023,Brazil,USA,0,0,0,0,18/06/2023,0,0,0,0,0,0,0,0,0,0,0,0,0,0,0,0,0,0,0,0
192906,2023,Japan,USA,1,2,14,17,17/06/2023,0,0,2,2,12,8,18,38,1,2,2,5,4,1,29,34,11,7,1,19
192906,2023,Thailand,USA,0,0,8,8,15/06/2023,0,1,1,2,13,3,10,26,2,1,3,6,3,0,12,15,8,0,1,9
192906,2023,Croatia,USA,0,0,0,0,13/06/2023,0,0,0,0,0,0,0,0,0,0,0,0,0,0,0,0,0,0,0,0
192906,2023,USA,Türkiye,0,0,13,13,4/6/2023,0,0,3,3,16,4,14,34,0,3,3,6,7,4,25,36,9,4,2,15
192906,2023,USA,Korea,1,3,16,20,3/6/2023,0,0,1,1,12,1,8,21,1,1,5,7,4,0,16,20,4,1,2,7
192906,2023,USA,Italy,0,0,2,2,2/6/2023,0,0,0,0,0,1,3,4,0,0,0,0,0,0,3,3,1,0,0,1
192906,2023,Serbia,USA,1,3,15,19,31/05/2023,0,0,1,1,17,4,11,32,1,4,2,7,5,1,29,35,10,6,0,16
147590,2023,Poland,USA,0,1,1,2,16/07/2023,0,0,1,1,3,1,6,10,0,2,0,2,1,1,9,11,1,0,0,1
147590,2023,USA,Türkiye,1,2,8,11,16/07/2023,0,0,3,3,16,5,16,37,1,0,1,2,6,0,33,39,13,3,0,16
147590,2023,USA,Japan,0,2,7,9,13/07/2023,0,0,1,1,6,4,17,27,3,1,2,6,4,1,19,24,13,3,3,19
147590,2023,Brazil,USA,0,0,8,8,18/06/2023,0,0,3,3,12,1,9,22,0,4,2,6,2,0,5,7,3,3,1,7
147590,2023,Japan,USA,2,0,13,15,17/06/2023,0,0,3,3,15,3,15,33,3,8,2,13,6,0,23,29,16,2,1,19
147590,2023,Thailand,USA,0,0,0,0,15/06/2023,0,0,0,0,0,0,0,0,0,0,0,0,0,0,0,0,0,0,0,0
147590,2023,Croatia,USA,0,4,12,16,13/06/2023,0,0,5,5,12,4,16,32,1,2,4,7,2,2,18,22,9,1,0,10
147590,2023,USA,Türkiye,0,2,13,15,4/6/2023,0,0,8,8,11,8,18,37,1,3,6,10,7,0,26,33,6,2,0,8
147590,2023,USA,Korea,0,0,0,0,3/6/2023,0,0,0,0,0,0,0,0,0,0,0,0,0,0,0,0,0,0,0,0
147590,2023,USA,Italy,1,2,12,15,2/6/2023,0,0,1,1,13,2,15,30,2,4,3,9,4,2,16,22,3,1,1,5
147590,2023,Serbia,USA,2,2,15,19,31/05/2023,0,0,3,3,13,5,16,34,1,1,4,6,7,0,29,36,10,3,0,13
